Name,Year,Population total,Median Age,Total Housing Units,Vacant Housing Units,Occupied Housing Units,Real Median Income,Household size,Vacant units per person
"Abbeville County, South Carolina",2009,25347,40.1,12009,2373,9636,33495,2.6304483188,0.0936205468103
"Abbeville County, South Carolina",2012,25387,42.4,12066,2188,9878,35067,2.57005466694,0.0861858431481
"Abbeville County, South Carolina",2015,24997,43.3,12008,2435,9573,34799,2.6111981615,0.0974116894027
"Acadia Parish, Louisiana",2009,59616,34.8,24658,2937,21721,33882,2.74462501726,0.0492652979066
"Acadia Parish, Louisiana",2012,61611,35.6,25369,3196,22173,38686,2.77864970911,0.051873853695
"Acadia Parish, Louisiana",2015,62163,35.7,25737,3138,22599,37649,2.75069693349,0.0504801891801
"Accomack County, Virginia",2009,38522,41.5,21231,6474,14757,40343,2.61042217253,0.168059809979
"Accomack County, Virginia",2012,33454,44.5,21017,6731,14286,40780,2.34173316534,0.201201650027
"Accomack County, Virginia",2015,33115,45.3,21031,7070,13961,39412,2.37196475897,0.213498414616
"Ada County, Idaho",2009,368791,33.9,151143,9424,141719,55888,2.60226927935,0.0255537689369
"Ada County, Idaho",2012,394961,34.9,159535,9651,149884,55499,2.63511115262,0.024435323994
"Ada County, Idaho",2015,417501,35.8,164992,7706,157286,56356,2.65440662233,0.0184574408205
"Adair County, Iowa",2009,7555,45.3,3704,357,3347,43487,2.25724529429,0.0472534745202
"Adair County, Iowa",2012,7628,45.4,3689,419,3270,47872,2.33272171254,0.0549292081804
"Adair County, Iowa",2015,7426,45.9,3672,443,3229,46526,2.29978321462,0.0596552652841
"Adair County, Kentucky",2009,17872,39,7948,1231,6717,29247,2.66071162721,0.0688786929275
"Adair County, Kentucky",2012,18651,39.4,8525,1289,7236,31169,2.57752902156,0.0691115757868
"Adair County, Kentucky",2015,18852,41,8526,1478,7048,33362,2.67480136209,0.0784001697433
"Adair County, Missouri",2009,24801,25.7,11327,1697,9630,30000,2.5753894081,0.068424660296
"Adair County, Missouri",2012,25542,29.1,11261,1664,9597,33284,2.66145670522,0.0651476000313
"Adair County, Missouri",2015,25560,27.9,11309,1674,9635,37516,2.65282823041,0.0654929577465
"Adair County, Oklahoma",2009,21822,34.2,8760,1074,7686,29798,2.83918813427,0.0492163871323
"Adair County, Oklahoma",2012,22470,36.8,9135,1219,7916,31287,2.83855482567,0.0542501112595
"Adair County, Oklahoma",2015,22236,37,9212,1244,7968,33404,2.7906626506,0.0559453139054
"Adams County, Colorado",2009,419439,32,159908,14159,145749,55258,2.87781734352,0.0337569944616
"Adams County, Colorado",2012,442996,32.4,163245,12211,151034,56633,2.93308791398,0.0275645829759
"Adams County, Colorado",2015,471206,33,165046,8418,156628,58946,3.00844038103,0.0178647979864
"Adams County, Idaho",2009,3520,45.4,2121,580,1541,37255,2.28423101882,0.164772727273
"Adams County, Idaho",2012,3976,50.3,2620,888,1732,35756,2.29561200924,0.223340040241
"Adams County, Idaho",2015,3880,51.3,2645,1053,1592,39565,2.43718592965,0.271391752577
"Adams County, Illinois",2009,66892,40.3,30383,2804,27579,43460,2.42546865369,0.0419183160916
"Adams County, Illinois",2012,67098,40.4,29904,3204,26700,45691,2.51303370787,0.047751050702
"Adams County, Illinois",2015,67081,40.6,29976,3093,26883,45965,2.49529442399,0.0461084360698
"Adams County, Indiana",2009,33955,34.2,13165,707,12458,43208,2.72555787446,0.0208216757473
"Adams County, Indiana",2012,34343,34.3,13023,706,12317,45339,2.78826012828,0.0205573188131
"Adams County, Indiana",2015,34642,33.8,13079,896,12183,48188,2.84347040959,0.0258645574736
"Adams County, Iowa",2009,4072,45.7,2220,306,1914,40833,2.12748171369,0.0751473477407
"Adams County, Iowa",2012,4027,46.5,2008,285,1723,45099,2.33720255369,0.0707722870623
"Adams County, Iowa",2015,3892,46.8,1992,274,1718,48043,2.26542491269,0.0704008221994
"Adams County, Mississippi",2009,31475,40.8,15494,2579,12915,28868,2.4370886566,0.0819380460683
"Adams County, Mississippi",2012,32391,40.4,14695,2452,12243,27486,2.64567507964,0.0757000401346
"Adams County, Mississippi",2015,31979,40.7,14622,2768,11854,28869,2.69773915978,0.0865568029019
"Adams County, Nebraska",2009,33024,36.3,13893,1154,12739,44524,2.59235418793,0.0349442829457
"Adams County, Nebraska",2012,31299,37.8,13433,874,12559,49017,2.49215701887,0.0279242148311
"Adams County, Nebraska",2015,31442,37.8,13618,948,12670,50635,2.4816101026,0.0301507537688
"Adams County, North Dakota",2009,2291,49.5,1370,369,1001,35550,2.28871128871,0.161065037102
"Adams County, North Dakota",2012,2325,50.2,1444,344,1100,42830,2.11363636364,0.147956989247
"Adams County, North Dakota",2015,2341,47.6,1378,311,1067,52118,2.19400187441,0.132849209739
"Adams County, Ohio",2009,28142,38.1,12095,1873,10222,33850,2.75308158873,0.0665553265582
"Adams County, Ohio",2012,28524,39.8,12913,1990,10923,34282,2.61137050261,0.0697658112467
"Adams County, Ohio",2015,28229,41,12848,1990,10858,35560,2.59983422361,0.0704948811506
"Adams County, Pennsylvania",2009,101011,39.4,39598,1894,37704,54899,2.67905262041,0.0187504331211
"Adams County, Pennsylvania",2012,101352,41.3,40827,2536,38291,58465,2.64688830273,0.0250217065277
"Adams County, Pennsylvania",2015,101767,42.8,41235,3042,38193,60356,2.66454585919,0.0298918116875
"Adams County, Washington",2009,17029,29.6,6005,582,5423,39679,3.14014383183,0.0341769921898
"Adams County, Washington",2012,18575,29.2,6220,498,5722,41798,3.24624257253,0.0268102288022
"Adams County, Washington",2015,19081,28.9,6271,469,5802,46564,3.28869355395,0.0245794245585
"Adams County, Wisconsin",2009,20400,46.6,16243,7163,9080,38726,2.24669603524,0.35112745098
"Adams County, Wisconsin",2012,20898,48.9,17384,8651,8733,42781,2.39299209894,0.413963058666
"Adams County, Wisconsin",2015,20451,51.4,17410,9624,7786,43640,2.62663755459,0.470588235294
"Addison County, Vermont",2009,36659,39.6,16459,2737,13722,55427,2.67154933683,0.0746610654955
"Addison County, Vermont",2012,36814,41.8,16760,2619,14141,57785,2.60335195531,0.0711414135927
"Addison County, Vermont",2015,36943,42.8,16891,2555,14336,59688,2.57693917411,0.0691605987603
"Adjuntas Municipio, Puerto Rico",2009,18472,34.4,6233,1201,5032,12103,3.67090620032,0.0650173235167
"Adjuntas Municipio, Puerto Rico",2012,19458,36.3,7037,1273,5764,13095,3.37578070784,0.0654229622777
"Adjuntas Municipio, Puerto Rico",2015,18962,37.8,7694,1372,6322,10499,2.99936728883,0.0723552367894
"Aguada Municipio, Puerto Rico",2009,45597,35.2,15271,2256,13015,13797,3.50341913177,0.0494769392723
"Aguada Municipio, Puerto Rico",2012,41876,38,16280,2953,13327,15106,3.14219254146,0.0705177189798
"Aguada Municipio, Puerto Rico",2015,40603,39.5,17398,4288,13110,16029,3.09710144928,0.105607960003
"Aguadilla Municipio, Puerto Rico",2009,67187,36.1,23993,4364,19629,13814,3.42284375159,0.064953041511
"Aguadilla Municipio, Puerto Rico",2012,60714,37.8,25553,6106,19447,15302,3.12202396256,0.100569885035
"Aguadilla Municipio, Puerto Rico",2015,57973,39.7,27386,6565,20821,17267,2.78435233658,0.113242371449
"Aguas Buenas Municipio, Puerto Rico",2009,31341,35.7,10341,1181,9160,15242,3.42150655022,0.037682269232
"Aguas Buenas Municipio, Puerto Rico",2012,28573,35.7,10250,1458,8792,13994,3.24988626024,0.0510271935044
"Aguas Buenas Municipio, Puerto Rico",2015,27693,37.7,10752,1904,8848,14824,3.12985985533,0.0687538367096
"Aibonito Municipio, Puerto Rico",2009,27119,35.2,9119,832,8287,15179,3.27247496078,0.0306795973303
"Aibonito Municipio, Puerto Rico",2012,25823,37.1,9556,938,8618,16235,2.9964028777,0.0363242071022
"Aibonito Municipio, Puerto Rico",2015,24829,40.2,9986,1278,8708,17307,2.85128617363,0.0514720689516
"Aiken County, South Carolina",2009,152647,39.4,68319,8133,60186,44534,2.5362542784,0.0532797893178
"Aiken County, South Carolina",2012,160169,40.1,72248,9003,63245,44399,2.53251640446,0.0562093788436
"Aiken County, South Carolina",2015,163908,40.9,73649,9943,63706,45759,2.5728816752,0.0606620787271
"Aitkin County, Minnesota",2009,15871,50.5,15687,8145,7542,39452,2.10434897905,0.513200176422
"Aitkin County, Minnesota",2012,16166,51.8,16011,8250,7761,41191,2.08297899755,0.5103303229
"Aitkin County, Minnesota",2015,15839,53.1,16112,8503,7609,42252,2.0816138783,0.536839446935
"Alachua County, Florida",2009,238990,27.5,108148,11630,96518,39345,2.47611844423,0.0486631239801
"Alachua County, Florida",2012,247973,30.1,112587,16043,96544,42818,2.5684972655,0.0646965597061
"Alachua County, Florida",2015,254218,30.8,113659,16956,96703,43073,2.62885329307,0.066698660205
"Alamance County, North Carolina",2009,144769,37.4,63843,5978,57865,44172,2.5018404908,0.0412933708183
"Alamance County, North Carolina",2012,151170,38.5,66694,6384,60310,44155,2.50654949428,0.0422306013098
"Alamance County, North Carolina",2015,155258,39.2,67804,6259,61545,41814,2.52267446584,0.0403135426194
"Alameda County, California",2009,1457095,36.1,563011,42915,520096,68863,2.80158855288,0.0294524378987
"Alameda County, California",2012,1515136,36.6,581859,42680,539179,71516,2.81007976943,0.0281690884515
"Alameda County, California",2015,1584983,37.1,589858,30951,558907,75619,2.83586178022,0.0195276542398
"Alamosa County, Colorado",2009,15353,31.5,6495,686,5809,32362,2.64296780857,0.0446818211424
"Alamosa County, Colorado",2012,15750,32.2,6572,719,5853,38045,2.69092772937,0.0456507936508
"Alamosa County, Colorado",2015,16269,30.1,6673,741,5932,32395,2.74258260283,0.0455467453439
"Albany County, New York",2009,298341,38,133501,10976,122525,55350,2.4349398082,0.0367901160082
"Albany County, New York",2012,304511,38.2,137426,14752,122674,59359,2.48227823337,0.0484448837645
"Albany County, New York",2015,307463,37.9,138081,14630,123451,59887,2.4905671076,0.0475829612018
"Albany County, Wyoming",2009,32985,24.5,17108,2915,14193,40116,2.324032974,0.0883735031075
"Albany County, Wyoming",2012,36186,26.8,18004,2983,15021,42882,2.40902736169,0.0824351959321
"Albany County, Wyoming",2015,37565,26.6,18537,2875,15662,42834,2.39848039842,0.07653400772
"Albemarle County, Virginia",2009,92866,36.6,40542,3648,36894,64306,2.51710305199,0.0392824069089
"Albemarle County, Virginia",2012,99484,38.2,42332,4783,37549,67797,2.64944472556,0.0480780829078
"Albemarle County, Virginia",2015,103108,38.6,43579,4726,38853,68449,2.65379764754,0.0458354346898
"Alcona County, Michigan",2009,11361,53.8,11169,6395,4774,35014,2.37976539589,0.562890590617
"Alcona County, Michigan",2012,10943,55.3,11066,6326,4740,36931,2.30864978903,0.578086447958
"Alcona County, Michigan",2015,10550,56.6,11056,6055,5001,38033,2.10957808438,0.573933649289
"Alcorn County, Mississippi",2009,35583,38.8,16493,2856,13637,31826,2.60929823275,0.0802630469606
"Alcorn County, Mississippi",2012,37027,39.4,17039,2875,14164,32846,2.61416266591,0.0776460420774
"Alcorn County, Mississippi",2015,37319,39.9,17100,2294,14806,36163,2.52053221667,0.0614700286717
"Aleutians East Borough, Alaska",2009,2959,37.2,581,226,355,56250,8.33521126761,0.0763771544441
"Aleutians East Borough, Alaska",2012,3114,40.7,597,203,394,58125,7.90355329949,0.0651894669236
"Aleutians East Borough, Alaska",2015,3304,42.4,894,204,690,61518,4.7884057971,0.0617433414044
"Aleutians West Census Area, Alaska",2009,5505,40.8,1706,1143,563,72989,9.77797513321,0.207629427793
"Aleutians West Census Area, Alaska",2012,5507,39.1,1949,958,991,77292,5.55701311806,0.173960414019
"Aleutians West Census Area, Alaska",2015,5684,36.8,1944,806,1138,84306,4.99472759227,0.141801548205
"Alexander County, Illinois",2009,8254,43,4643,1040,3603,28983,2.29086872051,0.125999515386
"Alexander County, Illinois",2012,8147,41,4033,949,3084,27248,2.64169909209,0.116484595557
"Alexander County, Illinois",2015,7364,39.7,3969,1325,2644,27265,2.78517397882,0.179929386203
"Alexander County, North Carolina",2009,36278,39.9,15399,2260,13139,41520,2.76109292945,0.0622967087491
"Alexander County, North Carolina",2012,37014,41.1,16119,2366,13753,39544,2.69134007126,0.0639217593343
"Alexander County, North Carolina",2015,37158,42.1,16177,2596,13581,39365,2.7360282748,0.0698638247484
"Alexandria city, Virginia",2009,142131,35.2,69973,7113,62860,80186,2.26107222399,0.0500453806699
"Alexandria city, Virginia",2012,140337,35.7,72460,7731,64729,83996,2.16806995319,0.0550888219073
"Alexandria city, Virginia",2015,149315,36,74317,7438,66879,89134,2.23261412402,0.0498141512909
"Alfalfa County, Oklahoma",2009,5571,45,2858,765,2093,39641,2.66172957477,0.13731825525
"Alfalfa County, Oklahoma",2012,5631,46,2765,718,2047,41943,2.75085490962,0.127508435447
"Alfalfa County, Oklahoma",2015,5755,44.7,2753,681,2072,50156,2.77750965251,0.118331885317
"Alger County, Michigan",2009,9512,46.1,6566,2794,3772,41234,2.52173913043,0.293734230446
"Alger County, Michigan",2012,9531,47.5,6559,3001,3558,38348,2.67875210793,0.314867275207
"Alger County, Michigan",2015,9476,48.7,6581,3111,3470,39300,2.73083573487,0.328303081469
"Allamakee County, Iowa",2009,14421,43.1,7577,1570,6007,43904,2.40069918429,0.108869010471
"Allamakee County, Iowa",2012,14285,44.2,7617,1812,5805,47539,2.46080964686,0.126846342317
"Allamakee County, Iowa",2015,14060,45.1,7626,1578,6048,45890,2.32473544974,0.112233285917
"Allegan County, Michigan",2009,112817,37.7,48371,6428,41943,51833,2.68976944901,0.0569772286092
"Allegan County, Michigan",2012,111589,39,49388,7430,41958,51030,2.65954049287,0.0665836238339
"Allegan County, Michigan",2015,112837,40,49692,7799,41893,54264,2.69345714081,0.0691173994346
"Allegany County, Maryland",2009,72598,40.5,33256,4228,29028,36810,2.50096458592,0.0582385189675
"Allegany County, Maryland",2012,74645,41,33304,4767,28537,39087,2.61572695098,0.0638622814656
"Allegany County, Maryland",2015,73549,41.5,33262,4938,28324,40551,2.59670244316,0.0671389141933
"Allegany County, New York",2009,49391,36.3,25047,6401,18646,40917,2.64887911616,0.12959850985
"Allegany County, New York",2012,48837,37.8,26046,7203,18843,42095,2.59178474765,0.147490632103
"Allegany County, New York",2015,48070,38.3,26024,7739,18285,42776,2.62893081761,0.160994383191
"Alleghany County, North Carolina",2009,10905,45,7185,2392,4793,32541,2.27519298978,0.219348922513
"Alleghany County, North Carolina",2012,11069,46,8050,3256,4794,32449,2.30892782645,0.29415484687
"Alleghany County, North Carolina",2015,10911,47.2,8128,3358,4770,36968,2.28742138365,0.307762808175
"Alleghany County, Virginia",2009,16397,44.1,8062,926,7136,42005,2.29778587444,0.0564737451973
"Alleghany County, Virginia",2012,16297,46.1,8064,1213,6851,46133,2.3787768209,0.0744308768485
"Alleghany County, Virginia",2015,16066,47.2,8063,1282,6781,45007,2.36926706975,0.0797958421511
"Allegheny County, Pennsylvania",2009,1222473,40.8,592006,67422,524584,46641,2.33036653806,0.0551521383294
"Allegheny County, Pennsylvania",2012,1224772,41.2,589171,64779,524392,50664,2.33560389937,0.0528906604658
"Allegheny County, Pennsylvania",2015,1231145,40.9,589681,60147,529534,53040,2.32495930384,0.0488545216039
"Allen County, Indiana",2009,348646,35.1,152002,15983,136019,47901,2.56321543314,0.0458430614434
"Allen County, Indiana",2012,355940,35.4,152340,15143,137197,50030,2.59437159705,0.0425436871383
"Allen County, Indiana",2015,363453,35.6,153860,13324,140536,49092,2.58619143849,0.0366594855456
"Allen County, Kansas",2009,13403,40.7,6516,784,5732,39328,2.33827634334,0.0584943669328
"Allen County, Kansas",2012,13364,40.8,6235,658,5577,39714,2.39627039627,0.0492367554624
"Allen County, Kansas",2015,13081,41.2,6247,941,5306,38698,2.46532227667,0.0719363963
"Allen County, Kentucky",2009,18799,37.4,8467,1368,7099,33929,2.64811945344,0.0727698281824
"Allen County, Kentucky",2012,20007,39.3,9263,1283,7980,36123,2.50714285714,0.0641275553556
"Allen County, Kentucky",2015,20355,40.3,9323,1549,7774,41326,2.61834319527,0.0760992385163
"Allen County, Ohio",2009,104946,37.9,45393,4432,40961,43433,2.56209565196,0.0422312427344
"Allen County, Ohio",2012,106079,38.1,44995,4373,40622,43194,2.61136822412,0.0412239934389
"Allen County, Ohio",2015,105196,38.1,44859,4873,39986,44103,2.63082078728,0.0463230541085
"Allen Parish, Louisiana",2009,25528,35.2,9562,1164,8398,36463,3.03977137414,0.0455969915387
"Allen Parish, Louisiana",2012,25740,38.5,9725,1422,8303,38899,3.10008430688,0.0552447552448
"Allen Parish, Louisiana",2015,25653,38.5,9781,1754,8027,40948,3.19583904323,0.0683740693096
"Allendale County, South Carolina",2009,10459,37,4652,1182,3470,20551,3.01412103746,0.113012716321
"Allendale County, South Carolina",2012,10399,38.3,4484,1042,3442,25966,3.02120859965,0.100201942494
"Allendale County, South Carolina",2015,9838,38.7,4448,1102,3346,25327,2.94022713688,0.112014637121
"Alpena County, Michigan",2009,29718,44.8,15615,2555,13060,36261,2.27549770291,0.0859748300693
"Alpena County, Michigan",2012,29602,45.8,16020,2922,13098,38900,2.26003970072,0.0987095466523
"Alpena County, Michigan",2015,29068,47.1,15983,3261,12722,38829,2.28486087093,0.112185220861
"Alpine County, California",2009,1153,39.5,1752,1308,444,54605,2.59684684685,1.13443191674
"Alpine County, California",2012,1197,43.2,1815,1430,385,59931,3.10909090909,1.19465329992
"Alpine County, California",2015,1131,43.6,1801,1443,358,52917,3.15921787709,1.27586206897
"Amador County, California",2009,38039,46.3,17238,2874,14364,57347,2.64821776664,0.0755540366466
"Amador County, California",2012,37764,48.4,18017,3781,14236,53462,2.6527114358,0.10012180913
"Amador County, California",2015,36995,50,18184,4259,13925,54171,2.65673249551,0.11512366536
"Amelia County, Virginia",2009,12581,41.5,5336,471,4865,48897,2.58602261048,0.0374374056116
"Amelia County, Virginia",2012,12674,41.6,5369,592,4777,50596,2.65312957923,0.0467097995897
"Amelia County, Virginia",2015,12777,45.8,5414,710,4704,56850,2.71619897959,0.0555685998278
"Amherst County, Virginia",2009,32185,40.5,13787,1099,12688,45947,2.53664880202,0.0341463414634
"Amherst County, Virginia",2012,32301,42.4,13972,1289,12683,45020,2.54679492234,0.0399058852667
"Amherst County, Virginia",2015,32148,43.6,14058,1556,12502,47558,2.57142857143,0.0484011447057
"Amite County, Mississippi",2009,13293,41.4,6821,1643,5178,27728,2.56720741599,0.123598886632
"Amite County, Mississippi",2012,13139,44.3,6638,1447,5191,30471,2.5311115392,0.110130146891
"Amite County, Mississippi",2015,12840,45.3,6636,1651,4985,30704,2.57572718154,0.128582554517
"Anchorage Municipality, Alaska",2009,280389,32.2,110982,7380,103602,70151,2.70640528175,0.0263205760568
"Anchorage Municipality, Alaska",2012,291470,32.9,113070,7553,105517,76495,2.76230370462,0.0259134730847
"Anchorage Municipality, Alaska",2015,299107,32.5,114083,8908,105175,78326,2.8438982648,0.0297819843735
"Anderson County, Kansas",2009,7900,41.4,3723,608,3115,40212,2.53611556982,0.0769620253165
"Anderson County, Kansas",2012,8066,43,3722,442,3280,43060,2.45914634146,0.0547979171832
"Anderson County, Kansas",2015,7896,41.7,3712,432,3280,40696,2.40731707317,0.0547112462006
"Anderson County, Kentucky",2009,21122,37.8,8958,744,8214,51164,2.57146335525,0.0352239371272
"Anderson County, Kentucky",2012,21442,38.3,9138,769,8369,52294,2.5620743219,0.0358641917732
"Anderson County, Kentucky",2015,21761,39.9,9222,776,8446,53974,2.57648591049,0.0356601259133
"Anderson County, South Carolina",2009,179914,38.9,82326,11729,70597,43109,2.54846523223,0.0651922585235
"Anderson County, South Carolina",2012,187228,40,84707,11697,73010,42659,2.56441583345,0.0624746298631
"Anderson County, South Carolina",2015,191215,40.5,85296,11273,74023,42143,2.5831836051,0.0589545799231
"Anderson County, Tennessee",2009,73382,41.1,34159,3308,30851,42643,2.37859388675,0.0450791747295
"Anderson County, Tennessee",2012,75039,42.4,34713,3843,30870,44154,2.43080660836,0.0512133690481
"Anderson County, Tennessee",2015,75430,43.2,34767,4155,30612,42880,2.4640663792,0.0550841840117
"Anderson County, Texas",2009,56575,37.2,19366,3869,15497,39355,3.65070658837,0.0683870967742
"Anderson County, Texas",2012,58269,38.8,20089,3844,16245,41471,3.58688827331,0.0659698982306
"Anderson County, Texas",2015,57915,38.9,20134,3397,16737,41327,3.46029754436,0.0586549253216
"Andrew County, Missouri",2009,16831,39.9,6986,487,6499,52330,2.58978304355,0.0289347038203
"Andrew County, Missouri",2012,17205,41.9,7285,587,6698,57406,2.56867721708,0.0341179889567
"Andrew County, Missouri",2015,17328,42.3,7303,495,6808,55613,2.54524089307,0.0285664819945
"Andrews County, Texas",2009,13295,34.1,5657,538,5119,47227,2.59718695058,0.0404663407296
"Andrews County, Texas",2012,15006,33.8,5833,650,5183,55327,2.89523442022,0.0433160069306
"Andrews County, Texas",2015,16775,31.3,6013,537,5476,70423,3.06336742148,0.0320119225037
"Androscoggin County, Maine",2009,106765,39.2,48330,4840,43490,43714,2.45493216831,0.0453332084485
"Androscoggin County, Maine",2012,107766,39.8,49108,4954,44154,44826,2.44068487566,0.0459699719763
"Androscoggin County, Maine",2015,107393,40.6,49164,4528,44636,47537,2.40597275742,0.0421628970231
"Angelina County, Texas",2009,82465,35.4,34300,4053,30247,38862,2.72638608788,0.0491481234463
"Angelina County, Texas",2012,86550,36.2,35614,4768,30846,40150,2.80587434351,0.0550895436164
"Angelina County, Texas",2015,87748,36.4,36070,5487,30583,44223,2.86917568584,0.0625313397456
"Anne Arundel County, Maryland",2009,513711,37.6,202510,12202,190308,81824,2.69936629043,0.0237526547027
"Anne Arundel County, Maryland",2012,538473,38.4,212860,14099,198761,86987,2.70914817293,0.0261832998126
"Anne Arundel County, Maryland",2015,555280,38.4,217545,14209,203336,89860,2.73084943148,0.0255888920905
"Anoka County, Minnesota",2009,326489,36,123706,5189,118517,69407,2.7547862332,0.0158933379072
"Anoka County, Minnesota",2012,331649,37.1,126892,5296,121596,69916,2.72746636403,0.0159686897895
"Anoka County, Minnesota",2015,338764,37.9,128780,4303,124477,70873,2.72149875077,0.0127020580699
"Anson County, North Carolina",2009,25243,39.2,10594,1702,8892,33706,2.83884390463,0.0674246325714
"Anson County, North Carolina",2012,26699,39.5,11515,1896,9619,34772,2.77565235471,0.0710138956515
"Anson County, North Carolina",2015,26135,39.7,11528,2017,9511,33228,2.74787088634,0.0771762004974
"Antelope County, Nebraska",2009,6729,45,3360,505,2855,35883,2.35691768827,0.0750482984099
"Antelope County, Nebraska",2012,6655,46.5,3287,451,2836,40397,2.34661495063,0.0677685950413
"Antelope County, Nebraska",2015,6486,46.5,3261,440,2821,45609,2.29918468628,0.0678384212149
"Antrim County, Michigan",2009,24088,45.1,16552,6811,9741,43167,2.47284673032,0.282754898705
"Antrim County, Michigan",2012,23634,48,17749,8030,9719,43171,2.43173165964,0.339764745705
"Antrim County, Michigan",2015,23267,49.5,17811,8122,9689,46845,2.40138301166,0.349078093437
"Apache County, Arizona",2009,69341,30.2,32552,13705,18847,28378,3.67915318088,0.197646414098
"Apache County, Arizona",2012,71618,32.1,32548,13513,19035,31615,3.76243761492,0.188681616353
"Apache County, Arizona",2015,72124,33.4,32661,13389,19272,31757,3.74242424242,0.185638622373
"Appanoose County, Iowa",2009,12975,43.1,6750,984,5766,32943,2.25026014568,0.075838150289
"Appanoose County, Iowa",2012,12858,44.2,6629,1148,5481,37866,2.34592227696,0.0892829366931
"Appanoose County, Iowa",2015,12669,44.7,6596,1115,5481,41394,2.31143951834,0.088010103402
"Appling County, Georgia",2009,17871,37.4,8064,1258,6806,33537,2.6257713782,0.0703933747412
"Appling County, Georgia",2012,18279,38.8,8485,1438,7047,35875,2.5938697318,0.0786695114612
"Appling County, Georgia",2015,18417,38.6,8434,1622,6812,37135,2.70361127422,0.0880708041483
"Appomattox County, Virginia",2009,14218,42.2,6468,740,5728,47412,2.48219273743,0.0520467013645
"Appomattox County, Virginia",2012,14952,42.3,6903,1001,5902,50092,2.53337851576,0.0669475655431
"Appomattox County, Virginia",2015,15208,42.3,7051,1120,5931,48823,2.56415444276,0.0736454497633
"Aransas County, Texas",2009,24499,46,14520,4554,9966,41172,2.45825807746,0.185885138169
"Aransas County, Texas",2012,23391,48.3,15330,5505,9825,44769,2.38076335878,0.235346928306
"Aransas County, Texas",2015,24292,49,15614,5932,9682,41690,2.50898574675,0.244195619957
"Arapahoe County, Colorado",2009,544157,35.5,229072,16607,212465,58968,2.56116066176,0.0305187657239
"Arapahoe County, Colorado",2012,574357,35.7,238160,14413,223747,60400,2.566993077,0.0250941487611
"Arapahoe County, Colorado",2015,608310,36.1,241431,11830,229601,63265,2.64942225861,0.0194473212671
"Archer County, Texas",2009,8936,40.9,4017,669,3348,51792,2.66905615293,0.0748657117278
"Archer County, Texas",2012,8944,42.9,4110,780,3330,56250,2.68588588589,0.0872093023256
"Archer County, Texas",2015,8779,44.1,4129,779,3350,60275,2.62059701493,0.0887344800091
"Archuleta County, Colorado",2009,12225,21.7,8247,5533,2714,54909,4.50442151805,0.452597137014
"Archuleta County, Colorado",2012,12109,47.5,8742,4206,4536,54007,2.66953262787,0.347344950037
"Archuleta County, Colorado",2015,12174,49.6,8879,3545,5334,46646,2.28233970754,0.291194348612
"Arecibo Municipio, Puerto Rico",2009,102429,36.9,38749,7445,31304,16158,3.27207385638,0.0726844936493
"Arecibo Municipio, Puerto Rico",2012,96176,38.7,40017,8116,31901,17077,3.01482712141,0.0843869572451
"Arecibo Municipio, Puerto Rico",2015,92511,40.2,41472,9185,32287,16485,2.86527085205,0.0992854903741
"Arenac County, Michigan",2009,16561,44.6,10105,3175,6930,36299,2.38975468975,0.191715476119
"Arenac County, Michigan",2012,15952,46.7,9824,3389,6435,36937,2.47894327894,0.212449849549
"Arenac County, Michigan",2015,15424,48.4,9767,3320,6447,38307,2.39243058787,0.215248962656
"Arkansas County, Arkansas",2009,19385,42,9932,1544,8388,36341,2.31103958035,0.0796492133093
"Arkansas County, Arkansas",2012,19029,41.5,9462,1465,7997,39883,2.37951731899,0.076987755531
"Arkansas County, Arkansas",2015,18731,41.4,9444,1701,7743,36411,2.4190882087,0.0908120228498
"Arlington County, Virginia",2009,206405,33.4,100724,10421,90303,93806,2.28569372003,0.0504881180204
"Arlington County, Virginia",2012,209077,33.7,105395,12403,92992,102459,2.24833318995,0.0593226418975
"Arlington County, Virginia",2015,223945,33.9,109443,11002,98441,105763,2.2749159395,0.0491281341401
"Armstrong County, Pennsylvania",2009,68806,43.8,32799,3772,29027,41075,2.37041375271,0.0548208005116
"Armstrong County, Pennsylvania",2012,68942,44.6,32517,3793,28724,44478,2.40015318201,0.055017260886
"Armstrong County, Pennsylvania",2015,67979,45.6,32411,3887,28524,44942,2.3832211471,0.0571794230571
"Armstrong County, Texas",2009,2014,44.7,954,185,769,58516,2.61898569571,0.091857000993
"Armstrong County, Texas",2012,1820,44.8,897,229,668,56974,2.7245508982,0.125824175824
"Armstrong County, Texas",2015,1943,45.1,933,219,714,59737,2.72128851541,0.112712300566
"Aroostook County, Maine",2009,71974,43.7,39473,8813,30660,35439,2.34748858447,0.122446994748
"Aroostook County, Maine",2012,71757,45.2,39519,9087,30432,37434,2.3579455836,0.126635728918
"Aroostook County, Maine",2015,70005,46.6,39477,9122,30355,36923,2.30620985011,0.130304978216
"Arroyo Municipio, Puerto Rico",2009,18997,34.6,7697,1500,6197,14887,3.06551557205,0.0789598357635
"Arroyo Municipio, Puerto Rico",2012,19542,35.2,8053,1994,6059,16114,3.22528470045,0.102036639034
"Arroyo Municipio, Puerto Rico",2015,19018,37.2,8564,2283,6281,15298,3.02786180544,0.120044168682
"Arthur County, Nebraska",2009,364,33.4,200,61,139,44750,2.61870503597,0.167582417582
"Arthur County, Nebraska",2012,490,37.4,236,56,180,45769,2.72222222222,0.114285714286
"Arthur County, Nebraska",2015,448,39.9,253,73,180,39375,2.48888888889,0.162946428571
"Ascension Parish, Louisiana",2009,98471,33.7,38101,3269,34832,60874,2.82702687184,0.033197591169
"Ascension Parish, Louisiana",2012,107647,34.4,40979,3648,37331,67688,2.88358200959,0.0338885431085
"Ascension Parish, Louisiana",2015,114738,34.8,43255,3145,40110,70551,2.86058339566,0.0274102738413
"Ashe County, North Carolina",2009,25467,44.6,15302,3963,11339,35312,2.24596525267,0.155613146425
"Ashe County, North Carolina",2012,27099,45.4,17243,5306,11937,35670,2.27016838402,0.195800583047
"Ashe County, North Carolina",2015,27114,46.6,17441,5655,11786,36267,2.30052604785,0.208563841558
"Ashland County, Ohio",2009,54622,38.1,21974,2003,19971,45556,2.73506584548,0.036670206144
"Ashland County, Ohio",2012,53203,39.5,22128,1862,20266,44996,2.62523438271,0.0349980264271
"Ashland County, Ohio",2015,53189,39.9,22104,1677,20427,48003,2.6038576394,0.0315290755607
"Ashland County, Wisconsin",2009,16307,39.2,9395,2513,6882,37245,2.36951467597,0.154105598823
"Ashland County, Wisconsin",2012,16113,41,9624,2820,6804,39157,2.36816578483,0.17501396388
"Ashland County, Wisconsin",2015,15993,42.2,9625,2907,6718,39381,2.38061923191,0.181767023073
"Ashley County, Arkansas",2009,22337,38.7,11076,1632,9444,33007,2.36520542143,0.0730626315083
"Ashley County, Arkansas",2012,21811,39.5,10181,1407,8774,38069,2.48586733531,0.064508734125
"Ashley County, Arkansas",2015,21229,41.4,10104,1777,8327,34263,2.54941755734,0.0837062508832
"Ashtabula County, Ohio",2009,101375,40.3,45727,6688,39039,41498,2.59676221215,0.0659728729963
"Ashtabula County, Ohio",2012,101262,41.1,46055,7166,38889,41075,2.60387256036,0.0707669214513
"Ashtabula County, Ohio",2015,99777,41.8,45907,7017,38890,40544,2.56562098226,0.0703268288283
"Asotin County, Washington",2009,21198,42.3,9520,859,8661,40643,2.44752338067,0.0405226908199
"Asotin County, Washington",2012,21658,43.3,9825,779,9046,42305,2.39420738448,0.0359682334472
"Asotin County, Washington",2015,22040,44.2,9855,514,9341,44394,2.35949041858,0.0233212341198
"Assumption Parish, Louisiana",2009,22986,38.3,10512,1919,8593,43003,2.67496799721,0.0834855999304
"Assumption Parish, Louisiana",2012,23321,38.8,10362,1708,8654,46410,2.69482320314,0.0732387118906
"Assumption Parish, Louisiana",2015,23057,39.3,10470,1810,8660,49167,2.66247113164,0.0785011059548
"Atascosa County, Texas",2009,43524,35.4,15909,2275,13634,41178,3.19231333431,0.0522700119474
"Atascosa County, Texas",2012,45091,35.8,17549,2554,14995,45702,3.00706902301,0.0566410148367
"Atascosa County, Texas",2015,47050,35.5,17788,2425,15363,52192,3.06255288681,0.0515409139214
"Atchison County, Kansas",2009,16469,36,6991,854,6137,45146,2.68355874206,0.0518550003036
"Atchison County, Kansas",2012,16854,35.8,6978,915,6063,45666,2.77981197427,0.0542897828409
"Atchison County, Kansas",2015,16633,35.9,6958,925,6033,43581,2.75700314935,0.0556123369206
"Atchison County, Missouri",2009,6078,45.1,3128,479,2649,39328,2.29445073613,0.0788088186904
"Atchison County, Missouri",2012,5664,46.1,2982,535,2447,46059,2.31467102575,0.0944562146893
"Atchison County, Missouri",2015,5440,47.1,2969,468,2501,43933,2.17512994802,0.0860294117647
"Athens County, Ohio",2009,63073,24.4,25399,3501,21898,30190,2.88030870399,0.0555071108081
"Athens County, Ohio",2012,64592,26.4,26299,4078,22221,33836,2.90679987399,0.0631347535298
"Athens County, Ohio",2015,64974,28,26260,3774,22486,33872,2.8895312639,0.0580847723705
"Atkinson County, Georgia",2009,8124,31,3262,634,2628,33548,3.09132420091,0.0780403741999
"Atkinson County, Georgia",2012,8355,34.2,3512,793,2719,28682,3.07282089003,0.0949132256134
"Atkinson County, Georgia",2015,8294,34.9,3476,704,2772,30933,2.99206349206,0.0848806366048
"Atlantic County, New Jersey",2009,270016,39.2,125866,23229,102637,54934,2.63078616873,0.0860282353638
"Atlantic County, New Jersey",2012,274402,40.1,126824,25806,101018,54559,2.71636738007,0.0940445040488
"Atlantic County, New Jersey",2015,275376,40.6,127435,25617,101818,54461,2.70459054391,0.0930255359944
"Atoka County, Oklahoma",2009,14424,38.5,5906,917,4989,30990,2.89116055322,0.0635745978924
"Atoka County, Oklahoma",2012,14133,39.3,6294,964,5330,36755,2.65159474672,0.0682091558763
"Atoka County, Oklahoma",2015,13906,40.7,6353,1095,5258,36661,2.6447318372,0.078742988638
"Attala County, Mississippi",2009,19558,38.7,9147,1621,7526,30096,2.598724422,0.0828816852439
"Attala County, Mississippi",2012,19454,39.9,9122,1873,7249,31102,2.68368050766,0.096278400329
"Attala County, Mississippi",2015,19175,40.8,9130,1679,7451,32886,2.57348006979,0.0875619295958
"Audrain County, Missouri",2009,25754,39,11127,1381,9746,39028,2.64252000821,0.0536227382154
"Audrain County, Missouri",2012,25617,38.6,10846,1571,9275,41387,2.76194070081,0.0613264628957
"Audrain County, Missouri",2015,25783,39.2,10813,1540,9273,41310,2.78043783026,0.0597292789823
"Audubon County, Iowa",2009,6140,45.8,3002,271,2731,42072,2.24826071036,0.0441368078176
"Audubon County, Iowa",2012,6077,46.7,2970,274,2696,47630,2.25408011869,0.0450880368603
"Audubon County, Iowa",2015,5869,47.8,3005,346,2659,46979,2.20722075968,0.0589538251832
"Auglaize County, Ohio",2009,46620,39.4,19501,1226,18275,52185,2.55102599179,0.0262977262977
"Auglaize County, Ohio",2012,45934,40.2,19565,1223,18342,52267,2.50430705485,0.0266251578352
"Auglaize County, Ohio",2015,45873,41,19641,1448,18193,54274,2.52146429946,0.0315654088462
"Augusta County, Virginia",2009,70991,41.3,30274,2745,27529,49364,2.57877147735,0.0386668732656
"Augusta County, Virginia",2012,73662,43.3,31249,2952,28297,50971,2.60317348129,0.0400749368738
"Augusta County, Virginia",2015,74053,44.2,31724,3574,28150,54558,2.63065719361,0.0482627307469
"Aurora County, South Dakota",2009,2878,44.1,1350,178,1172,43209,2.45563139932,0.0618485059069
"Aurora County, South Dakota",2012,2726,41.7,1248,190,1058,46071,2.57655954631,0.0696991929567
"Aurora County, South Dakota",2015,2729,41.8,1361,204,1157,48750,2.35868625756,0.0747526566508
"Austin County, Texas",2009,26567,39.9,10866,1838,9028,51086,2.94273371732,0.0691835736064
"Austin County, Texas",2012,28372,40.4,12826,2226,10600,51340,2.67660377358,0.0784576342873
"Austin County, Texas",2015,28886,40.6,12978,1940,11038,53687,2.61695959413,0.0671605622101
"Autauga County, Alabama",2009,49584,36,19882,1594,18288,51463,2.71128608924,0.0321474669248
"Autauga County, Alabama",2012,54590,37,22077,2143,19934,53773,2.73853717267,0.0392562740429
"Autauga County, Alabama",2015,55221,37.7,22582,2186,20396,51281,2.70744263581,0.039586389236
"Avery County, North Carolina",2009,17903,39.9,13471,6404,7067,34676,2.53332389982,0.357705412501
"Avery County, North Carolina",2012,17815,42.2,13860,6659,7201,38051,2.47396194973,0.373786135279
"Avery County, North Carolina",2015,17695,43.7,13988,7187,6801,37777,2.60182326129,0.406159932184
"Avoyelles Parish, Louisiana",2009,42184,36.6,17785,1922,15863,31123,2.65926999937,0.0455622985018
"Avoyelles Parish, Louisiana",2012,41925,38.5,18034,2451,15583,34512,2.6904318809,0.0584615384615
"Avoyelles Parish, Louisiana",2015,41389,38.2,18157,3214,14943,33739,2.76979187579,0.0776534828094
"Añasco Municipio, Puerto Rico",2009,30098,36.7,10615,1787,8828,14435,3.40937924785,0.0593727157951
"Añasco Municipio, Puerto Rico",2012,29236,38.6,11457,2195,9262,16771,3.15655366012,0.0750786701327
"Añasco Municipio, Puerto Rico",2015,28579,40.4,12368,2796,9572,17386,2.98568742165,0.0978340739704
"Baca County, Colorado",2009,3847,47,2441,662,1779,33504,2.16245081506,0.172082141929
"Baca County, Colorado",2012,3783,47.8,2253,578,1675,39497,2.25850746269,0.152788791964
"Baca County, Colorado",2015,3701,47.6,2234,666,1568,38000,2.36033163265,0.179951364496
"Bacon County, Georgia",2009,10464,35.8,4562,984,3578,31661,2.92453884852,0.0940366972477
"Bacon County, Georgia",2012,11124,35.7,4789,788,4001,33557,2.78030492377,0.0708378281194
"Bacon County, Georgia",2015,11222,37.1,4758,807,3951,37162,2.84029359656,0.0719123150953
"Bailey County, Texas",2009,6360,32.8,2948,635,2313,35585,2.74967574578,0.0998427672956
"Bailey County, Texas",2012,7096,33.9,2870,513,2357,41075,3.01060670344,0.0722942502818
"Bailey County, Texas",2015,7126,34.9,2787,395,2392,37397,2.97909698997,0.0554308167275
"Baker County, Florida",2009,25478,34.6,8762,1082,7680,46315,3.31744791667,0.0424680116179
"Baker County, Florida",2012,27010,35.9,9633,1209,8424,47149,3.20631528965,0.0447611995557
"Baker County, Florida",2015,27135,36.6,9634,1429,8205,47121,3.3071297989,0.0526626128616
"Baker County, Georgia",2009,3810,29.6,1636,372,1264,30403,3.01424050633,0.0976377952756
"Baker County, Georgia",2012,3483,41.9,1752,288,1464,24219,2.37909836066,0.0826873385013
"Baker County, Georgia",2015,3292,42.6,1660,369,1291,44297,2.54996127033,0.112089914945
"Baker County, Oregon",2009,16027,47.3,8785,1739,7046,38401,2.27462390009,0.108504398827
"Baker County, Oregon",2012,16092,48.1,8826,1752,7074,40348,2.27480916031,0.108873974646
"Baker County, Oregon",2015,16052,48.2,8822,1662,7160,41098,2.24189944134,0.103538499875
"Baldwin County, Alabama",2009,171997,41,99645,31148,68497,48918,2.51101508095,0.18109618191
"Baldwin County, Alabama",2012,183226,41.2,103984,31233,72751,50706,2.51853582769,0.17046161571
"Baldwin County, Alabama",2015,195121,42.2,106422,32318,74104,50254,2.63306973983,0.165630557449
"Baldwin County, Georgia",2009,46252,34.8,19180,3860,15320,38273,3.01906005222,0.0834558505578
"Baldwin County, Georgia",2012,46378,34.2,20099,3666,16433,35278,2.82224791578,0.0790460994437
"Baldwin County, Georgia",2015,45795,34.1,20205,4227,15978,32460,2.86612842659,0.0923026531281
"Ballard County, Kentucky",2009,8181,42,4019,517,3502,41276,2.33609366077,0.0631952084097
"Ballard County, Kentucky",2012,8268,41.6,3896,517,3379,41989,2.44687777449,0.0625302370585
"Ballard County, Kentucky",2015,8256,42.8,3889,601,3288,42244,2.51094890511,0.0727955426357
"Baltimore County, Maryland",2009,786697,38.4,327067,16608,310459,63348,2.53398033235,0.021111050379
"Baltimore County, Maryland",2012,807318,39,335288,20465,314823,66068,2.56435520912,0.0253493666684
"Baltimore County, Maryland",2015,822959,39.1,336682,23782,312900,67095,2.6301022691,0.0288981589605
"Baltimore city, Maryland",2009,639337,34.3,294617,56798,237819,38738,2.68833440558,0.0888389065548
"Baltimore city, Maryland",2012,620644,34.4,296437,55807,240630,40803,2.57924614553,0.0899178917383
"Baltimore city, Maryland",2015,622454,34.6,296727,54459,242268,42241,2.56927865009,0.0874908025332
"Bamberg County, South Carolina",2009,15384,38.4,7259,1884,5375,30889,2.86213953488,0.122464898596
"Bamberg County, South Carolina",2012,15941,38.9,7678,1918,5760,31015,2.76753472222,0.120318675114
"Bamberg County, South Carolina",2015,15432,40.3,7646,1725,5921,31314,2.60631650059,0.111780715397
"Bandera County, Texas",2009,20137,46.2,10088,2768,7320,44244,2.75095628415,0.137458409892
"Bandera County, Texas",2012,20477,48.5,11490,2995,8495,47927,2.41047675103,0.146261659423
"Bandera County, Texas",2015,20796,51.5,11592,3300,8292,49863,2.50795947902,0.158684362377
"Banks County, Georgia",2009,16388,36.8,6801,988,5813,41039,2.81919834853,0.0602880156212
"Banks County, Georgia",2012,18250,38.2,7552,769,6783,40162,2.69054990417,0.0421369863014
"Banks County, Georgia",2015,18336,40.4,7565,1012,6553,41472,2.79810773691,0.0551919720768
"Banner County, Nebraska",2009,824,45.5,408,42,366,32833,2.25136612022,0.0509708737864
"Banner County, Nebraska",2012,778,45.2,379,70,309,32292,2.51779935275,0.0899742930591
"Banner County, Nebraska",2015,820,50.4,406,67,339,48897,2.41887905605,0.0817073170732
"Bannock County, Idaho",2009,80428,29.6,31667,2365,29302,44162,2.74479557709,0.0294051822748
"Bannock County, Idaho",2012,82584,31.5,33125,2919,30206,45860,2.73402635238,0.0353458297007
"Bannock County, Idaho",2015,83604,32.7,33337,2943,30394,43779,2.75067447523,0.0352016649921
"Baraga County, Michigan",2009,8650,41.7,4952,1871,3081,40849,2.80753002272,0.216300578035
"Baraga County, Michigan",2012,8808,43.3,5246,2085,3161,39594,2.78645998102,0.236716621253
"Baraga County, Michigan",2015,8690,43.6,5235,2261,2974,39803,2.92199058507,0.260184119678
"Barber County, Kansas",2009,4714,46.5,2762,461,2301,38497,2.04867448935,0.0977938056852
"Barber County, Kansas",2012,4867,46.4,2809,558,2251,43048,2.16215015549,0.114649681529
"Barber County, Kansas",2015,4770,44.9,2792,811,1981,51811,2.4078748107,0.170020964361
"Barbour County, Alabama",2009,29663,37.5,12956,2311,10645,32537,2.78656646313,0.0779085055456
"Barbour County, Alabama",2012,27469,38.2,11878,2455,9423,31889,2.91510134777,0.0893734755543
"Barbour County, Alabama",2015,26932,38.8,11810,2588,9222,32964,2.92040772067,0.096093866033
"Barbour County, West Virginia",2009,15522,41.6,7611,1504,6107,30875,2.54167348944,0.0968947300606
"Barbour County, West Virginia",2012,16472,41.4,7830,1624,6206,36087,2.65420560748,0.0985915492958
"Barbour County, West Virginia",2015,16731,41.5,7850,1809,6041,37066,2.76957457375,0.108122646584
"Barceloneta Municipio, Puerto Rico",2009,23029,33.5,9044,1283,7761,15708,2.96727225873,0.0557123626732
"Barceloneta Municipio, Puerto Rico",2012,24815,35.6,9518,1480,8038,15034,3.08721074894,0.0596413459601
"Barceloneta Municipio, Puerto Rico",2015,24775,37,9845,1530,8315,15212,2.97955502105,0.06175580222
"Barnes County, North Dakota",2009,10840,43.9,5769,777,4992,41911,2.17147435897,0.0716789667897
"Barnes County, North Dakota",2012,11047,44,5706,827,4879,48317,2.26419348227,0.0748619534715
"Barnes County, North Dakota",2015,11097,42.8,5723,667,5056,53141,2.19481803797,0.0601063350455
"Barnstable County, Massachusetts",2009,222629,48.1,154792,57673,97119,60096,2.29233208744,0.259054301102
"Barnstable County, Massachusetts",2012,216021,49.9,160020,64500,95520,60424,2.26152638191,0.298582082298
"Barnstable County, Massachusetts",2015,214766,51.3,161311,66894,94417,63251,2.27465392885,0.311473883203
"Barnwell County, South Carolina",2009,22914,37.6,10374,1962,8412,35888,2.7239657632,0.0856245090338
"Barnwell County, South Carolina",2012,22523,38.9,10448,2245,8203,35748,2.74570279166,0.0996758868712
"Barnwell County, South Carolina",2015,22098,39.8,10411,2067,8344,34336,2.64837008629,0.0935378767309
"Barranquitas Municipio, Puerto Rico",2009,30389,30.4,9754,863,8891,13770,3.4179507367,0.0283984336438
"Barranquitas Municipio, Puerto Rico",2012,30322,32,10348,1413,8935,14907,3.39362059317,0.0465998285074
"Barranquitas Municipio, Puerto Rico",2015,29805,34.3,11080,1761,9319,14331,3.19830453911,0.059084046301
"Barren County, Kentucky",2009,40953,39.8,18110,1645,16465,36919,2.48727604009,0.0401679974605
"Barren County, Kentucky",2012,42229,39.9,19166,2318,16848,37587,2.50646961064,0.0548911885197
"Barren County, Kentucky",2015,42925,40.4,19372,2393,16979,38370,2.52812297544,0.0557483983692
"Barron County, Wisconsin",2009,45612,42.4,23322,3704,19618,42928,2.32500764604,0.0812066999912
"Barron County, Wisconsin",2012,45882,42.7,23558,4548,19010,44149,2.41357180431,0.0991238394141
"Barron County, Wisconsin",2015,45686,43.9,23683,4563,19120,45714,2.38943514644,0.0998774241562
"Barrow County, Georgia",2009,66458,32.7,25362,2651,22711,48285,2.92624719299,0.0398898552469
"Barrow County, Georgia",2012,69136,33.6,26392,2774,23618,51202,2.92725887035,0.040123813932
"Barrow County, Georgia",2015,72012,34.8,26700,3140,23560,52012,3.05653650255,0.0436038438038
"Barry County, Michigan",2009,58815,39.8,26061,3625,22436,53848,2.62145658763,0.0616339369209
"Barry County, Michigan",2012,59249,41.3,26967,4512,22455,53541,2.63856602093,0.07615318402
"Barry County, Michigan",2015,59147,42.6,27044,4208,22836,55064,2.59007707129,0.0711447748829
"Barry County, Missouri",2009,35905,39.2,16948,2770,14178,36411,2.53244463253,0.0771480295224
"Barry County, Missouri",2012,35680,41.8,17460,3804,13656,38153,2.61277094318,0.106614349776
"Barry County, Missouri",2015,35726,43.3,17436,4190,13246,39033,2.69711611052,0.117281531658
"Bartholomew County, Indiana",2009,74681,38.1,31413,2867,28546,52545,2.61616338541,0.0383899519289
"Bartholomew County, Indiana",2012,77297,38.1,33042,2967,30075,54481,2.57014131338,0.0383844133666
"Bartholomew County, Indiana",2015,79488,38.1,33422,2904,30518,55050,2.60462677764,0.0365338164251
"Barton County, Kansas",2009,27654,40.6,13023,1438,11585,42103,2.3870522227,0.0519997107109
"Barton County, Kansas",2012,27556,40,12706,1396,11310,46639,2.43642793988,0.0506604732182
"Barton County, Kansas",2015,27399,39.3,12617,1311,11306,44013,2.42340350257,0.0478484616227
"Barton County, Missouri",2009,12695,39.1,5648,699,4949,41124,2.56516467973,0.0550610476566
"Barton County, Missouri",2012,12428,40.5,5604,672,4932,39576,2.5198702352,0.054071451561
"Barton County, Missouri",2015,12166,41.1,5576,588,4988,37467,2.43905372895,0.04833141542
"Bartow County, Georgia",2009,92490,35.3,36771,3935,32836,50075,2.81672554513,0.0425451400151
"Bartow County, Georgia",2012,99872,36.7,39680,5082,34598,49543,2.88664084629,0.0508851329702
"Bartow County, Georgia",2015,101336,37.4,39838,4106,35732,48893,2.83600134333,0.0405186705613
"Bastrop County, Texas",2009,71928,37.2,24999,2981,22018,50585,3.26678172404,0.0414442219998
"Bastrop County, Texas",2012,74023,38.3,29116,3645,25471,52516,2.90616779867,0.0492414519811
"Bastrop County, Texas",2015,76948,38.7,29522,4068,25454,54821,3.0230219219,0.0528668711338
"Bates County, Missouri",2009,16906,39.9,7560,1205,6355,39071,2.6602675059,0.0712764698923
"Bates County, Missouri",2012,17003,41.5,7845,1112,6733,39371,2.52532303579,0.06540022349
"Bates County, Missouri",2015,16643,41.9,7832,1142,6690,41060,2.48774289985,0.0686174367602
"Bath County, Kentucky",2009,11597,38.4,5315,1156,4159,29054,2.78841067564,0.0996809519703
"Bath County, Kentucky",2012,11665,40.4,5398,977,4421,29632,2.63854331599,0.0837548221174
"Bath County, Kentucky",2015,11978,40.4,5390,1093,4297,33483,2.78752618106,0.0912506261479
"Bath County, Virginia",2009,4636,45.2,2974,985,1989,46250,2.33081950729,0.212467644521
"Bath County, Virginia",2012,4713,45.4,3056,1048,2008,51528,2.34711155378,0.222363674942
"Bath County, Virginia",2015,4583,48.3,3394,1248,2146,43646,2.13560111836,0.272310713506
"Baxter County, Arkansas",2009,41468,49.7,21276,3260,18016,34534,2.30173179396,0.0786148355358
"Baxter County, Arkansas",2012,41387,50.8,22516,4379,18137,35209,2.28190990792,0.10580617102
"Baxter County, Arkansas",2015,41040,51.5,22613,4449,18164,35396,2.25941422594,0.108406432749
"Bay County, Florida",2009,163451,38.3,96120,27488,68632,46240,2.38155670824,0.168172724547
"Bay County, Florida",2012,168957,39.3,99518,30656,68862,47364,2.4535592925,0.181442615577
"Bay County, Florida",2015,175353,39.8,100109,32187,67922,47368,2.58168192927,0.183555456707
"Bay County, Michigan",2009,107778,41.1,48210,3651,44559,44844,2.41877061873,0.0338751878862
"Bay County, Michigan",2012,107633,41.5,48184,4266,43918,46068,2.45077189307,0.0396346845298
"Bay County, Michigan",2015,106698,42.6,48057,4492,43565,45583,2.44916791002,0.0421001330859
"Bayamón Municipio, Puerto Rico",2009,220606,36.5,79618,8343,71275,25760,3.09513854788,0.0378185543458
"Bayamón Municipio, Puerto Rico",2012,207337,38,81952,10569,71383,24609,2.90457111637,0.0509749827575
"Bayamón Municipio, Puerto Rico",2015,197287,39.3,83980,12605,71375,24430,2.7640910683,0.0638916907855
"Bayfield County, Wisconsin",2009,14938,46.8,12692,5898,6794,43210,2.19870473948,0.394831972152
"Bayfield County, Wisconsin",2012,15078,49.3,13005,6074,6931,44626,2.17544365892,0.402838572755
"Bayfield County, Wisconsin",2015,15050,50.8,13134,6215,6919,46665,2.17516982223,0.412956810631
"Baylor County, Texas",2009,3789,45.9,2863,1161,1702,32569,2.22620446533,0.306413301663
"Baylor County, Texas",2012,3706,50.2,2859,1124,1735,34688,2.13602305476,0.303291958985
"Baylor County, Texas",2015,3628,48.5,2695,972,1723,36373,2.10562971561,0.267916207277
"Beadle County, South Dakota",2009,15845,43.1,8332,1084,7248,42259,2.18612030905,0.0684127485011
"Beadle County, South Dakota",2012,17372,41,8301,1005,7296,43778,2.38103070175,0.0578517154041
"Beadle County, South Dakota",2015,18168,39,8358,793,7565,46267,2.40158625248,0.0436481726112
"Bear Lake County, Idaho",2009,5859,40.5,3530,1121,2409,44263,2.43212951432,0.191329578426
"Bear Lake County, Idaho",2012,5977,39.6,3901,1427,2474,40242,2.41592562652,0.238748536055
"Bear Lake County, Idaho",2015,5939,39.5,3965,1619,2346,48654,2.531543052,0.272604815626
"Beaufort County, North Carolina",2009,45993,43.5,23803,4555,19248,39817,2.38949501247,0.0990368099493
"Beaufort County, North Carolina",2012,47542,44,24728,5049,19679,40147,2.41587479039,0.106200832948
"Beaufort County, North Carolina",2015,47561,44.9,25217,6701,18516,40391,2.56864333549,0.14089274826
"Beaufort County, South Carolina",2009,147799,39.7,80306,22108,58198,54131,2.53958898931,0.149581526262
"Beaufort County, South Carolina",2012,162316,41.2,92373,28331,64042,56581,2.53452421848,0.174542250918
"Beaufort County, South Carolina",2015,171420,42.8,93858,27883,65975,57048,2.5982569155,0.162658966282
"Beauregard Parish, Louisiana",2009,34828,36.3,15259,2173,13086,43441,2.66147027357,0.0623923280119
"Beauregard Parish, Louisiana",2012,35662,37.4,15068,2108,12960,46762,2.75169753086,0.0591105378274
"Beauregard Parish, Louisiana",2015,36259,37.5,15201,2049,13152,45969,2.75691909976,0.0565101078353
"Beaver County, Oklahoma",2009,5311,42.4,2728,491,2237,47753,2.37416182387,0.0924496328375
"Beaver County, Oklahoma",2012,5587,40.9,2674,606,2068,50466,2.70164410058,0.108466081976
"Beaver County, Oklahoma",2015,5530,41.5,2663,646,2017,52090,2.74169558751,0.116817359855
"Beaver County, Pennsylvania",2009,173277,43.5,79611,7979,71632,45414,2.41898872013,0.0460476577965
"Beaver County, Pennsylvania",2012,170614,44.2,78311,7596,70715,48311,2.41269886163,0.0445215515726
"Beaver County, Pennsylvania",2015,169785,44.8,78292,8213,70079,50581,2.42276573581,0.0483729422505
"Beaver County, Utah",2009,6139,31.8,2870,827,2043,39362,3.0048947626,0.134712493892
"Beaver County, Utah",2012,6527,31.5,2909,847,2062,45948,3.16537342386,0.129768653286
"Beaver County, Utah",2015,6461,33,2927,678,2249,50282,2.87283236994,0.104937316205
"Beaverhead County, Montana",2009,8887,41.5,4632,1079,3553,37038,2.50126653532,0.121413300326
"Beaverhead County, Montana",2012,9228,44,5249,1139,4110,41039,2.24525547445,0.123428695275
"Beaverhead County, Montana",2015,9291,42.6,5259,1179,4080,41512,2.27720588235,0.126896997094
"Becker County, Minnesota",2009,31832,42.4,18426,5072,13354,46142,2.38370525685,0.159336516713
"Becker County, Minnesota",2012,32600,42.6,18821,5367,13454,49159,2.42307120559,0.16463190184
"Becker County, Minnesota",2015,33138,42.4,19060,5498,13562,52038,2.44344491963,0.16591224576
"Beckham County, Oklahoma",2009,20268,35.2,9164,1697,7467,41225,2.71434310968,0.0837280442076
"Beckham County, Oklahoma",2012,22519,35.1,9628,1730,7898,51506,2.85122815903,0.076824015276
"Beckham County, Oklahoma",2015,23300,34.7,9831,2296,7535,48601,3.09223623092,0.0985407725322
"Bedford County, Pennsylvania",2009,49648,42.5,24438,4339,20099,39827,2.47017264541,0.087395262649
"Bedford County, Pennsylvania",2012,49680,43.8,23994,3835,20159,41512,2.46440795674,0.077194041868
"Bedford County, Pennsylvania",2015,49086,45,24012,4012,20000,45930,2.4543,0.0817340993359
"Bedford County, Tennessee",2009,44291,35,17190,1615,15575,37917,2.84372391653,0.0364633898535
"Bedford County, Tennessee",2012,45060,36.5,18311,2169,16142,39635,2.79147565357,0.0481358189081
"Bedford County, Tennessee",2015,45986,36.6,18519,1798,16721,41984,2.75019436637,0.0390988561736
"Bedford County, Virginia",2009,65916,42.5,30950,4074,26876,54527,2.45259711267,0.0618059348261
"Bedford County, Virginia",2012,68750,44,31991,4974,27017,56906,2.5446940815,0.0723490909091
"Bedford County, Virginia",2015,76463,45.3,35546,4955,30591,56316,2.49952600438,0.0648025842564
"Bedford city, Virginia",2009,6291,40.4,3097,286,2811,31796,2.23799359658,0.0454617707837
"Bedford city, Virginia",2012,6103,44.7,3057,334,2723,35863,2.2412780022,0.0547271833524
"Bee County, Texas",2009,32413,33.8,11230,2123,9107,35759,3.5591303393,0.0654984111313
"Bee County, Texas",2012,32083,35.4,10685,2004,8681,40707,3.69577237645,0.0624629866284
"Bee County, Texas",2015,32659,35.3,10651,1889,8762,42302,3.72734535494,0.0578401053308
"Belknap County, New Hampshire",2009,61102,43,35524,11595,23929,54565,2.55347068411,0.189764655821
"Belknap County, New Hampshire",2012,60206,44.5,37312,12185,25127,57163,2.39606797469,0.202388466266
"Belknap County, New Hampshire",2015,60399,46.1,37611,13014,24597,62159,2.45554335895,0.215467143496
"Bell County, Kentucky",2009,29093,38.6,13892,2670,11222,22559,2.59249688113,0.0917746536968
"Bell County, Kentucky",2012,28613,41.1,13195,2314,10881,25952,2.62962962963,0.0808723307587
"Bell County, Kentucky",2015,27950,41.1,13109,2021,11088,22443,2.52074314574,0.0723076923077
"Bell County, Texas",2009,275594,28.5,112653,16275,96378,46473,2.85951150678,0.0590542609781
"Bell County, Texas",2012,310155,29.7,125526,21811,103715,50085,2.99045461119,0.0703229030646
"Bell County, Texas",2015,326041,30.2,131684,21840,109844,50550,2.96821856451,0.0669854404814
"Belmont County, Ohio",2009,68372,42.6,31508,3165,28343,37753,2.41230638958,0.0462908793073
"Belmont County, Ohio",2012,70182,43.5,32408,3692,28716,41676,2.44400334308,0.0526060813314
"Belmont County, Ohio",2015,69560,43.9,32220,4285,27935,43833,2.49006622517,0.0616014951121
"Beltrami County, Minnesota",2009,43407,32.5,18578,3005,15573,43678,2.78732421499,0.0692284654549
"Beltrami County, Minnesota",2012,44652,33.5,20438,3750,16688,44038,2.67569511026,0.0839828003225
"Beltrami County, Minnesota",2015,45434,33.3,20725,3986,16739,44757,2.71426011112,0.0877316547079
"Ben Hill County, Georgia",2009,17535,36.1,8004,1328,6676,30078,2.62657279808,0.0757342457941
"Ben Hill County, Georgia",2012,17612,38,7944,1561,6383,29162,2.75920413599,0.0886327503975
"Ben Hill County, Georgia",2015,17477,38.6,7914,1501,6413,29994,2.72524559489,0.0858843050867
"Benewah County, Idaho",2009,9246,43.1,4386,718,3668,38198,2.52071973828,0.0776552022496
"Benewah County, Idaho",2012,9247,44.6,4606,844,3762,38536,2.45800106326,0.0912728452471
"Benewah County, Idaho",2015,9088,45.4,4631,963,3668,39863,2.47764449291,0.105963908451
"Bennett County, South Dakota",2009,3408,35.6,1345,234,1111,36580,3.06750675068,0.068661971831
"Bennett County, South Dakota",2012,3432,27.8,1266,160,1106,36429,3.10307414105,0.04662004662
"Bennett County, South Dakota",2015,3438,29.4,1217,167,1050,42171,3.27428571429,0.0485747527632
"Bennington County, Vermont",2009,36466,44,20675,5075,15600,46265,2.33756410256,0.139170734383
"Bennington County, Vermont",2012,36990,45.1,20874,5264,15610,48938,2.36963484946,0.14230873209
"Bennington County, Vermont",2015,36589,46.1,20919,5283,15636,49573,2.34004860578,0.144387657493
"Benson County, North Dakota",2009,6889,30.1,2995,633,2362,30809,2.916596105,0.0918856147481
"Benson County, North Dakota",2012,6677,32,2963,645,2318,34706,2.88050043141,0.0966002695821
"Benson County, North Dakota",2015,6794,31,2983,703,2280,41296,2.9798245614,0.103473653223
"Bent County, Colorado",2009,6128,39.3,2366,339,2027,35647,3.02318697583,0.055319843342
"Bent County, Colorado",2012,6192,40.6,2255,323,1932,36297,3.2049689441,0.0521640826873
"Bent County, Colorado",2015,5895,41.1,2080,445,1635,36791,3.60550458716,0.0754877014419
"Benton County, Arkansas",2009,209931,34.5,83084,9207,73877,50377,2.84162865303,0.0438572673879
"Benton County, Arkansas",2012,222028,34.5,92947,11567,81380,53515,2.72828704841,0.0520970328067
"Benton County, Arkansas",2015,238198,35,96389,10719,85670,56239,2.78041321349,0.0450003778369
"Benton County, Indiana",2009,8723,40.3,3900,387,3513,45603,2.48306290919,0.044365470595
"Benton County, Indiana",2012,8816,39.8,3933,471,3462,47828,2.54650491046,0.0534255898367
"Benton County, Indiana",2015,8752,40.4,3907,478,3429,47046,2.55234762321,0.0546160877514
"Benton County, Iowa",2009,26628,39.9,11004,808,10196,54210,2.61161239702,0.0303439987983
"Benton County, Iowa",2012,26044,40.4,11095,865,10230,57488,2.5458455523,0.033213024113
"Benton County, Iowa",2015,25803,41.4,11082,928,10154,60606,2.54116604294,0.0359648102934
"Benton County, Minnesota",2009,39460,33,16440,1183,15257,50071,2.58635380481,0.0299797263051
"Benton County, Minnesota",2012,38560,34.1,16155,734,15421,51365,2.50048634978,0.0190352697095
"Benton County, Minnesota",2015,39221,35.4,16375,743,15632,52178,2.50901995906,0.0189439330971
"Benton County, Mississippi",2009,7978,38.8,3623,725,2898,28667,2.75293305728,0.0908749059915
"Benton County, Mississippi",2012,8725,40.2,4158,945,3213,26899,2.71553065671,0.108309455587
"Benton County, Mississippi",2015,8470,39.8,4197,1233,2964,33141,2.85762483131,0.145572609209
"Benton County, Missouri",2009,18458,49.4,13232,5127,8105,34038,2.27735965453,0.277765738433
"Benton County, Missouri",2012,19021,51.5,14083,5998,8085,33349,2.35262832406,0.315335681615
"Benton County, Missouri",2015,18854,52.5,14034,5885,8149,33042,2.31365811756,0.312135355893
"Benton County, Oregon",2009,81107,31.9,35202,2150,33052,46652,2.45392109403,0.026508192881
"Benton County, Oregon",2012,85501,32.1,36301,2799,33502,48635,2.55211629156,0.0327364592227
"Benton County, Oregon",2015,86495,32.7,36992,3152,33840,49802,2.55599881797,0.0364414127984
"Benton County, Tennessee",2009,16130,44.9,9066,1795,7271,33647,2.21840187044,0.111283323001
"Benton County, Tennessee",2012,16420,46,8980,1950,7030,33663,2.33570412518,0.118757612667
"Benton County, Tennessee",2015,16261,46.1,8974,2188,6786,33240,2.39625699971,0.134555070414
"Benton County, Washington",2009,161077,36.3,63331,4937,58394,55253,2.75845121074,0.0306499376075
"Benton County, Washington",2012,175424,35.7,68896,4236,64660,60300,2.71302196103,0.0241472090478
"Benton County, Washington",2015,184930,35.5,71473,4043,67430,60251,2.74254782738,0.0218623262856
"Benzie County, Michigan",2009,17440,43.7,11859,4665,7194,44445,2.42424242424,0.26748853211
"Benzie County, Michigan",2012,17554,46.4,12193,4673,7520,47491,2.33430851064,0.266207132278
"Benzie County, Michigan",2015,17437,48.4,12267,5042,7225,47388,2.41342560554,0.289155244595
"Bergen County, New Jersey",2009,888546,40.7,349346,15934,333412,81350,2.66500905786,0.0179326675265
"Bergen County, New Jersey",2012,906781,41.2,352985,18458,334527,84255,2.71063621173,0.0203555213442
"Bergen County, New Jersey",2015,926330,41.5,353978,18428,335550,85806,2.76063179854,0.0198935584511
"Berkeley County, South Carolina",2009,163328,34.3,65462,9259,56203,49286,2.90603704429,0.0566896061912
"Berkeley County, South Carolina",2012,179773,34.6,73303,9913,63390,51476,2.83598359363,0.0551417621111
"Berkeley County, South Carolina",2015,193613,35.3,76503,7473,69030,52506,2.80476604375,0.0385976148296
"Berkeley County, West Virginia",2009,99058,36.4,42588,4431,38157,52250,2.59606363184,0.0447313695007
"Berkeley County, West Virginia",2012,104410,37.6,44766,4774,39992,53332,2.61077215443,0.0457235896945
"Berkeley County, West Virginia",2015,108724,38.4,45872,4881,40991,55239,2.65238710937,0.0448934917773
"Berks County, Pennsylvania",2009,401488,38.5,160323,10098,150225,54139,2.67257779997,0.0251514366556
"Berks County, Pennsylvania",2012,411094,39.4,164583,10606,153977,55021,2.66984030082,0.0257994521934
"Berks County, Pennsylvania",2015,413965,39.7,164853,11541,153312,55936,2.70014741181,0.0278791685287
"Berkshire County, Massachusetts",2009,130168,43.6,68243,13043,55200,49907,2.35811594203,0.100201278348
"Berkshire County, Massachusetts",2012,130866,44.6,68449,12837,55612,47513,2.35319715169,0.0980927055156
"Berkshire County, Massachusetts",2015,129288,45.8,68385,13145,55240,49956,2.34047791455,0.101672235629
"Bernalillo County, New Mexico",2009,626822,35,276183,20556,255627,46121,2.45209621832,0.0327939989343
"Bernalillo County, New Mexico",2012,661924,36,284375,20845,263530,48398,2.51175957197,0.0314915307498
"Bernalillo County, New Mexico",2015,673943,36.5,287054,23784,263270,47725,2.55989288563,0.035290818363
"Berrien County, Georgia",2009,16814,36.4,7599,1003,6596,32029,2.5491206792,0.0596526703937
"Berrien County, Georgia",2012,19131,37.9,8650,1475,7175,31506,2.66634146341,0.0770999947729
"Berrien County, Georgia",2015,19019,39,8650,1692,6958,31835,2.73340040241,0.088963667911
"Berrien County, Michigan",2009,160129,40,76962,13421,63541,42481,2.5200893911,0.0838136752244
"Berrien County, Michigan",2012,156759,40.8,76908,15622,61286,43471,2.55782723624,0.0996561600929
"Berrien County, Michigan",2015,155565,41.4,76772,15605,61167,44993,2.54328314287,0.100311766786
"Bertie County, North Carolina",2009,19187,42.5,9394,1628,7766,27487,2.47064125676,0.0848491165894
"Bertie County, North Carolina",2012,21035,43.1,9793,2070,7723,31194,2.7236825068,0.0984074162111
"Bertie County, North Carolina",2015,20518,44.8,9767,2359,7408,30027,2.76970842333,0.114972219515
"Bethel Census Area, Alaska",2009,17151,26.2,5548,1370,4178,53120,4.10507419818,0.0798787242726
"Bethel Census Area, Alaska",2012,17184,26.1,5907,1600,4307,52349,3.98978407244,0.0931098696462
"Bethel Census Area, Alaska",2015,17776,26.7,5937,1449,4488,51012,3.96078431373,0.0815144014401
"Bexar County, Texas",2009,1584817,32.4,599229,58897,540332,45688,2.933043018,0.0371632813126
"Bexar County, Texas",2012,1719902,32.9,660779,63917,596862,49141,2.88157396517,0.0371631639477
"Bexar County, Texas",2015,1825502,33.1,675208,56377,618831,51150,2.94992009127,0.0308830119058
"Bibb County, Alabama",2009,21464,38.6,8706,1181,7525,41236,2.85235880399,0.0550223630265
"Bibb County, Alabama",2012,22769,39.4,8958,1572,7386,36824,3.08272407257,0.0690412402828
"Bibb County, Alabama",2015,22604,38.9,8971,1944,7027,38678,3.21673544898,0.0860024774376
"Bibb County, Georgia",2009,155034,34.9,71608,12564,59044,38207,2.6257367387,0.0810402879368
"Bibb County, Georgia",2012,155560,35.5,69793,12685,57108,37920,2.72396161659,0.08154409874
"Bibb County, Georgia",2015,154816,35.6,70071,12960,57111,36519,2.71079126613,0.0837122778007
"Bienville Parish, Louisiana",2009,14848,41,8256,2584,5672,31741,2.61777150917,0.174030172414
"Bienville Parish, Louisiana",2012,14312,41.3,7738,2066,5672,31229,2.52327221439,0.144354387926
"Bienville Parish, Louisiana",2015,13977,42.3,7727,1913,5814,32876,2.4040247678,0.13686771124
"Big Horn County, Montana",2009,12809,31,4692,1089,3603,34891,3.55509297807,0.0850183464751
"Big Horn County, Montana",2012,12872,30.1,4700,1168,3532,36803,3.64439411099,0.0907395898073
"Big Horn County, Montana",2015,13141,29.8,4677,1101,3576,41622,3.67477628635,0.0837835781143
"Big Horn County, Wyoming",2009,11372,41.9,5252,664,4588,44612,2.47863993025,0.0583890256771
"Big Horn County, Wyoming",2012,11636,41.8,5364,777,4587,51002,2.53673424896,0.0667755242351
"Big Horn County, Wyoming",2015,11895,41.2,5373,882,4491,51679,2.64863059452,0.0741488020177
"Big Stone County, Minnesota",2009,5335,48.2,3285,825,2460,39973,2.16869918699,0.154639175258
"Big Stone County, Minnesota",2012,5250,48.7,3129,800,2329,45545,2.25418634607,0.152380952381
"Big Stone County, Minnesota",2015,5134,49.2,3109,827,2282,47794,2.24978089395,0.161082976237
"Billings County, North Dakota",2009,912,45.4,508,128,380,55192,2.4,0.140350877193
"Billings County, North Dakota",2012,838,49.3,505,154,351,48375,2.38746438746,0.183770883055
"Billings County, North Dakota",2015,969,45,519,112,407,70469,2.38083538084,0.115583075335
"Bingham County, Idaho",2009,43635,31.4,15490,1504,13986,44380,3.11990561991,0.0344677437837
"Bingham County, Idaho",2012,45312,32,16100,1462,14638,46817,3.09550485039,0.0322651836158
"Bingham County, Idaho",2015,45407,32.9,16202,1504,14698,50155,3.08933188189,0.033122646288
"Black Hawk County, Iowa",2009,127369,34.3,54640,3274,51366,42959,2.47963633532,0.0257048418375
"Black Hawk County, Iowa",2012,130843,34.6,55923,3773,52150,45610,2.50897411314,0.0288360859962
"Black Hawk County, Iowa",2015,132496,34.7,56591,4181,52410,48369,2.52806716276,0.0315556696051
"Blackford County, Indiana",2009,13254,41.9,6425,714,5711,40372,2.32078445106,0.0538705296514
"Blackford County, Indiana",2012,12742,42,6063,770,5293,39619,2.40733043643,0.0604300737718
"Blackford County, Indiana",2015,12476,43.3,6008,780,5228,38190,2.38638102525,0.0625200384739
"Bladen County, North Carolina",2009,32412,39.1,16052,3283,12769,30823,2.53833503015,0.10128964581
"Bladen County, North Carolina",2012,34922,41,17616,3534,14082,30031,2.47990342281,0.10119695321
"Bladen County, North Carolina",2015,34720,42.6,17637,3236,14401,30096,2.41094368447,0.093202764977
"Blaine County, Idaho",2009,21775,38.8,14298,5465,8833,56601,2.46518736556,0.250975889782
"Blaine County, Idaho",2012,21323,40.6,15014,5804,9210,60160,2.31520086862,0.272194344135
"Blaine County, Idaho",2015,21309,43,15109,6185,8924,60088,2.38783056925,0.290252944765
"Blaine County, Montana",2009,6515,34.8,2938,518,2420,37039,2.69214876033,0.0795088257866
"Blaine County, Montana",2012,6514,35,2839,546,2293,37899,2.84081988661,0.083819465766
"Blaine County, Montana",2015,6598,34.5,2819,581,2238,36744,2.94816800715,0.0880569869657
"Blaine County, Nebraska",2009,471,49.1,323,104,219,35694,2.15068493151,0.220806794055
"Blaine County, Nebraska",2012,584,41.3,361,117,244,41364,2.39344262295,0.200342465753
"Blaine County, Nebraska",2015,551,40.4,341,110,231,48875,2.38528138528,0.199637023593
"Blaine County, Oklahoma",2009,12625,36,5294,1152,4142,39068,3.04804442298,0.0912475247525
"Blaine County, Oklahoma",2012,10651,40.4,5138,1122,4016,43356,2.65214143426,0.105342221388
"Blaine County, Oklahoma",2015,9810,41.1,4723,1143,3580,41972,2.74022346369,0.116513761468
"Blair County, Pennsylvania",2009,125984,41.6,56370,4598,51772,40673,2.43343892452,0.0364966979934
"Blair County, Pennsylvania",2012,127133,42.1,56262,4772,51490,42687,2.46908137502,0.0375354943248
"Blair County, Pennsylvania",2015,126448,42.8,56109,5075,51034,43981,2.4777207352,0.0401350752879
"Blanco County, Texas",2009,9037,41.2,4314,855,3459,50225,2.61260479907,0.0946110434879
"Blanco County, Texas",2012,10425,46.1,5463,1359,4104,46881,2.54020467836,0.13035971223
"Blanco County, Texas",2015,10723,48.6,5622,1458,4164,55504,2.57516810759,0.135969411545
"Bland County, Virginia",2009,6792,44.6,3271,686,2585,42231,2.62746615087,0.101001177856
"Bland County, Virginia",2012,6827,44.2,3267,803,2464,42658,2.77069805195,0.117621209902
"Bland County, Virginia",2015,6662,44.8,3274,660,2614,45294,2.54858454476,0.099069348544
"Bleckley County, Georgia",2009,12584,36,5170,919,4251,37542,2.96024464832,0.0730292434838
"Bleckley County, Georgia",2012,13009,38.7,5288,1163,4125,37853,3.1536969697,0.0893996463986
"Bleckley County, Georgia",2015,12746,37.3,5275,1162,4113,38991,3.0989545344,0.0911658559548
"Bledsoe County, Tennessee",2009,12941,41,5446,1409,4037,32439,3.2055982165,0.108878757438
"Bledsoe County, Tennessee",2012,12898,42.2,5698,1128,4570,31388,2.82231947484,0.0874554194449
"Bledsoe County, Tennessee",2015,13686,42.9,5709,1175,4534,37013,3.01852668725,0.0858541575332
"Blount County, Alabama",2009,56804,38.2,21935,2707,19228,45406,2.95423340961,0.0476550947116
"Blount County, Alabama",2012,57466,39.1,23761,2730,21031,45192,2.73244258476,0.0475063515818
"Blount County, Alabama",2015,57710,40.7,23860,3044,20816,45813,2.77238662567,0.0527464910761
"Blount County, Tennessee",2009,119489,40.6,52350,5602,46748,47218,2.55602378711,0.0468829766757
"Blount County, Tennessee",2012,123086,41.6,55121,6426,48695,46347,2.5276927816,0.0522073997043
"Blount County, Tennessee",2015,125188,42.6,55744,6711,49033,48286,2.55313768279,0.0536073745087
"Blue Earth County, Minnesota",2009,59883,29.5,25319,1979,23340,45902,2.56568123393,0.0330477764975
"Blue Earth County, Minnesota",2012,63991,29.9,26200,1941,24259,49306,2.63782513706,0.0303323904924
"Blue Earth County, Minnesota",2015,65125,30.1,26843,1996,24847,50061,2.62104076951,0.0306487523992
"Boise County, Idaho",2009,7467,45.2,5034,2155,2879,49341,2.59360889198,0.288603187358
"Boise County, Idaho",2012,7014,48.8,5280,2302,2978,45403,2.35527199463,0.328200741374
"Boise County, Idaho",2015,6885,52,5336,2366,2970,44238,2.31818181818,0.343645606391
"Bolivar County, Mississippi",2009,37266,31.6,15542,1876,13666,24920,2.72691350798,0.0503407932163
"Bolivar County, Mississippi",2012,34239,34.2,14141,1731,12410,27768,2.75898468977,0.0505563830719
"Bolivar County, Mississippi",2015,33803,34.7,14215,1833,12382,27585,2.73001130674,0.0542259562761
"Bollinger County, Missouri",2009,12037,41.2,5697,1061,4636,34878,2.59641932701,0.0881448865997
"Bollinger County, Missouri",2012,12389,42.5,5866,1063,4803,37016,2.57942952321,0.085801921059
"Bollinger County, Missouri",2015,12356,43.1,5840,1087,4753,39707,2.59962129182,0.0879734541923
"Bon Homme County, South Dakota",2009,7023,43.1,3070,439,2631,38750,2.669327252,0.0625088993308
"Bon Homme County, South Dakota",2012,7041,43.5,2927,404,2523,41139,2.79072532699,0.057378213322
"Bon Homme County, South Dakota",2015,7013,42.9,2941,461,2480,45254,2.82782258065,0.0657350634536
"Bond County, Illinois",2009,18173,38.4,7193,883,6310,47240,2.88003169572,0.0485885654542
"Bond County, Illinois",2012,17762,40.4,7086,774,6312,47705,2.81400506971,0.0435761738543
"Bond County, Illinois",2015,17313,40.1,7081,933,6148,47946,2.81603773585,0.053890140357
"Bonner County, Idaho",2009,40878,44.2,19971,4510,15461,42736,2.64394282388,0.110328293948
"Bonner County, Idaho",2012,40806,45.7,24413,6527,17886,41379,2.28144917813,0.159951967848
"Bonner County, Idaho",2015,41066,47.2,24589,7396,17193,42171,2.38853021579,0.180100326304
"Bonneville County, Idaho",2009,96238,31.3,36952,2491,34461,49823,2.79266417109,0.025883746545
"Bonneville County, Idaho",2012,104177,31.8,39711,3792,35919,51254,2.90033130098,0.0363995891608
"Bonneville County, Idaho",2015,107788,32.4,40471,3785,36686,50762,2.93812353486,0.0351152261847
"Boone County, Arkansas",2009,36341,40.6,16213,2367,13846,36839,2.62465694063,0.0651330453207
"Boone County, Arkansas",2012,37032,41.4,16814,2066,14748,38364,2.51098454028,0.0557895873839
"Boone County, Arkansas",2015,37227,41.4,16902,1941,14961,39251,2.4882695007,0.0521395761141
"Boone County, Illinois",2009,52400,35.9,18507,1608,16899,59202,3.1007751938,0.0306870229008
"Boone County, Illinois",2012,54141,36.6,19909,2045,17864,63670,3.03073219884,0.0377717441495
"Boone County, Illinois",2015,53851,38.2,19968,1839,18129,58248,2.97043411109,0.0341497836623
"Boone County, Indiana",2009,53931,38.2,21631,1349,20282,67322,2.65905729218,0.0250134431032
"Boone County, Indiana",2012,56823,38.5,23013,1382,21631,68774,2.62692432158,0.0243211375675
"Boone County, Indiana",2015,60511,38.8,24565,1641,22924,67552,2.6396353167,0.0271190362083
"Boone County, Iowa",2009,26222,40.3,11616,702,10914,48302,2.40260216236,0.0267714133171
"Boone County, Iowa",2012,26324,40.9,11745,1097,10648,51284,2.47220135237,0.0416729980246
"Boone County, Iowa",2015,26401,41.3,11789,1030,10759,52985,2.45385258853,0.0390136737245
"Boone County, Kentucky",2009,112514,35,43933,3211,40722,65964,2.76297824272,0.0285386707432
"Boone County, Kentucky",2012,119406,35.7,46196,3579,42617,67125,2.80183964146,0.0299733681725
"Boone County, Kentucky",2015,124617,36.2,47466,2757,44709,66730,2.78729114943,0.0221237872842
"Boone County, Missouri",2009,151836,29.2,68596,4974,63622,44787,2.3865329603,0.0327590294792
"Boone County, Missouri",2012,163266,29.6,69858,5281,64577,47786,2.52823760782,0.0323459875296
"Boone County, Missouri",2015,170770,30.1,72187,5207,66980,49899,2.54956703494,0.0304913040932
"Boone County, Nebraska",2009,5531,44.5,2686,249,2437,43891,2.26959376282,0.0450189839089
"Boone County, Nebraska",2012,5473,45.7,2644,329,2315,44491,2.36414686825,0.0601132833912
"Boone County, Nebraska",2015,5373,45.6,2637,410,2227,50306,2.41266277503,0.0763074632421
"Boone County, West Virginia",2009,25000,40.1,11945,1380,10565,38828,2.36630383341,0.0552
"Boone County, West Virginia",2012,24617,41.2,11125,1370,9755,42819,2.52352639672,0.0556525977983
"Boone County, West Virginia",2015,24000,41.9,11066,1519,9547,39958,2.51387870535,0.0632916666667
"Borden County, Texas",2009,585,41.8,452,196,256,55200,2.28515625,0.335042735043
"Borden County, Texas",2012,642,40,367,128,239,69688,2.68619246862,0.19937694704
"Borden County, Texas",2015,705,38.7,397,135,262,73750,2.69083969466,0.191489361702
"Bosque County, Texas",2009,17720,43.3,8965,2403,6562,44244,2.70039622066,0.135609480813
"Bosque County, Texas",2012,18114,45.6,9587,2704,6883,44860,2.63170129304,0.149276802473
"Bosque County, Texas",2015,17971,46,9641,2642,6999,44674,2.56765252179,0.147014634689
"Bossier Parish, Louisiana",2009,108722,34,47242,4709,42533,49815,2.55617990737,0.0433123010982
"Bossier Parish, Louisiana",2012,117742,34.6,49681,4845,44836,53070,2.62605941654,0.0411492925209
"Bossier Parish, Louisiana",2015,123403,34.7,52851,5726,47125,52892,2.61863129973,0.0464008168359
"Botetourt County, Virginia",2009,32231,43.1,14129,1457,12672,59823,2.54348169192,0.0452049269337
"Botetourt County, Virginia",2012,33074,45,14555,1733,12822,66053,2.57947278116,0.0523976537461
"Botetourt County, Virginia",2015,33155,46.4,14664,1751,12913,60454,2.56756756757,0.0528125471271
"Bottineau County, North Dakota",2009,6427,48,4322,1460,2862,39643,2.24563242488,0.227166640734
"Bottineau County, North Dakota",2012,6449,47.4,4340,1350,2990,48289,2.15685618729,0.209334780586
"Bottineau County, North Dakota",2015,6634,46,4342,1307,3035,56349,2.18583196046,0.197015375339
"Boulder County, Colorado",2009,295524,35,123355,8175,115180,65040,2.56575794409,0.0276627279003
"Boulder County, Colorado",2012,297218,35.6,127105,7044,120061,67403,2.47555825789,0.0236997759221
"Boulder County, Colorado",2015,310032,35.8,129739,7223,122516,70961,2.53054294949,0.023297595087
"Boundary County, Idaho",2009,10748,42.1,4587,595,3992,35473,2.69238476954,0.0553591365836
"Boundary County, Idaho",2012,10857,42.6,5146,1053,4093,36300,2.65257757146,0.0969881182647
"Boundary County, Idaho",2015,10961,43.7,5231,966,4265,38961,2.56998827667,0.0881306450141
"Bourbon County, Kansas",2009,14846,37.9,7328,1315,6013,36651,2.46898386829,0.0885760474202
"Bourbon County, Kansas",2012,15060,38,7173,1433,5740,38250,2.62369337979,0.0951527224436
"Bourbon County, Kansas",2015,14812,37.3,7114,1454,5660,38280,2.61696113074,0.0981636510937
"Bourbon County, Kentucky",2009,19668,39.6,8942,689,8253,38301,2.38313340603,0.0350315232866
"Bourbon County, Kentucky",2012,20004,40.4,8956,985,7971,40894,2.50959729018,0.0492401519696
"Bourbon County, Kentucky",2015,20013,41.1,8990,1123,7867,45208,2.54391763061,0.056113526208
"Bowie County, Texas",2009,91841,36.6,38601,4442,34159,40569,2.68863257121,0.0483661981032
"Bowie County, Texas",2012,92460,37.6,38581,4661,33920,42346,2.7258254717,0.0504109885356
"Bowie County, Texas",2015,93155,37.7,39008,5585,33423,42670,2.78715255961,0.0599538403736
"Bowman County, North Dakota",2009,2944,47,1589,285,1304,47232,2.25766871166,0.0968070652174
"Bowman County, North Dakota",2012,3154,46.3,1685,327,1358,52821,2.32253313697,0.103677869372
"Bowman County, North Dakota",2015,3221,43.6,1718,341,1377,66845,2.33914306463,0.105867742937
"Box Butte County, Nebraska",2009,11031,42.7,5510,786,4724,45000,2.33509737511,0.0712537394615
"Box Butte County, Nebraska",2012,11345,40.5,5467,618,4849,44025,2.33965766137,0.0544733362715
"Box Butte County, Nebraska",2015,11310,40.8,5448,643,4805,51691,2.35379812695,0.0568523430592
"Box Elder County, Utah",2009,47897,30.4,16699,1308,15391,54670,3.11201351439,0.0273085997035
"Box Elder County, Utah",2012,49660,30.9,17383,1266,16117,55918,3.08121858907,0.0254933548127
"Box Elder County, Utah",2015,50991,32,17910,1506,16404,55038,3.10844915874,0.0295346237571
"Boyd County, Kentucky",2009,48669,40.6,22704,2345,20359,39309,2.3905398104,0.0481826213812
"Boyd County, Kentucky",2012,49358,41.6,21819,2211,19608,39076,2.5172378621,0.0447951699826
"Boyd County, Kentucky",2015,48917,41.9,21717,2334,19383,42319,2.52370634061,0.0477134738434
"Boyd County, Nebraska",2009,2120,46.9,1535,496,1039,33060,2.04042348412,0.233962264151
"Boyd County, Nebraska",2012,2025,50.8,1356,457,899,38281,2.25250278087,0.225679012346
"Boyd County, Nebraska",2015,2039,50.8,1370,435,935,40224,2.1807486631,0.213339872487
"Boyle County, Kentucky",2009,28914,38.2,12342,1353,10989,39113,2.63117663118,0.0467939406516
"Boyle County, Kentucky",2012,28445,40.8,12329,1186,11143,41037,2.55272368303,0.0416944981543
"Boyle County, Kentucky",2015,29388,41,12385,1340,11045,39704,2.66075147125,0.0455968422485
"Bracken County, Kentucky",2009,8618,40.8,3911,659,3252,36967,2.65006150062,0.0764678579717
"Bracken County, Kentucky",2012,8488,39.7,3852,621,3231,38724,2.62705044878,0.0731621112158
"Bracken County, Kentucky",2015,8425,41,3827,524,3303,36327,2.55071147442,0.0621958456973
"Bradford County, Florida",2009,28841,37.9,10180,1696,8484,40519,3.39945780292,0.0588051731909
"Bradford County, Florida",2012,28404,38.7,10970,1905,9065,39082,3.1333701048,0.0670680185889
"Bradford County, Florida",2015,27223,39.6,10926,2156,8770,41606,3.10410490308,0.0791977372075
"Bradford County, Pennsylvania",2009,61375,42.4,29465,4682,24783,39242,2.47649598515,0.0762851323829
"Bradford County, Pennsylvania",2012,62628,43.1,30034,5589,24445,44650,2.56199631827,0.0892412339529
"Bradford County, Pennsylvania",2015,62228,44.1,30102,5744,24358,48987,2.55472534691,0.0923057144694
"Bradley County, Arkansas",2009,11967,40,5998,1076,4922,26207,2.43132872816,0.0899139299741
"Bradley County, Arkansas",2012,11510,40.2,5865,945,4920,32321,2.33943089431,0.0821025195482
"Bradley County, Arkansas",2015,11206,40.6,5832,1234,4598,33701,2.43714658547,0.110119578797
"Bradley County, Tennessee",2009,95184,37.3,41004,3329,37675,39995,2.52644990046,0.0349743654396
"Bradley County, Tennessee",2012,99229,38.3,41510,4084,37426,40614,2.65133864159,0.04115732296
"Bradley County, Tennessee",2015,102062,39.4,42258,3792,38466,42114,2.65330421671,0.0371538868531
"Branch County, Michigan",2009,45890,38.7,20792,4230,16562,44086,2.77080062794,0.0921769448682
"Branch County, Michigan",2012,44920,40,20806,4770,16036,42995,2.80119730606,0.106188780053
"Branch County, Michigan",2015,43706,40.6,20672,4650,16022,44373,2.72787417301,0.106392714959
"Brantley County, Georgia",2009,15442,37.3,6734,1024,5710,39569,2.70437828371,0.0663126538013
"Brantley County, Georgia",2012,18279,37.9,7992,1441,6551,37374,2.79026102885,0.0788336342251
"Brantley County, Georgia",2015,18452,39,7963,1382,6581,37206,2.80382920529,0.0748970301322
"Braxton County, West Virginia",2009,14554,41.8,7684,1546,6138,30174,2.37113066145,0.106225092758
"Braxton County, West Virginia",2012,14531,43.4,7426,1417,6009,31623,2.4182060243,0.0975156561833
"Braxton County, West Virginia",2015,14466,44.5,7389,1782,5607,32750,2.57998929909,0.123185400249
"Brazoria County, Texas",2009,292304,34.7,112518,11901,100617,62570,2.90511543775,0.0407144616564
"Brazoria County, Texas",2012,313813,35.2,118795,12875,105920,68008,2.96273602719,0.0410276183587
"Brazoria County, Texas",2015,331741,35.5,124547,12037,112510,69749,2.94854679584,0.0362843302456
"Brazos County, Texas",2009,171382,23.1,70202,7852,62350,34688,2.74870890136,0.0458157799536
"Brazos County, Texas",2012,194087,24.5,77625,8689,68936,37638,2.81546651967,0.0447685831612
"Brazos County, Texas",2015,205271,25.2,81916,8058,73858,39808,2.77926561781,0.0392554233184
"Breathitt County, Kentucky",2009,15641,39.4,7211,1292,5919,19329,2.64250718027,0.082603414104
"Breathitt County, Kentucky",2012,13922,40.4,6276,979,5297,23049,2.62828015858,0.0703203562707
"Breathitt County, Kentucky",2015,13591,40.7,6206,712,5494,25817,2.47378958864,0.0523876094474
"Breckinridge County, Kentucky",2009,19057,41.2,10442,3133,7309,37694,2.60733342455,0.164401532245
"Breckinridge County, Kentucky",2012,20068,41.8,10620,3215,7405,39695,2.71006076975,0.160205301973
"Breckinridge County, Kentucky",2015,20061,42.5,10615,3318,7297,43479,2.74921200493,0.165395543592
"Bremer County, Iowa",2009,23505,39.1,10097,488,9609,53842,2.44614423978,0.0207615400979
"Bremer County, Iowa",2012,24294,38.3,9939,629,9310,60193,2.60945220193,0.0258911665432
"Bremer County, Iowa",2015,24539,38.6,10067,702,9365,62163,2.62028830753,0.0286075227189
"Brevard County, Florida",2009,532697,44,263121,44236,218885,49114,2.4336843548,0.0830415789839
"Brevard County, Florida",2012,544019,45.5,269856,49442,220414,49099,2.46816899108,0.0908828551944
"Brevard County, Florida",2015,553591,46.6,271654,48863,222791,48925,2.48479965528,0.0882655245479
"Brewster County, Texas",2009,9216,36.3,4869,874,3995,34640,2.30688360451,0.0948350694444
"Brewster County, Texas",2012,9175,40.6,5353,1247,4106,40086,2.23453482708,0.13591280654
"Brewster County, Texas",2015,9235,42.1,5419,1394,4025,38395,2.29440993789,0.150947482404
"Briscoe County, Texas",2009,1583,43.7,1051,344,707,31141,2.23903818953,0.217308907138
"Briscoe County, Texas",2012,1674,43.9,970,313,657,35078,2.54794520548,0.186977299881
"Briscoe County, Texas",2015,1670,42.5,985,310,675,38603,2.47407407407,0.185628742515
"Bristol Bay Borough, Alaska",2009,682,36,828,554,274,62500,2.48905109489,0.812316715543
"Bristol Bay Borough, Alaska",2012,929,42.7,934,559,375,79931,2.47733333333,0.601722282024
"Bristol Bay Borough, Alaska",2015,970,39.7,917,540,377,79750,2.57294429708,0.556701030928
"Bristol County, Massachusetts",2009,545210,38.8,224761,16850,207911,55789,2.62232397516,0.0309055226427
"Bristol County, Massachusetts",2012,548739,39.9,230269,20737,209532,55995,2.61887921654,0.0377902791673
"Bristol County, Massachusetts",2015,552763,40.6,230986,18957,212029,56842,2.60701602139,0.0342949871826
"Bristol County, Rhode Island",2009,50022,42.4,20268,1384,18884,69227,2.64890912942,0.0276678261565
"Bristol County, Rhode Island",2012,49796,43,20785,1468,19317,71086,2.57783299684,0.0294802795405
"Bristol County, Rhode Island",2015,49176,43.9,20801,1511,19290,72458,2.54930015552,0.0307263705873
"Bristol city, Virginia",2009,17526,43.2,8859,815,8044,31797,2.1787667827,0.0465023393815
"Bristol city, Virginia",2012,17747,40.8,8821,1064,7757,30636,2.28786902153,0.0599537950076
"Bristol city, Virginia",2015,17524,41.8,8841,1123,7718,35368,2.2705364084,0.0640835425702
"Broadwater County, Montana",2009,4602,41.3,1782,321,1461,42860,3.1498973306,0.0697522816167
"Broadwater County, Montana",2012,5575,45.6,2662,245,2417,47480,2.30657840298,0.0439461883408
"Broadwater County, Montana",2015,5692,45.8,2699,272,2427,50115,2.34528224145,0.0477863668306
"Bronx County, New York",2009,1381529,32.6,508895,35982,472913,33794,2.92131745162,0.0260450558765
"Bronx County, New York",2012,1386364,32.7,512420,39139,473281,34300,2.92926189727,0.0282314024311
"Bronx County, New York",2015,1428357,33.2,520329,35427,484902,34299,2.94566118515,0.0248026228737
"Brooke County, West Virginia",2009,23801,43.7,11291,1285,10006,40537,2.37867279632,0.0539893281795
"Brooke County, West Virginia",2012,24021,44.9,10967,1056,9911,42307,2.42367066895,0.043961533658
"Brooke County, West Virginia",2015,23665,45.9,10918,888,10030,46215,2.3594217348,0.0375237692795
"Brookings County, South Dakota",2009,29437,25,12914,1430,11484,41043,2.56330546848,0.0485783198016
"Brookings County, South Dakota",2012,31973,26.1,13104,1444,11660,47093,2.74210977702,0.045163106371
"Brookings County, South Dakota",2015,33046,26.4,13638,1313,12325,50082,2.68121703854,0.0397324940991
"Brooks County, Georgia",2009,16324,38.5,7615,1113,6502,40840,2.51061211935,0.0681818181818
"Brooks County, Georgia",2012,16066,40.6,7685,1240,6445,35284,2.49278510473,0.0771816257936
"Brooks County, Georgia",2015,15637,41.4,7660,1083,6577,32663,2.37752774821,0.0692588092345
"Brooks County, Texas",2009,7475,37.6,3526,676,2850,19425,2.62280701754,0.0904347826087
"Brooks County, Texas",2012,7236,32,3179,714,2465,21445,2.9354969574,0.0986733001658
"Brooks County, Texas",2015,7221,31.7,3056,976,2080,22741,3.47163461538,0.135161334995
"Broome County, New York",2009,195209,39.9,89117,8910,80207,43467,2.43381500368,0.0456433873438
"Broome County, New York",2012,199928,40.2,90357,10134,80223,45856,2.49215312317,0.0506882477692
"Broome County, New York",2015,198093,39.9,90026,10894,79132,46261,2.50332356063,0.0549943713306
"Broomfield County, Colorado",2009,52882,35,20140,1277,18863,76240,2.80347770768,0.0241481033244
"Broomfield County, Colorado",2012,55913,36.5,22552,1177,21375,80483,2.6158128655,0.0210505606925
"Broomfield County, Colorado",2015,60699,37.5,24710,1179,23531,81898,2.5795333815,0.019423713735
"Broward County, Florida",2009,1759132,38.5,801196,130724,670472,51731,2.62372179599,0.0743116491542
"Broward County, Florida",2012,1761993,39.7,810220,144307,665913,51603,2.64598078127,0.0818998713389
"Broward County, Florida",2015,1843152,40,814454,144170,670284,51968,2.74980754426,0.0782192678629
"Brown County, Illinois",2009,6593,35.7,2468,320,2148,33472,3.06936685289,0.0485363264068
"Brown County, Illinois",2012,6913,37.2,2466,361,2105,43915,3.28408551069,0.0522204542167
"Brown County, Illinois",2015,6859,37.7,2454,314,2140,50739,3.20514018692,0.0457792681149
"Brown County, Indiana",2009,14724,45,7964,1941,6023,51904,2.44462892246,0.131825590872
"Brown County, Indiana",2012,15181,47.3,8278,2184,6094,48652,2.49113882507,0.143864040577
"Brown County, Indiana",2015,15011,48.3,8479,2384,6095,54615,2.46283839212,0.15881686763
"Brown County, Kansas",2009,10028,42.7,4918,756,4162,37066,2.40941854877,0.0753889110491
"Brown County, Kansas",2012,9962,41.9,4773,609,4164,37515,2.39241114313,0.0611323027505
"Brown County, Kansas",2015,9880,42.5,4768,666,4102,43724,2.40858117991,0.0674089068826
"Brown County, Minnesota",2009,25881,42.8,11638,691,10947,48067,2.36420937243,0.0266991229087
"Brown County, Minnesota",2012,25772,43.1,11486,668,10818,47915,2.38232575337,0.0259196026696
"Brown County, Minnesota",2015,25391,43.5,11543,864,10679,52598,2.377657084,0.0340278051278
"Brown County, Nebraska",2009,3178,47.5,1814,443,1371,26676,2.31801604668,0.139395846444
"Brown County, Nebraska",2012,3183,46.7,1878,398,1480,33333,2.15067567568,0.125039271128
"Brown County, Nebraska",2015,3078,47.6,1855,344,1511,36078,2.03706154864,0.111760883691
"Brown County, Ohio",2009,43823,38.2,19205,2968,16237,45169,2.69895916733,0.0677269926751
"Brown County, Ohio",2012,44666,39.9,19273,2984,16289,45807,2.74209589293,0.0668069672682
"Brown County, Ohio",2015,44247,40.8,19349,2677,16672,45568,2.65397072937,0.0605012769227
"Brown County, South Dakota",2009,35016,38.5,16555,1583,14972,45054,2.33876569597,0.0452079049577
"Brown County, South Dakota",2012,36562,39.4,16746,1421,15325,49504,2.38577487765,0.0388654887588
"Brown County, South Dakota",2015,38060,38.1,17280,1284,15996,53100,2.37934483621,0.0337362059905
"Brown County, Texas",2009,38225,39,18757,4677,14080,38531,2.71484375,0.122354480052
"Brown County, Texas",2012,38018,39.6,18300,4998,13302,40821,2.85806645617,0.131464043348
"Brown County, Texas",2015,37833,41,18419,5124,13295,41962,2.84565626175,0.135437316628
"Brown County, Wisconsin",2009,242881,35.6,102202,6165,96037,52535,2.52903568416,0.0253828006308
"Brown County, Wisconsin",2012,248526,36.2,104613,6442,98171,53419,2.53156227399,0.025920829209
"Brown County, Wisconsin",2015,254717,36.8,106532,5892,100640,53527,2.5309717806,0.0231315538421
"Brule County, South Dakota",2009,5169,39,2368,311,2057,44570,2.51288283909,0.0601663764751
"Brule County, South Dakota",2012,5236,41.5,2416,320,2096,46107,2.49809160305,0.061115355233
"Brule County, South Dakota",2015,5330,40.8,2461,394,2067,49531,2.5786163522,0.0739212007505
"Brunswick County, North Carolina",2009,98712,46.1,72441,28146,44295,44321,2.22851337623,0.285132506686
"Brunswick County, North Carolina",2012,107925,47.6,77514,30333,47181,46490,2.28746741273,0.28105628909
"Brunswick County, North Carolina",2015,115926,50,80412,31219,49193,46859,2.35655479438,0.269301105878
"Brunswick County, Virginia",2009,17786,39.7,7922,1773,6149,36202,2.89250284599,0.0996851456202
"Brunswick County, Virginia",2012,17372,41,8151,2122,6029,33859,2.88140653508,0.122150587152
"Brunswick County, Virginia",2015,16930,41.7,8158,2242,5916,36919,2.86173089926,0.132427643237
"Bryan County, Georgia",2009,30109,34.9,11795,1179,10616,63858,2.83619065561,0.0391577269255
"Bryan County, Georgia",2012,30616,36.1,11966,1014,10952,63818,2.79547114682,0.0331199372877
"Bryan County, Georgia",2015,33151,35.1,12676,1235,11441,63327,2.89756140198,0.0372537781666
"Bryan County, Oklahoma",2009,39467,36,17981,2774,15207,35598,2.59531794568,0.0702865685256
"Bryan County, Oklahoma",2012,42494,36.8,19523,3125,16398,37883,2.59141358702,0.0735397938532
"Bryan County, Oklahoma",2015,44003,37.1,19826,3194,16632,38847,2.64568302068,0.0725859600482
"Buchanan County, Iowa",2009,20911,37.8,9145,754,8391,50360,2.49207484209,0.0360575773516
"Buchanan County, Iowa",2012,20988,38.9,8965,861,8104,54596,2.58983218164,0.0410234419668
"Buchanan County, Iowa",2015,20998,38.4,8989,721,8268,56150,2.5396710208,0.034336603486
"Buchanan County, Missouri",2009,88476,36.9,37341,4259,33082,41366,2.6744453177,0.0481373479814
"Buchanan County, Missouri",2012,89162,36.6,38416,4834,33582,44181,2.65505330236,0.0542159215809
"Buchanan County, Missouri",2015,89561,36.8,38487,5311,33176,46315,2.69957197974,0.0593003651143
"Buchanan County, Virginia",2009,23584,42.1,12221,2700,9521,27538,2.47705072997,0.114484396201
"Buchanan County, Virginia",2012,24071,43.9,11605,2221,9384,29821,2.56511082694,0.0922687050808
"Buchanan County, Virginia",2015,23486,45.5,11489,2047,9442,29679,2.48739673798,0.0871583070766
"Buckingham County, Virginia",2009,15932,43.6,6422,1468,4954,38128,3.21598708115,0.0921416018077
"Buckingham County, Virginia",2012,17071,41.4,7220,1492,5728,37843,2.98027234637,0.0873996836741
"Buckingham County, Virginia",2015,17068,42.2,7263,1660,5603,40331,3.04622523648,0.0972580267167
"Bucks County, Pennsylvania",2009,621241,40.7,240086,12882,227204,74111,2.73428724846,0.0207359140817
"Bucks County, Pennsylvania",2012,625485,41.9,245591,15658,229933,76859,2.72029243301,0.0250333741017
"Bucks County, Pennsylvania",2015,626583,43,246515,13449,233066,77568,2.6884358937,0.0214640358899
"Buena Vista County, Iowa",2009,19573,37.5,8206,627,7579,41938,2.58253067687,0.0320339242835
"Buena Vista County, Iowa",2012,20215,36.5,8235,590,7645,46947,2.6442119032,0.0291862478358
"Buena Vista County, Iowa",2015,20507,35.9,8263,628,7635,48195,2.68592010478,0.0306236894719
"Buena Vista city, Virginia",2009,6285,39.3,2857,165,2692,40913,2.33469539376,0.0262529832936
"Buena Vista city, Virginia",2012,6679,38,2931,199,2732,35921,2.44472913616,0.029794879473
"Buena Vista city, Virginia",2015,6666,33.8,2920,183,2737,29097,2.43551333577,0.0274527452745
"Buffalo County, Nebraska",2009,44877,30.3,18603,1354,17249,46300,2.60171604151,0.0301713572654
"Buffalo County, Nebraska",2012,46330,32.3,19074,1612,17462,50307,2.65318978353,0.0347938700626
"Buffalo County, Nebraska",2015,47958,32.5,19531,1179,18352,53624,2.61323016565,0.0245840110096
"Buffalo County, South Dakota",2009,2091,23.4,628,102,526,25714,3.9752851711,0.0487804878049
"Buffalo County, South Dakota",2012,1950,26.4,643,77,566,30439,3.44522968198,0.0394871794872
"Buffalo County, South Dakota",2015,2038,25.9,629,83,546,31163,3.7326007326,0.040726202159
"Buffalo County, Wisconsin",2009,13683,42.6,6607,797,5810,44950,2.35507745267,0.0582474603523
"Buffalo County, Wisconsin",2012,13544,44,6662,956,5706,47119,2.37364178058,0.0705847607797
"Buffalo County, Wisconsin",2015,13319,45,6672,901,5771,50196,2.30791890487,0.0676477213004
"Bullitt County, Kentucky",2009,73528,37.4,29382,1798,27584,52594,2.66560324826,0.0244532695028
"Bullitt County, Kentucky",2012,74431,38.2,29417,1626,27791,53922,2.67824115721,0.0218457363195
"Bullitt County, Kentucky",2015,76961,39.3,30175,1908,28267,55975,2.72264478013,0.0247917776536
"Bulloch County, Georgia",2009,66366,24.7,27378,3503,23875,34723,2.77972774869,0.0527830515625
"Bulloch County, Georgia",2012,70360,25.8,28819,3625,25194,34403,2.7927284274,0.0515207504264
"Bulloch County, Georgia",2015,72386,26.3,29593,3465,26128,36032,2.77043784446,0.0478683723372
"Bullock County, Alabama",2009,10917,37.4,4850,921,3929,26209,2.77856961059,0.0843638362187
"Bullock County, Alabama",2012,10779,40.7,4501,761,3740,34500,2.8820855615,0.0706002412098
"Bullock County, Alabama",2015,10678,39.3,4465,782,3683,31938,2.89926690198,0.0732346881438
"Buncombe County, North Carolina",2009,225869,40.4,107414,10949,96465,43750,2.34146063339,0.0484750009962
"Buncombe County, North Carolina",2012,239000,40.7,113409,12028,101381,44206,2.35744370247,0.0503263598326
"Buncombe County, North Carolina",2015,247336,41.1,115426,13566,101860,45167,2.42819556254,0.0548484652457
"Bureau County, Illinois",2009,34795,41.8,15627,976,14651,45329,2.37492321343,0.0280500071849
"Bureau County, Illinois",2012,34798,42.6,15712,1423,14289,48102,2.43529988103,0.040893154779
"Bureau County, Illinois",2015,34115,43.4,15647,1624,14023,50423,2.43278898952,0.04760369339
"Burke County, Georgia",2009,22807,35.2,9378,1645,7733,31482,2.94930815983,0.0721269785592
"Burke County, Georgia",2012,23242,35.5,9822,2079,7743,31597,3.00167893581,0.0894501333792
"Burke County, Georgia",2015,23007,36,9832,1730,8102,33641,2.83966921748,0.0751945060199
"Burke County, North Carolina",2009,88987,40.1,39513,5549,33964,36061,2.62003886468,0.0623574229944
"Burke County, North Carolina",2012,90821,41.4,40790,6140,34650,38062,2.6210966811,0.0676055097389
"Burke County, North Carolina",2015,89548,42.9,40711,6531,34180,39360,2.61989467525,0.0729329521597
"Burke County, North Dakota",2009,2027,50.9,1305,292,1013,49013,2.00098716683,0.14405525407
"Burke County, North Dakota",2012,2011,46.2,1276,269,1007,52031,1.99702085402,0.13376429637
"Burke County, North Dakota",2015,2208,36.5,1333,353,980,60096,2.25306122449,0.159873188406
"Burleigh County, North Dakota",2009,77049,36.6,33142,1425,31717,52070,2.4292650629,0.0184947241366
"Burleigh County, North Dakota",2012,81941,37.3,35902,1995,33907,59309,2.41663963193,0.0243467861022
"Burleigh County, North Dakota",2015,88223,36.8,38716,1655,37061,65254,2.3804808289,0.0187592804597
"Burleson County, Texas",2009,16634,40.8,8679,1922,6757,39522,2.46174337724,0.115546471083
"Burleson County, Texas",2012,17160,41.6,8824,2531,6293,43976,2.7268393453,0.147494172494
"Burleson County, Texas",2015,17293,42.6,8875,2474,6401,51821,2.70160912357,0.14306366738
"Burlington County, New Jersey",2009,446301,39.1,173858,8522,165336,75383,2.69935767165,0.0190947365119
"Burlington County, New Jersey",2012,449117,40.3,175844,10224,165620,78229,2.71173167492,0.0227646693401
"Burlington County, New Jersey",2015,450556,41,177058,12399,164659,78621,2.73629743895,0.0275193316702
"Burnet County, Texas",2009,43402,44.7,19797,3736,16061,46463,2.70232239587,0.0860789825354
"Burnet County, Texas",2012,42946,44,20865,4217,16648,49047,2.57964920711,0.0981930796815
"Burnet County, Texas",2015,44144,44.1,21338,4398,16940,49732,2.60590318772,0.0996284885828
"Burnett County, Wisconsin",2009,16111,47.9,13783,6318,7465,40870,2.15820495646,0.392154428651
"Burnett County, Wisconsin",2012,15528,49.3,14829,7468,7361,39382,2.10949599239,0.480937660999
"Burnett County, Wisconsin",2015,15334,50.9,15316,8004,7312,41135,2.09710065646,0.521977305335
"Burt County, Nebraska",2009,7047,45.4,3719,659,3060,43333,2.30294117647,0.0935149709096
"Burt County, Nebraska",2012,6829,47.2,3470,532,2938,47786,2.32437031995,0.0779030604774
"Burt County, Nebraska",2015,6647,47.4,3461,660,2801,47429,2.37308104248,0.0992929140966
"Butler County, Alabama",2009,20189,39.2,10393,2337,8056,31938,2.50608242304,0.11575610481
"Butler County, Alabama",2012,20730,40.3,9973,1824,8149,30752,2.54387041355,0.087988422576
"Butler County, Alabama",2015,20354,40.5,9919,1863,8056,32229,2.52656405164,0.0915299204088
"Butler County, Iowa",2009,14581,44.2,6693,476,6217,46143,2.34534341322,0.0326452232357
"Butler County, Iowa",2012,14899,43.6,6645,561,6084,51348,2.44888231427,0.0376535337942
"Butler County, Iowa",2015,14966,43.5,6707,500,6207,52360,2.41114870308,0.0334090605372
"Butler County, Kansas",2009,62878,37.4,25706,1856,23850,56077,2.63639412998,0.0295174782913
"Butler County, Kansas",2012,65647,37.5,26060,1784,24276,57424,2.70419344208,0.0271756515911
"Butler County, Kansas",2015,66092,37.8,26329,2056,24273,58897,2.72286079183,0.0311081522726
"Butler County, Kentucky",2009,13337,38.9,6114,753,5361,33063,2.4877821302,0.0564594736447
"Butler County, Kentucky",2012,12748,40.3,5884,832,5052,36237,2.5233570863,0.0652651396297
"Butler County, Kentucky",2015,12835,41.2,5861,685,5176,33536,2.47971406491,0.0533696922478
"Butler County, Missouri",2009,41293,39.6,19341,2520,16821,33074,2.45484810653,0.0610272927615
"Butler County, Missouri",2012,42792,40.6,19711,2644,17067,34343,2.5072947794,0.0617872499533
"Butler County, Missouri",2015,42951,40,19662,2932,16730,35738,2.56730424387,0.0682638355335
"Butler County, Nebraska",2009,8416,43.2,4142,597,3545,45226,2.37404795487,0.0709363117871
"Butler County, Nebraska",2012,8345,44.4,4060,552,3508,50569,2.37884834664,0.0661473936489
"Butler County, Nebraska",2015,8256,44.7,4043,466,3577,51027,2.30807939614,0.0564437984496
"Butler County, Ohio",2009,356878,35.4,142936,12014,130922,54344,2.72588258658,0.033664165345
"Butler County, Ohio",2012,368029,36.1,148006,13061,134945,56253,2.72725184334,0.0354890511346
"Butler County, Ohio",2015,372538,36.4,149016,14296,134720,57540,2.76527612827,0.0383746087647
"Butler County, Pennsylvania",2009,182519,40.4,76964,5344,71620,55373,2.54843619101,0.0292791435412
"Butler County, Pennsylvania",2012,183946,41.3,78260,5393,72867,58226,2.52440748212,0.0293183869179
"Butler County, Pennsylvania",2015,185689,42.7,79529,5053,74476,60934,2.4932730007,0.0272121665796
"Butte County, California",2009,217917,36.6,94743,9536,85207,42002,2.55750114427,0.0437597800998
"Butte County, California",2012,220101,37.3,95830,10756,85074,43339,2.58717116863,0.0488684740187
"Butte County, California",2015,222564,36.8,97133,11815,85318,43444,2.60864061511,0.0530858539566
"Butte County, Idaho",2009,2769,44.6,1424,203,1221,34229,2.26781326781,0.073311664861
"Butte County, Idaho",2012,2828,45.9,1417,316,1101,40150,2.56857402361,0.111739745403
"Butte County, Idaho",2015,2653,40.9,1278,269,1009,37891,2.62933597621,0.101394647569
"Butte County, South Dakota",2009,9418,41.1,4396,532,3864,36649,2.43737060041,0.0564875769803
"Butte County, South Dakota",2012,10122,40.1,4609,596,4013,38980,2.52230251682,0.0588816439439
"Butte County, South Dakota",2015,10292,39.9,4667,588,4079,41920,2.523167443,0.0571317528177
"Butts County, Georgia",2009,23596,36.9,9211,1580,7631,52760,3.09212423011,0.06696050178
"Butts County, Georgia",2012,23671,38.2,9340,1544,7796,50722,3.03630066701,0.0652274935575
"Butts County, Georgia",2015,23445,38.4,9291,1517,7774,41667,3.01582197067,0.0647046278524
"Cabarrus County, North Carolina",2009,161473,35.8,66969,5465,61504,54274,2.62540647763,0.0338446675296
"Cabarrus County, North Carolina",2012,178396,36.7,71848,7364,64484,54341,2.76651572483,0.0412789524429
"Cabarrus County, North Carolina",2015,188375,37.4,74504,7343,67161,54720,2.80482720627,0.0389807564698
"Cabell County, West Virginia",2009,94552,37.7,46435,5764,40671,33062,2.32480145558,0.0609611642271
"Cabell County, West Virginia",2012,96240,39,46174,5690,40484,37238,2.37723545104,0.0591230257689
"Cabell County, West Virginia",2015,96824,38.5,46376,6403,39973,38344,2.42223500863,0.0661302982732
"Cabo Rojo Municipio, Puerto Rico",2009,52969,37.8,24770,8264,16506,16124,3.2090754877,0.156015782816
"Cabo Rojo Municipio, Puerto Rico",2012,50866,39.3,27085,11737,15348,16003,3.31417774303,0.230743522196
"Cabo Rojo Municipio, Puerto Rico",2015,50380,41.1,29661,12546,17115,16499,2.94361671049,0.249027391822
"Cache County, Utah",2009,109347,23.8,34539,2074,32465,46091,3.36815031572,0.0189671413025
"Cache County, Utah",2012,112095,25.5,37181,1947,35234,49203,3.18144405972,0.0173691957714
"Cache County, Utah",2015,117449,25,38715,3030,35685,50497,3.29127084209,0.0257984316597
"Caddo County, Oklahoma",2009,29505,37.4,13536,2609,10927,36989,2.7001921845,0.0884256905609
"Caddo County, Oklahoma",2012,29403,38.1,13174,2770,10404,38155,2.82612456747,0.0942080740061
"Caddo County, Oklahoma",2015,29495,37,13164,2962,10202,40674,2.89109978436,0.100423800644
"Caddo Parish, Louisiana",2009,252467,35.6,113303,15217,98086,36536,2.57393511816,0.0602732238273
"Caddo Parish, Louisiana",2012,254970,36.3,112162,13878,98284,40497,2.59421675959,0.0544299329333
"Caddo Parish, Louisiana",2015,254742,36.6,112557,14566,97991,41234,2.59964690635,0.0571794207473
"Caguas Municipio, Puerto Rico",2009,142926,36.8,52773,5398,47375,22425,3.01690765172,0.0377677959224
"Caguas Municipio, Puerto Rico",2012,142549,37.2,55096,6764,48332,23845,2.94937101713,0.0474503504058
"Caguas Municipio, Puerto Rico",2015,138262,38.4,58254,7754,50500,23769,2.73786138614,0.0560819314056
"Calaveras County, California",2009,46548,47.7,26905,8752,18153,57676,2.56420426376,0.188020967603
"Calaveras County, California",2012,45507,49.5,27867,9249,18618,54686,2.44424750242,0.203243457051
"Calaveras County, California",2015,44767,50.7,28031,9971,18060,53233,2.47879291251,0.222731029553
"Calcasieu Parish, Louisiana",2009,185017,35.3,82361,9758,72603,42938,2.54833822294,0.0527410994665
"Calcasieu Parish, Louisiana",2012,192307,35.9,82418,9628,72790,44247,2.64194257453,0.0500657802368
"Calcasieu Parish, Louisiana",2015,195887,36.1,84954,9629,75325,45312,2.6005575838,0.0491558908963
"Caldwell County, Kentucky",2009,12822,42.5,6350,973,5377,36929,2.38460107867,0.0758851973171
"Caldwell County, Kentucky",2012,12977,42.2,6291,1199,5092,37778,2.54850746269,0.0923942359559
"Caldwell County, Kentucky",2015,12826,42.6,6271,978,5293,42537,2.42320045343,0.076251364416
"Caldwell County, Missouri",2009,9192,41.5,4697,845,3852,37792,2.38629283489,0.0919277632724
"Caldwell County, Missouri",2012,9302,41.7,4597,865,3732,41324,2.49249732047,0.0929907546764
"Caldwell County, Missouri",2015,9083,42.3,4604,889,3715,43691,2.44495289367,0.0978751513817
"Caldwell County, North Carolina",2009,79382,40.1,36080,5204,30876,37308,2.57099365203,0.0655564233705
"Caldwell County, North Carolina",2012,82493,41.2,37569,5821,31748,36108,2.59836840116,0.070563562969
"Caldwell County, North Carolina",2015,81758,42.8,37633,6067,31566,35763,2.59006526009,0.0742068054502
"Caldwell County, Texas",2009,36895,35.8,13271,2028,11243,41387,3.28159743841,0.0549667976691
"Caldwell County, Texas",2012,38152,35.1,13714,2074,11640,43393,3.27766323024,0.054361501363
"Caldwell County, Texas",2015,39347,35.6,13864,1413,12451,47233,3.16014777929,0.0359112511754
"Caldwell Parish, Louisiana",2009,10400,37.9,5255,1389,3866,39156,2.69011898603,0.133557692308
"Caldwell Parish, Louisiana",2012,10118,40.4,5002,1041,3961,40181,2.55440545317,0.102885945839
"Caldwell Parish, Louisiana",2015,9990,39.9,5014,1176,3838,33294,2.60291818656,0.117717717718
"Caledonia County, Vermont",2009,30356,41.5,15332,2970,12362,41897,2.4555897104,0.0978389774674
"Caledonia County, Vermont",2012,31170,42.3,15906,3381,12525,44435,2.48862275449,0.108469682387
"Caledonia County, Vermont",2015,31012,43.1,16022,3735,12287,45323,2.52396842191,0.120437250097
"Calhoun County, Alabama",2009,112969,38.1,53553,6507,47046,38382,2.40124558942,0.0575998725314
"Calhoun County, Alabama",2012,117834,38.7,53293,7529,45764,40093,2.57481863473,0.0638949708913
"Calhoun County, Alabama",2015,116648,39.1,53296,8142,45154,41703,2.58333702441,0.0697997393869
"Calhoun County, Arkansas",2009,5411,41.1,3158,874,2284,32148,2.36908931699,0.161522823877
"Calhoun County, Arkansas",2012,5373,42.4,2909,825,2084,31425,2.57821497121,0.153545505304
"Calhoun County, Arkansas",2015,5245,44.9,2889,764,2125,36899,2.46823529412,0.145662535748
"Calhoun County, Florida",2009,13525,37.2,5492,1195,4297,29642,3.1475447987,0.0883548983364
"Calhoun County, Florida",2012,14639,40.1,5960,1108,4852,32480,3.0171063479,0.0756882300704
"Calhoun County, Florida",2015,14615,40.5,5944,1160,4784,34510,3.05497491639,0.0793705097503
"Calhoun County, Georgia",2009,6113,36.8,2369,548,1821,27723,3.35694673256,0.0896450188124
"Calhoun County, Georgia",2012,6581,38.8,2388,591,1797,30042,3.66221480245,0.0898039811579
"Calhoun County, Georgia",2015,6489,38.2,2339,503,1836,25513,3.53431372549,0.0775157959624
"Calhoun County, Illinois",2009,5076,42.9,2840,797,2043,44016,2.4845814978,0.157013396375
"Calhoun County, Illinois",2012,5065,44.6,2834,763,2071,47399,2.44567841622,0.15064165844
"Calhoun County, Illinois",2015,4999,46.9,2828,765,2063,53869,2.42317014057,0.153030606121
"Calhoun County, Iowa",2009,9964,46,4828,535,4293,40080,2.32098765432,0.0536932958651
"Calhoun County, Iowa",2012,9936,47.5,5031,611,4420,45097,2.2479638009,0.0614935587762
"Calhoun County, Iowa",2015,9914,46,5094,833,4261,44921,2.32668387702,0.0840225943111
"Calhoun County, Michigan",2009,136875,38,60767,6569,54198,42003,2.52546219418,0.0479926940639
"Calhoun County, Michigan",2012,136063,39.2,60997,7707,53290,42164,2.55325577031,0.0566428786665
"Calhoun County, Michigan",2015,134790,40.1,60716,7866,52850,42520,2.55042573321,0.0583574449143
"Calhoun County, Mississippi",2009,14533,39.4,7211,1063,6148,27078,2.36385816526,0.0731438794468
"Calhoun County, Mississippi",2012,14903,39.3,6934,929,6005,30768,2.48176519567,0.062336442327
"Calhoun County, Mississippi",2015,14789,40.5,6917,995,5922,31098,2.49729821006,0.0672797349381
"Calhoun County, South Carolina",2009,14746,44.2,7394,1427,5967,37402,2.47125858891,0.0967720059677
"Calhoun County, South Carolina",2012,15134,43.9,7342,1246,6096,39843,2.48261154856,0.0823311748381
"Calhoun County, South Carolina",2015,14958,45.3,7313,1285,6028,43531,2.48142003981,0.0859072068458
"Calhoun County, Texas",2009,20384,38.1,11001,3075,7926,43305,2.5717890487,0.150853610675
"Calhoun County, Texas",2012,21366,38.2,11393,3566,7827,45122,2.72978152549,0.166900683329
"Calhoun County, Texas",2015,21666,38.1,11606,3612,7994,51078,2.71028271203,0.166712821933
"Calhoun County, West Virginia",2009,7209,44.1,4004,869,3135,27367,2.2995215311,0.120543764739
"Calhoun County, West Virginia",2012,7613,45.4,3965,783,3182,29282,2.3925204274,0.102850387495
"Calhoun County, West Virginia",2015,7557,47,3947,857,3090,35568,2.44563106796,0.113404790261
"Callahan County, Texas",2009,13300,41,6214,1121,5093,44470,2.61142744944,0.0842857142857
"Callahan County, Texas",2012,13521,42.2,6530,1348,5182,46812,2.60922423775,0.0996967679905
"Callahan County, Texas",2015,13532,43.5,6574,1301,5273,40981,2.56628105443,0.0961424770913
"Callaway County, Missouri",2009,43192,36.6,17422,1636,15786,49425,2.73609527429,0.0378773847009
"Callaway County, Missouri",2012,44157,37.6,18452,1624,16828,50516,2.62401949132,0.0367778608148
"Callaway County, Missouri",2015,44566,37.8,18539,2389,16150,47744,2.75950464396,0.0536058878966
"Calloway County, Kentucky",2009,36036,34.2,17184,2427,14757,36632,2.44195974792,0.0673493173493
"Calloway County, Kentucky",2012,37198,33.6,18035,3037,14998,39037,2.48019735965,0.081644174418
"Calloway County, Kentucky",2015,38106,33.7,18237,3403,14834,37034,2.56882836726,0.0893035217551
"Calumet County, Wisconsin",2009,44407,37.2,19002,1281,17721,61655,2.50589695841,0.0288468034319
"Calumet County, Wisconsin",2012,48960,38.2,19666,1316,18350,64982,2.66811989101,0.0268790849673
"Calumet County, Wisconsin",2015,49678,39,19898,1315,18583,67427,2.67330355701,0.0264704698257
"Calvert County, Maryland",2009,88055,38.7,32317,2583,29734,90621,2.96142463173,0.0293339390154
"Calvert County, Maryland",2012,88774,39.8,33793,2877,30916,92395,2.87145814465,0.0324081375177
"Calvert County, Maryland",2015,90114,40.6,34384,3229,31155,95828,2.8924410207,0.0358323900837
"Camas County, Idaho",2009,1040,41,739,336,403,50114,2.58064516129,0.323076923077
"Camas County, Idaho",2012,1276,38,801,352,449,40515,2.84187082405,0.275862068966
"Camas County, Idaho",2015,1052,42.1,876,441,435,42614,2.4183908046,0.419201520913
"Cambria County, Pennsylvania",2009,145219,43.2,66452,6829,59623,38381,2.43562048203,0.0470255269627
"Cambria County, Pennsylvania",2012,143305,43.7,65646,7144,58502,41668,2.44957437353,0.0498517148739
"Cambria County, Pennsylvania",2015,139381,44.4,65413,7948,57465,42107,2.42549377882,0.057023554143
"Camden County, Georgia",2009,47003,30.8,20827,3098,17729,48967,2.65119296069,0.0659106865519
"Camden County, Georgia",2012,50435,31.6,21063,2911,18152,54155,2.77848171,0.0577178546644
"Camden County, Georgia",2015,51445,31.6,21366,2728,18638,52473,2.76022105376,0.0530275051025
"Camden County, Missouri",2009,40150,47,35651,19543,16108,43127,2.49255028557,0.486749688667
"Camden County, Missouri",2012,43731,48.7,40886,23266,17620,44577,2.48189557321,0.532025336718
"Camden County, Missouri",2015,43927,49.8,41234,24486,16748,44816,2.6228206353,0.557424818449
"Camden County, New Jersey",2009,516937,36.9,205611,13516,192095,60362,2.69104869986,0.0261463195709
"Camden County, New Jersey",2012,513660,37.7,205174,16313,188861,62320,2.71977803782,0.0317583615621
"Camden County, New Jersey",2015,511998,38.3,205768,19667,186101,62185,2.75118349713,0.0384122594229
"Camden County, North Carolina",2009,9375,40.2,3849,365,3484,58480,2.69087256028,0.0389333333333
"Camden County, North Carolina",2012,9965,40.1,4075,510,3565,56315,2.79523141655,0.0511791269443
"Camden County, North Carolina",2015,10161,41.1,4129,334,3795,58780,2.67747035573,0.032870780435
"Cameron County, Pennsylvania",2009,5334,44.9,4613,2457,2156,40288,2.47402597403,0.46062992126
"Cameron County, Pennsylvania",2012,5058,47.9,4455,2271,2184,41409,2.31593406593,0.448991696323
"Cameron County, Pennsylvania",2015,4869,49.9,4410,2240,2170,39897,2.24377880184,0.460053399055
"Cameron County, Texas",2009,383171,29.1,143029,26859,116170,30034,3.29836446587,0.0700966409253
"Cameron County, Texas",2012,405819,30.6,142475,25636,116839,32558,3.47331798458,0.0631710195925
"Cameron County, Texas",2015,417947,31.2,145194,24097,121097,33266,3.45134066079,0.0576556357624
"Cameron Parish, Louisiana",2009,7588,40.2,4659,1445,3214,57786,2.36092097075,0.190432261465
"Cameron Parish, Louisiana",2012,6934,40.3,3708,1226,2482,62353,2.79371474617,0.176809922123
"Cameron Parish, Louisiana",2015,6706,42.6,3524,916,2608,64231,2.5713190184,0.13659409484
"Camp County, Texas",2009,12489,36.5,5444,1022,4422,33891,2.82428765265,0.0818320121707
"Camp County, Texas",2012,12389,38,5641,1291,4350,36495,2.84804597701,0.10420534345
"Camp County, Texas",2015,12516,37.8,5675,1244,4431,37851,2.82464454976,0.0993927772451
"Campbell County, Kentucky",2009,87509,37.1,38961,3776,35185,51890,2.48711098479,0.0431498474443
"Campbell County, Kentucky",2012,90119,36.9,39497,4262,35235,53580,2.55765574003,0.0472930236687
"Campbell County, Kentucky",2015,91475,37.3,39754,4277,35477,54621,2.5784310962,0.0467559442471
"Campbell County, South Dakota",2009,1450,46.5,993,312,681,35764,2.12922173275,0.215172413793
"Campbell County, South Dakota",2012,1419,50.5,961,309,652,36563,2.1763803681,0.217758985201
"Campbell County, South Dakota",2015,1548,49.6,1000,317,683,45170,2.26647144949,0.204780361757
"Campbell County, Tennessee",2009,40646,40.1,19213,3424,15789,28988,2.57432389638,0.0842395315652
"Campbell County, Tennessee",2012,40629,41.8,19933,3900,16033,31312,2.53408594773,0.0959905486229
"Campbell County, Tennessee",2015,40176,43,20256,4261,15995,32028,2.51178493279,0.10605834329
"Campbell County, Virginia",2009,52542,40.1,24177,2132,22045,43324,2.38339759583,0.0405770621598
"Campbell County, Virginia",2012,54797,41.4,24761,3180,21581,45432,2.53913164358,0.0580323740351
"Campbell County, Virginia",2015,55012,42.4,25100,3309,21791,47699,2.52452847506,0.0601505126154
"Campbell County, Wyoming",2009,40290,31.7,15015,1218,13797,74757,2.92020004349,0.0302308265078
"Campbell County, Wyoming",2012,45840,31.8,18819,1882,16937,77090,2.7065005609,0.0410558464223
"Campbell County, Wyoming",2015,48013,32.7,19525,2015,17510,80060,2.74203312393,0.0419678003874
"Camuy Municipio, Puerto Rico",2009,39310,35,12554,2115,10439,14375,3.76568636843,0.053803103536
"Camuy Municipio, Puerto Rico",2012,35085,37.5,13204,2217,10987,17762,3.19331937745,0.0631893971783
"Camuy Municipio, Puerto Rico",2015,33949,39,14076,2142,11934,17532,2.84472934473,0.0630946419629
"Canadian County, Oklahoma",2009,103588,35.9,40287,3424,36863,59015,2.81008056859,0.0330540217014
"Canadian County, Oklahoma",2012,116299,35.7,45561,3904,41657,63884,2.7918237031,0.033568646334
"Canadian County, Oklahoma",2015,126193,35.7,46753,3690,43063,64505,2.93042751318,0.0292409246155
"Candler County, Georgia",2009,10380,35.7,4017,891,3126,35951,3.32053742802,0.085838150289
"Candler County, Georgia",2012,11007,37.6,4706,922,3784,35833,2.90882663848,0.0837648768965
"Candler County, Georgia",2015,11031,37.1,4714,805,3909,30185,2.82194934766,0.0729761580999
"Cannon County, Tennessee",2009,13505,40.6,5718,497,5221,35972,2.58666922046,0.0368011847464
"Cannon County, Tennessee",2012,13797,40.4,6026,703,5323,40998,2.59195942138,0.0509531057476
"Cannon County, Tennessee",2015,13787,41.9,6057,669,5388,41533,2.55883444692,0.0485239718575
"Canyon County, Idaho",2009,176820,30.8,65433,4995,60438,42912,2.92564280751,0.0282490668476
"Canyon County, Idaho",2012,189396,31.6,69299,6287,63012,42691,3.00571319749,0.0331949988384
"Canyon County, Idaho",2015,198921,32.8,70720,4913,65807,42888,3.0227939277,0.0246982470428
"Canóvanas Municipio, Puerto Rico",2009,47174,33,15603,2161,13442,22292,3.50944799881,0.0458091321491
"Canóvanas Municipio, Puerto Rico",2012,47656,35.4,16751,2532,14219,22746,3.3515718405,0.0531307705221
"Canóvanas Municipio, Puerto Rico",2015,47432,37.5,17901,3203,14698,20023,3.22710572867,0.0675282509698
"Cape Girardeau County, Missouri",2009,72621,36.4,31271,2323,28948,43639,2.50867071991,0.031987992454
"Cape Girardeau County, Missouri",2012,75690,36.3,32576,3074,29502,46154,2.56558877364,0.0406130268199
"Cape Girardeau County, Missouri",2015,77606,36,32904,3109,29795,46050,2.60466521228,0.0400613354638
"Cape May County, New Jersey",2009,97127,46.3,101027,54318,46709,54441,2.07940653835,0.559247171229
"Cape May County, New Jersey",2012,96987,47.3,98519,55005,43514,56370,2.22886886979,0.567137863837
"Cape May County, New Jersey",2015,95805,48.3,98747,58335,40412,57637,2.37070672078,0.608893064036
"Carbon County, Montana",2009,9741,45.9,5738,1764,3974,50676,2.45118268747,0.181090237142
"Carbon County, Montana",2012,10057,48,6424,2208,4216,47030,2.38543643264,0.219548573133
"Carbon County, Montana",2015,10268,49.1,6473,1993,4480,49767,2.29196428571,0.194098169069
"Carbon County, Pennsylvania",2009,62856,42.8,32831,7398,25433,47283,2.47143475013,0.117697594502
"Carbon County, Pennsylvania",2012,65101,44,34253,7997,26256,49951,2.47947135893,0.122839894932
"Carbon County, Pennsylvania",2015,64634,45,34400,8649,25751,49973,2.50996077822,0.133815019959
"Carbon County, Utah",2009,19536,35.7,9102,1348,7754,41056,2.51947381996,0.0690008190008
"Carbon County, Utah",2012,21153,34.6,9528,1768,7760,47240,2.72590206186,0.0835815250792
"Carbon County, Utah",2015,20927,35.1,9604,1806,7798,46900,2.68363682996,0.0862999952215
"Carbon County, Wyoming",2009,15347,40.4,8607,2451,6156,50963,2.49301494477,0.159705479898
"Carbon County, Wyoming",2012,15781,39.4,8580,2536,6044,57787,2.61101919259,0.160699575439
"Carbon County, Wyoming",2015,15739,39,8559,2451,6108,56825,2.57678454486,0.155727809899
"Caribou County, Idaho",2009,6888,38.6,3276,589,2687,43918,2.5634536658,0.0855110336818
"Caribou County, Idaho",2012,6872,38.1,3226,592,2634,52134,2.60895975702,0.0861466821886
"Caribou County, Idaho",2015,6808,36.8,3218,612,2606,58021,2.61243284728,0.0898942420682
"Carlisle County, Kentucky",2009,5205,42.7,2605,436,2169,33468,2.39972337483,0.0837656099904
"Carlisle County, Kentucky",2012,5081,43.2,2447,362,2085,37768,2.43693045564,0.0712458177524
"Carlisle County, Kentucky",2015,4984,42.3,2426,367,2059,38829,2.42059252064,0.0736356340289
"Carlton County, Minnesota",2009,33875,40.7,15483,1835,13648,51552,2.48204865182,0.0541697416974
"Carlton County, Minnesota",2012,35304,41,15642,1903,13739,52943,2.56961933183,0.053903240426
"Carlton County, Minnesota",2015,35443,41,15759,2361,13398,53227,2.64539483505,0.0666139999436
"Carolina Municipio, Puerto Rico",2009,187439,36.8,72205,10711,61494,28391,3.04808599213,0.0571439241567
"Carolina Municipio, Puerto Rico",2012,176157,37.8,74214,12514,61700,29470,2.85505672609,0.0710389027969
"Carolina Municipio, Puerto Rico",2015,168114,39.7,77446,13080,64366,27969,2.61184476276,0.0778043470502
"Caroline County, Maryland",2009,32727,37.9,13479,1505,11974,55844,2.73317187239,0.0459864943319
"Caroline County, Maryland",2012,32947,38.9,13489,1683,11806,60735,2.79069964425,0.0510820408535
"Caroline County, Maryland",2015,32661,40.1,13525,1605,11920,52465,2.74001677852,0.0491411775512
"Caroline County, Virginia",2009,26917,38.6,11217,1159,10058,56829,2.67617816663,0.0430582902998
"Caroline County, Virginia",2012,28510,38.6,11734,1085,10649,58044,2.67724668983,0.0380568221677
"Caroline County, Virginia",2015,29349,39.1,11927,957,10970,59227,2.67538742024,0.0326075845855
"Carroll County, Arkansas",2009,27321,41.9,12542,1762,10780,32978,2.53441558442,0.0644925149153
"Carroll County, Arkansas",2012,27321,44.2,13507,2191,11316,35558,2.41436903499,0.0801947220087
"Carroll County, Arkansas",2015,27635,44.2,13561,2584,10977,36897,2.51753666758,0.0935046137145
"Carroll County, Georgia",2009,110641,33,45028,5096,39932,44693,2.77073524992,0.0460588751006
"Carroll County, Georgia",2012,110750,33.6,44680,5276,39404,46704,2.8106283626,0.0476388261851
"Carroll County, Georgia",2015,112595,34,44657,4583,40074,43586,2.80967709737,0.0407034060127
"Carroll County, Illinois",2009,15878,45,8301,1332,6969,42969,2.27837566365,0.0838896586472
"Carroll County, Illinois",2012,15338,46.5,8432,1693,6739,48456,2.27600534204,0.110379449733
"Carroll County, Illinois",2015,14926,47.5,8435,1818,6617,48631,2.25570500227,0.121800884363
"Carroll County, Indiana",2009,19863,39.6,9350,1311,8039,47030,2.47082970519,0.0660021144842
"Carroll County, Indiana",2012,20105,41.3,9475,1415,8060,49935,2.49441687345,0.0703805023626
"Carroll County, Indiana",2015,20014,41.5,9456,1663,7793,52005,2.56820223277,0.083091835715
"Carroll County, Iowa",2009,20764,43.2,9294,680,8614,46034,2.41049454377,0.0327489886342
"Carroll County, Iowa",2012,20751,42.5,9379,789,8590,48824,2.41571594878,0.0380222639873
"Carroll County, Iowa",2015,20629,42.3,9398,851,8547,50559,2.4135954136,0.0412526055553
"Carroll County, Kentucky",2009,10536,37.3,4613,528,4085,44087,2.57919216646,0.0501138952164
"Carroll County, Kentucky",2012,10851,36.6,4694,426,4268,40938,2.54240862231,0.039259054465
"Carroll County, Kentucky",2015,10830,36.9,4687,699,3988,41439,2.71564694082,0.0645429362881
"Carroll County, Maryland",2009,168964,39.3,61239,2250,58989,80743,2.86433063792,0.0133164461069
"Carroll County, Maryland",2012,167249,41.1,62379,2695,59684,83155,2.80224180685,0.0161136987366
"Carroll County, Maryland",2015,167444,42.2,62919,2915,60004,85385,2.79054729685,0.0174088053319
"Carroll County, Mississippi",2009,10301,43.2,5185,1166,4019,28100,2.56307539189,0.113192893894
"Carroll County, Mississippi",2012,10553,42.3,5059,1245,3814,30568,2.76691137913,0.117975931015
"Carroll County, Mississippi",2015,10338,44.6,5059,1365,3694,37289,2.79859231186,0.132037144515
"Carroll County, Missouri",2009,9816,42,5024,868,4156,38360,2.36188642926,0.0884270578647
"Carroll County, Missouri",2012,9279,41.8,4650,991,3659,44858,2.53593878109,0.106800301757
"Carroll County, Missouri",2015,9096,42.4,4603,979,3624,42415,2.50993377483,0.107629727353
"Carroll County, New Hampshire",2009,47591,46.2,38316,19281,19035,50479,2.50018387182,0.40513962724
"Carroll County, New Hampshire",2012,47761,48.2,39778,19146,20632,50865,2.31489918573,0.400871003538
"Carroll County, New Hampshire",2015,47513,50.3,40127,18921,21206,53306,2.24054512874,0.39822785343
"Carroll County, Ohio",2009,28752,42.2,13122,1786,11336,42375,2.53634438956,0.0621174179188
"Carroll County, Ohio",2012,28828,43.2,13664,2240,11424,43127,2.52345938375,0.0777022339392
"Carroll County, Ohio",2015,28361,44.5,13610,2638,10972,47075,2.58485235144,0.0930150558866
"Carroll County, Tennessee",2009,28686,40.8,13646,2071,11575,35713,2.47827213823,0.0721954960608
"Carroll County, Tennessee",2012,28486,42,13203,2348,10855,35595,2.62422846614,0.0824264551008
"Carroll County, Tennessee",2015,28353,42.6,13211,2043,11168,35508,2.53877148997,0.072055867104
"Carroll County, Virginia",2009,29137,44,15920,3364,12556,34794,2.32056387385,0.115454576655
"Carroll County, Virginia",2012,29989,45,16539,3917,12622,33600,2.37593091428,0.130614558672
"Carroll County, Virginia",2015,29856,46.1,16621,4073,12548,35000,2.37934332164,0.136421489818
"Carson City, Nevada",2009,55262,40,22889,1836,21053,52096,2.62489906427,0.0332235532554
"Carson City, Nevada",2012,55184,41.6,23511,2389,21122,53987,2.6126313796,0.0432915337779
"Carson City, Nevada",2015,54482,42.6,23470,1876,21594,47668,2.5230156525,0.0344333908447
"Carson County, Texas",2009,6246,41.7,2909,365,2544,53425,2.45518867925,0.058437399936
"Carson County, Texas",2012,6215,40.6,2783,446,2337,60813,2.6593923834,0.0717618664521
"Carson County, Texas",2015,6068,40.7,2771,478,2293,66023,2.64631487135,0.0787738958471
"Carter County, Kentucky",2009,27160,37.4,12273,1618,10655,33232,2.54903801032,0.0595729013255
"Carter County, Kentucky",2012,27594,39.2,12290,1878,10412,35415,2.65021129466,0.0680582735377
"Carter County, Kentucky",2015,27326,40.1,12285,1798,10487,36696,2.60570229808,0.0657981409646
"Carter County, Missouri",2009,5894,40.2,3165,770,2395,24502,2.46096033403,0.130641330166
"Carter County, Missouri",2012,6225,40.3,3241,809,2432,27209,2.55962171053,0.129959839357
"Carter County, Missouri",2015,6284,40.9,3235,782,2453,33034,2.56176110885,0.124443029917
"Carter County, Montana",2009,1260,51.5,828,259,569,35813,2.2144112478,0.205555555556
"Carter County, Montana",2012,1276,51.5,828,283,545,38750,2.34128440367,0.221786833856
"Carter County, Montana",2015,1227,50.8,796,292,504,45000,2.43452380952,0.237978810106
"Carter County, Oklahoma",2009,47388,38.5,21722,3143,18579,38132,2.55062166963,0.0663248079683
"Carter County, Oklahoma",2012,47603,38.3,21210,3851,17359,41039,2.74226625958,0.0808982627145
"Carter County, Oklahoma",2015,48442,38.6,21408,3541,17867,44531,2.71125538703,0.0730977251146
"Carter County, Tennessee",2009,58955,40.1,27383,3654,23729,32424,2.48451262169,0.0619794758714
"Carter County, Tennessee",2012,57531,42.3,27734,3736,23998,32908,2.39732477706,0.0649389025047
"Carter County, Tennessee",2015,56941,43.6,27817,3923,23894,33213,2.38306687871,0.0688958746773
"Carteret County, North Carolina",2009,63369,44.8,45722,18313,27409,46982,2.31197781751,0.288989884644
"Carteret County, North Carolina",2012,66415,45.7,48148,19913,28235,47506,2.35222241898,0.299826846345
"Carteret County, North Carolina",2015,68228,46.4,48694,19129,29565,48457,2.3077287333,0.280368763557
"Carver County, Minnesota",2009,88208,35.9,33162,1207,31955,78436,2.76038178689,0.0136835661165
"Carver County, Minnesota",2012,91355,36.3,34625,1608,33017,83275,2.76690795651,0.0176016638389
"Carver County, Minnesota",2015,95715,36.9,35842,1421,34421,86323,2.78071526103,0.0148461578645
"Cascade County, Montana",2009,81912,38.5,36178,3670,32508,41964,2.51974898487,0.0448041800957
"Cascade County, Montana",2012,81248,38.7,37260,3908,33352,43817,2.43607579755,0.0480996455297
"Cascade County, Montana",2015,82090,38,37553,3769,33784,45205,2.42984844897,0.0459130222926
"Casey County, Kentucky",2009,16306,39.5,7610,1412,6198,26079,2.63084866086,0.086593891819
"Casey County, Kentucky",2012,15984,41.1,7483,1321,6162,28416,2.59396299903,0.0826451451451
"Casey County, Kentucky",2015,15954,42.1,7429,1045,6384,32341,2.49906015038,0.0655008148427
"Cass County, Illinois",2009,13575,37.5,5975,946,5029,41083,2.69934380593,0.0696869244936
"Cass County, Illinois",2012,13570,37.9,5845,775,5070,43180,2.67652859961,0.057111274871
"Cass County, Illinois",2015,13254,39.2,5799,599,5200,47434,2.54884615385,0.0451939037272
"Cass County, Indiana",2009,39263,38.2,17277,1701,15576,43006,2.52073703133,0.0433232305224
"Cass County, Indiana",2012,38875,38.6,16508,1787,14721,41135,2.64078527274,0.0459678456592
"Cass County, Indiana",2015,38476,40.1,16374,1819,14555,42290,2.64349020955,0.0472762241397
"Cass County, Iowa",2009,13854,44.7,6737,617,6120,40437,2.2637254902,0.0445358741158
"Cass County, Iowa",2012,13865,44.8,6603,529,6074,43114,2.28268027659,0.0381536242337
"Cass County, Iowa",2015,13590,44.7,6559,479,6080,43750,2.23519736842,0.0352465047829
"Cass County, Michigan",2009,50483,40.9,25667,5266,20401,45263,2.47453556198,0.104312342769
"Cass County, Michigan",2012,52412,42.5,25854,6053,19801,45462,2.64693702338,0.115488819354
"Cass County, Michigan",2015,51952,44.1,25909,5808,20101,46570,2.58454803244,0.111795503542
"Cass County, Minnesota",2009,28654,45.6,25119,11927,13192,41501,2.17207398423,0.416242060445
"Cass County, Minnesota",2012,28519,47,24761,11835,12926,43992,2.2063283305,0.414986500228
"Cass County, Minnesota",2015,28519,48.3,25011,12155,12856,46531,2.21834163037,0.42620709001
"Cass County, Missouri",2009,97203,36.8,38448,2491,35957,60628,2.70331228968,0.0256267810664
"Cass County, Missouri",2012,99394,38.3,39990,2770,37220,60595,2.67044599678,0.0278688854458
"Cass County, Missouri",2015,100781,39.2,40422,2477,37945,61584,2.65597575438,0.0245780454649
"Cass County, Nebraska",2009,25495,39.9,11130,1450,9680,62527,2.63378099174,0.0568738968425
"Cass County, Nebraska",2012,25214,40.9,11142,1428,9714,64979,2.59563516574,0.0566352026652
"Cass County, Nebraska",2015,25360,41.5,11225,1469,9756,65619,2.59942599426,0.0579258675079
"Cass County, North Dakota",2009,137803,30.4,64139,3072,61067,45891,2.25658702736,0.0222926931925
"Cass County, North Dakota",2012,150240,31.7,68267,3543,64724,51110,2.32124096162,0.0235822683706
"Cass County, North Dakota",2015,162500,31.9,73190,4414,68776,53289,2.36274281726,0.0271630769231
"Cass County, Texas",2009,29315,43.2,14539,2226,12313,36693,2.38081702266,0.0759338222753
"Cass County, Texas",2012,30324,43.8,14379,2640,11739,35932,2.5831842576,0.0870597546498
"Cass County, Texas",2015,30328,43.3,14400,2709,11691,37352,2.59413223847,0.0893233975204
"Cassia County, Idaho",2009,21154,33.3,8165,771,7394,39167,2.86096835272,0.0364470076581
"Cassia County, Idaho",2012,22813,32.1,8372,720,7652,43039,2.98131207527,0.0315609520887
"Cassia County, Idaho",2015,23369,31.7,8425,693,7732,45695,3.02237454734,0.0296546707176
"Castro County, Texas",2009,7233,35.7,3232,460,2772,34849,2.60930735931,0.0635974008019
"Castro County, Texas",2012,7984,33.8,3167,570,2597,35301,3.07431651906,0.0713927855711
"Castro County, Texas",2015,7948,34.6,3178,677,2501,39459,3.17792882847,0.0851786612984
"Caswell County, North Carolina",2009,23228,41.6,10254,1584,8670,36414,2.67912341407,0.0681935594972
"Caswell County, North Carolina",2012,23615,43.6,10598,1843,8755,38387,2.69731581953,0.0780436163455
"Caswell County, North Carolina",2015,23174,44.9,10582,1906,8676,37869,2.67104656524,0.0822473461638
"Catahoula Parish, Louisiana",2009,10424,37.7,5694,1458,4236,33913,2.46081208687,0.13986953185
"Catahoula Parish, Louisiana",2012,10409,37.3,4922,1169,3753,38205,2.77351452172,0.1123066577
"Catahoula Parish, Louisiana",2015,10247,38.5,4901,1153,3748,34904,2.73399146211,0.112520737777
"Catawba County, North Carolina",2009,155157,38.5,67084,7787,59297,43303,2.61660792283,0.0501878742177
"Catawba County, North Carolina",2012,154201,39.7,67809,9114,58695,43657,2.62715733879,0.059104675067
"Catawba County, North Carolina",2015,154610,40.8,67820,9179,58641,44376,2.63655121843,0.0593687342345
"Cataño Municipio, Puerto Rico",2009,26561,33.4,10398,896,9502,17298,2.79530625132,0.0337336696661
"Cataño Municipio, Puerto Rico",2012,28049,35.1,10665,1270,9395,17780,2.98552421501,0.0452779065207
"Cataño Municipio, Puerto Rico",2015,26680,36.9,10890,1518,9372,18326,2.84677763551,0.0568965517241
"Catoosa County, Georgia",2009,62075,37.4,25902,2144,23758,45295,2.61280410809,0.0345388642771
"Catoosa County, Georgia",2012,64226,38.7,26582,2774,23808,46143,2.69766465054,0.0431912309657
"Catoosa County, Georgia",2015,65375,39,26735,2792,23943,50876,2.73044313578,0.042707456979
"Catron County, New Mexico",2009,3410,59.6,2976,1203,1773,30413,1.92329385223,0.352785923754
"Catron County, New Mexico",2012,3686,57.6,3551,1870,1681,34738,2.19274241523,0.507325013565
"Catron County, New Mexico",2015,3583,57.1,3785,2398,1387,42973,2.58327325162,0.669271560145
"Cattaraugus County, New York",2009,80349,40.1,40612,7973,32639,41482,2.46174821533,0.0992296108228
"Cattaraugus County, New York",2012,80166,40.8,41085,8666,32419,43202,2.47280915513,0.108100691066
"Cattaraugus County, New York",2015,78962,41.4,41034,9399,31635,42601,2.49603287498,0.119031939414
"Cavalier County, North Dakota",2009,3905,50.5,2477,717,1760,47143,2.21875,0.183610755442
"Cavalier County, North Dakota",2012,3974,50.7,2340,611,1729,54080,2.2984384037,0.153749370911
"Cavalier County, North Dakota",2015,3890,50.8,2324,578,1746,66806,2.22794959908,0.148586118252
"Cayey Municipio, Puerto Rico",2009,47293,36.5,17959,2442,15517,18845,3.04781852162,0.0516355486013
"Cayey Municipio, Puerto Rico",2012,48008,37.6,18524,2638,15886,20912,3.02203197784,0.0549491751375
"Cayey Municipio, Puerto Rico",2015,46647,39.8,19938,3363,16575,20751,2.81429864253,0.0720946684674
"Cayuga County, New York",2009,79994,40.3,36062,4302,31760,47414,2.51870277078,0.0537790334275
"Cayuga County, New York",2012,79996,41.6,36448,5021,31427,50950,2.54545454545,0.0627656382819
"Cayuga County, New York",2015,79173,42.5,36405,5433,30972,52082,2.55627663696,0.0686218786708
"Cecil County, Maryland",2009,99069,37.7,40100,4228,35872,65079,2.76173617306,0.0426773259042
"Cecil County, Maryland",2012,101109,39,41131,5189,35942,66025,2.81311557509,0.051320851754
"Cecil County, Maryland",2015,101960,40.1,42030,5302,36728,66396,2.77608364191,0.0520007846214
"Cedar County, Iowa",2009,17987,42.3,8037,479,7558,52197,2.37986239746,0.0266303441374
"Cedar County, Iowa",2012,18446,42.8,8060,466,7594,58433,2.42902291283,0.0252629296324
"Cedar County, Iowa",2015,18375,42.1,8111,491,7620,59047,2.41141732283,0.0267210884354
"Cedar County, Missouri",2009,13790,44.4,7110,1066,6044,33503,2.28160158835,0.0773023930384
"Cedar County, Missouri",2012,13941,44.6,7204,1143,6061,31677,2.30011549249,0.0819883795997
"Cedar County, Missouri",2015,13892,44.8,7180,1276,5904,31532,2.35298102981,0.0918514252807
"Cedar County, Nebraska",2009,8582,43.4,4297,823,3474,42430,2.4703511802,0.0958983919832
"Cedar County, Nebraska",2012,8807,44.5,4148,713,3435,43718,2.56390101892,0.0809583286022
"Cedar County, Nebraska",2015,8675,44.8,4136,561,3575,52250,2.42657342657,0.0646685878963
"Ceiba Municipio, Puerto Rico",2009,17863,33.4,7526,2822,4704,16897,3.79740646259,0.1579801825
"Ceiba Municipio, Puerto Rico",2012,13726,38.4,7456,3101,4355,20455,3.15177956372,0.225921608626
"Ceiba Municipio, Puerto Rico",2015,12810,39.7,7453,2869,4584,20702,2.7945026178,0.223965651835
"Centre County, Pennsylvania",2009,144306,27.3,58124,6405,51719,45959,2.79019315919,0.0443848488628
"Centre County, Pennsylvania",2012,153758,28.9,63067,6541,56526,49706,2.72012879029,0.0425408759219
"Centre County, Pennsylvania",2015,157823,30.3,64489,7306,57183,52186,2.75996362555,0.0462923654981
"Cerro Gordo County, Iowa",2009,43927,42.3,21887,2488,19399,44770,2.26439507191,0.0566394244997
"Cerro Gordo County, Iowa",2012,44083,43.4,22155,2054,20101,44762,2.19307497139,0.0465939250958
"Cerro Gordo County, Iowa",2015,43481,44.2,22215,2696,19519,46122,2.227624366,0.0620040937421
"Chaffee County, Colorado",2009,16870,46.3,9821,2389,7432,42808,2.2699138859,0.141612329579
"Chaffee County, Colorado",2012,17879,47.3,10038,2358,7680,45713,2.32799479167,0.131886570837
"Chaffee County, Colorado",2015,18309,49.2,10260,2504,7756,51092,2.36062403301,0.136763340434
"Chambers County, Alabama",2009,34704,39.6,16846,3174,13672,32433,2.53832650673,0.091459197787
"Chambers County, Alabama",2012,34228,41.4,17000,3366,13634,32181,2.51048848467,0.0983405399088
"Chambers County, Alabama",2015,34079,43,16936,3149,13787,34177,2.47182128092,0.0924029460958
"Chambers County, Texas",2009,29198,37.1,13373,1758,11615,60451,2.51381833836,0.0602096033975
"Chambers County, Texas",2012,34562,36.2,13362,1540,11822,75200,2.92353239723,0.04455760662
"Chambers County, Texas",2015,37251,36.2,14139,1121,13018,70544,2.86149946228,0.0300931518617
"Champaign County, Illinois",2009,192135,26.8,83655,7294,76361,42561,2.51614043818,0.0379628906758
"Champaign County, Illinois",2012,200931,28.9,87460,8193,79267,45088,2.53486318392,0.0407751914836
"Champaign County, Illinois",2015,205766,29.3,88981,9069,79912,46495,2.57490739814,0.0440743368681
"Champaign County, Ohio",2009,39549,39.3,16880,1550,15330,49335,2.57984344423,0.0391918885433
"Champaign County, Ohio",2012,39982,39.7,16748,1508,15240,50214,2.62349081365,0.0377169726377
"Champaign County, Ohio",2015,39393,41.2,16714,1477,15237,50974,2.58535144714,0.0374939710101
"Chariton County, Missouri",2009,7777,45.7,4380,1077,3303,41233,2.35452618831,0.138485277099
"Chariton County, Missouri",2012,7759,45.3,4167,1156,3011,40538,2.5768847559,0.148988271684
"Chariton County, Missouri",2015,7650,45.5,4153,1206,2947,40642,2.59586019681,0.157647058824
"Charles City County, Virginia",2009,7146,45.8,3182,470,2712,49747,2.63495575221,0.0657710607333
"Charles City County, Virginia",2012,7226,47.1,3243,466,2777,48208,2.6020885848,0.0644893440354
"Charles City County, Virginia",2015,7118,48.6,3303,420,2883,49563,2.46895594866,0.0590053385783
"Charles County, Maryland",2009,140181,36.1,52282,3311,48971,86141,2.86253088563,0.023619463408
"Charles County, Maryland",2012,147107,37.2,55049,4204,50845,93063,2.89324417347,0.0285778379003
"Charles County, Maryland",2015,152754,37.7,57156,3985,53171,90607,2.87288183408,0.0260876965579
"Charles Mix County, South Dakota",2009,8999,37.7,3956,612,3344,35385,2.69108851675,0.0680075563952
"Charles Mix County, South Dakota",2012,9127,39,3856,663,3193,38475,2.85844033824,0.0726416127972
"Charles Mix County, South Dakota",2015,9239,37.3,3850,679,3171,43109,2.91359192684,0.0734928022513
"Charleston County, South Carolina",2009,345714,34.9,168567,28813,139754,47770,2.47373241553,0.0833434573086
"Charleston County, South Carolina",2012,352548,35.8,170401,29469,140932,50289,2.50154684529,0.0835886177201
"Charleston County, South Carolina",2015,372904,36.5,175607,27589,148018,53437,2.51931521842,0.0739841889602
"Charlevoix County, Michigan",2009,26098,43.6,17362,5781,11581,48641,2.25351869441,0.221511226914
"Charlevoix County, Michigan",2012,26057,45.3,17266,6567,10699,47177,2.43546125806,0.252024408029
"Charlevoix County, Michigan",2015,26134,46.7,17336,6542,10794,46554,2.42115990365,0.250325246805
"Charlotte County, Florida",2009,156043,54.6,98200,25554,72646,44639,2.14799163065,0.16376255263
"Charlotte County, Florida",2012,160380,55.9,100727,29440,71287,44596,2.2497790621,0.183564035416
"Charlotte County, Florida",2015,165783,57.3,101195,29339,71856,44244,2.30715597862,0.176972307173
"Charlotte County, Virginia",2009,12222,42.1,6265,1603,4662,37591,2.62162162162,0.131156930126
"Charlotte County, Virginia",2012,12546,43.5,6264,1461,4803,33562,2.61211742661,0.116451458632
"Charlotte County, Virginia",2015,12313,44.6,6298,1575,4723,35079,2.60702943045,0.127913587265
"Charlottesville city, Virginia",2009,41393,27.9,18659,1622,17037,38369,2.42959441216,0.0391853695069
"Charlottesville city, Virginia",2012,43223,28.1,19211,1892,17319,44535,2.49569836596,0.0437729912315
"Charlottesville city, Virginia",2015,45084,29.8,19886,2134,17752,49775,2.53965750338,0.047333865673
"Charlton County, Georgia",2009,10700,37.5,4108,651,3457,39734,3.09516922187,0.0608411214953
"Charlton County, Georgia",2012,12954,38,4446,691,3755,39511,3.44980026631,0.0533425968813
"Charlton County, Georgia",2015,13130,40.7,4436,912,3524,42778,3.72587968218,0.0694592536177
"Chase County, Kansas",2009,2880,41.7,1548,369,1179,41719,2.4427480916,0.128125
"Chase County, Kansas",2012,2788,45.5,1507,390,1117,36434,2.49597135184,0.139885222382
"Chase County, Kansas",2015,2722,46.2,1496,386,1110,38707,2.45225225225,0.141807494489
"Chase County, Nebraska",2009,3702,46.4,1960,298,1662,37192,2.2274368231,0.0804970286332
"Chase County, Nebraska",2012,3964,43.7,1923,205,1718,43125,2.30733410943,0.0517154389506
"Chase County, Nebraska",2015,3897,44.9,1909,208,1701,52422,2.29100529101,0.0533743905568
"Chatham County, Georgia",2009,248078,34.2,114064,15536,98528,44464,2.51784264372,0.0626254645716
"Chatham County, Georgia",2012,266344,34,119318,17591,101727,45653,2.61822328389,0.0660461658607
"Chatham County, Georgia",2015,279290,34.3,121877,16965,104912,47218,2.66213588531,0.0607433134018
"Chatham County, North Carolina",2009,61444,40.6,25558,2453,23105,55333,2.65933780567,0.0399225310852
"Chatham County, North Carolina",2012,63896,44.1,28681,2984,25697,57793,2.48651593571,0.0467008889445
"Chatham County, North Carolina",2015,67431,46.3,29632,2709,26923,56642,2.50458715596,0.0401744004983
"Chattahoochee County, Georgia",2009,14364,25,3363,733,2630,48035,5.46159695817,0.0510303536619
"Chattahoochee County, Georgia",2012,11917,23.8,3371,812,2559,48684,4.65689722548,0.0681379541831
"Chattahoochee County, Georgia",2015,11914,23.3,3352,753,2599,43378,4.58407079646,0.0632029545073
"Chattooga County, Georgia",2009,26492,36.6,10980,1931,9049,31550,2.92761631119,0.0728899290352
"Chattooga County, Georgia",2012,25905,39.5,10966,1622,9344,32825,2.77236729452,0.0626133950975
"Chattooga County, Georgia",2015,25241,40.3,10903,1539,9364,32913,2.69553609569,0.0609722277247
"Chautauqua County, Kansas",2009,3826,47.3,2239,580,1659,35433,2.30620855937,0.151594354417
"Chautauqua County, Kansas",2012,3654,48.3,2161,596,1565,37039,2.33482428115,0.16310892173
"Chautauqua County, Kansas",2015,3520,49.1,2134,577,1557,37993,2.26075786769,0.163920454545
"Chautauqua County, New York",2009,134078,40,65907,11450,54457,40179,2.4620893549,0.0853980518802
"Chautauqua County, New York",2012,134599,40.6,66832,11882,54950,41975,2.44948134668,0.08827703029
"Chautauqua County, New York",2015,132646,41.7,66741,13195,53546,42993,2.47723452732,0.0994752951465
"Chaves County, New Mexico",2009,62365,35,26383,3281,23102,36445,2.69954982253,0.0526096368155
"Chaves County, New Mexico",2012,65343,34.8,26693,3130,23563,38155,2.77311887281,0.0479010758612
"Chaves County, New Mexico",2015,65811,34.8,26709,3287,23422,40630,2.80979421057,0.0499460576499
"Cheatham County, Tennessee",2009,39042,38.3,15598,1130,14468,51221,2.69850705004,0.0289431893858
"Cheatham County, Tennessee",2012,39103,39.5,15635,1136,14499,53363,2.69694461687,0.0290514794261
"Cheatham County, Tennessee",2015,39422,39.8,15797,1298,14499,51857,2.71894613422,0.0329257774847
"Cheboygan County, Michigan",2009,26711,45.2,17890,6186,11704,38189,2.28221120984,0.231589981655
"Cheboygan County, Michigan",2012,26195,47.1,18292,6833,11459,38166,2.28597608866,0.260851307501
"Cheboygan County, Michigan",2015,25690,49.1,18284,7061,11223,40219,2.28904927381,0.274854028805
"Chelan County, Washington",2009,70668,39.4,32941,6960,25981,47009,2.71998768331,0.0984887077602
"Chelan County, Washington",2012,72431,39.8,35373,8325,27048,50582,2.67786897368,0.1149369745
"Chelan County, Washington",2015,74267,39.3,35934,8882,27052,51837,2.74534230371,0.119595513485
"Chemung County, New York",2009,88161,40.3,38116,2886,35230,42420,2.50244110133,0.0327355633443
"Chemung County, New York",2012,88779,40.9,38326,2874,35452,48128,2.50420286585,0.0323725205285
"Chemung County, New York",2015,88267,40.9,38382,3215,35167,50320,2.50993829442,0.0364235784608
"Chenango County, New York",2009,50956,42,24373,4381,19992,43991,2.54881952781,0.0859761362744
"Chenango County, New York",2012,50490,42.9,24671,4892,19779,44127,2.55270741696,0.0968904733611
"Chenango County, New York",2015,49549,43.8,24742,5101,19641,45668,2.5227330584,0.102948596339
"Cherokee County, Alabama",2009,24427,43.5,14690,4429,10261,40240,2.38056719618,0.181315757154
"Cherokee County, Alabama",2012,25917,44.3,16168,4410,11758,36241,2.2042013948,0.170158583169
"Cherokee County, Alabama",2015,26008,45.4,16242,4964,11278,36296,2.30608263877,0.190864349431
"Cherokee County, Georgia",2009,201233,34.9,77729,5903,71826,66248,2.80167348871,0.0293341549348
"Cherokee County, Georgia",2012,215014,36.4,82397,6460,75937,67928,2.83147872579,0.0300445552383
"Cherokee County, Georgia",2015,225944,37.4,84607,5474,79133,68926,2.85524370364,0.0242272421485
"Cherokee County, Iowa",2009,11681,46.3,5896,569,5327,44055,2.19279143983,0.0487115829124
"Cherokee County, Iowa",2012,12011,47.3,5787,388,5399,47816,2.22467123541,0.0323037215885
"Cherokee County, Iowa",2015,11853,46.6,5766,432,5334,48599,2.22215973003,0.0364464692483
"Cherokee County, Kansas",2009,21295,39.5,10373,1549,8824,36521,2.41330462375,0.0727400798309
"Cherokee County, Kansas",2012,21521,40.5,9913,1789,8124,41877,2.64906450025,0.08312810743
"Cherokee County, Kansas",2015,20952,41.4,9837,1849,7988,41388,2.6229344016,0.088249331806
"Cherokee County, North Carolina",2009,26203,46.6,16186,5171,11015,37708,2.37884702678,0.197343815594
"Cherokee County, North Carolina",2012,27304,48.3,17463,6225,11238,34981,2.42961381029,0.227988573103
"Cherokee County, North Carolina",2015,27092,50,17667,7075,10592,34662,2.55777945619,0.261147202126
"Cherokee County, Oklahoma",2009,45241,32.2,21150,4744,16406,30635,2.75758868707,0.104860635264
"Cherokee County, Oklahoma",2012,47165,34.5,21483,4682,16801,35182,2.80727337658,0.0992685253896
"Cherokee County, Oklahoma",2015,48097,34.8,21639,5315,16324,38694,2.94639794168,0.110505852756
"Cherokee County, South Carolina",2009,54175,37.1,23442,2897,20545,34808,2.63689462156,0.0534748500231
"Cherokee County, South Carolina",2012,55351,38.2,23943,2843,21100,33512,2.62327014218,0.0513631190042
"Cherokee County, South Carolina",2015,55863,38.8,23993,3470,20523,35389,2.72197047215,0.0621162486798
"Cherokee County, Texas",2009,48041,37,20140,3784,16356,36571,2.9372095867,0.0787660539955
"Cherokee County, Texas",2012,50690,37.7,20830,3557,17273,37508,2.93463787414,0.0701716314855
"Cherokee County, Texas",2015,51167,37.6,20956,3227,17729,39595,2.88606238367,0.0630679930424
"Cherry County, Nebraska",2009,5682,42.9,3318,705,2613,39089,2.17451205511,0.124076029567
"Cherry County, Nebraska",2012,5722,47.1,3159,625,2534,45172,2.25808997632,0.109227542817
"Cherry County, Nebraska",2015,5770,43.9,3150,511,2639,48750,2.1864342554,0.08856152513
"Chesapeake city, Virginia",2009,219425,35.9,81691,2766,78925,66932,2.78017104846,0.0126056739205
"Chesapeake city, Virginia",2012,223233,36.7,83541,4161,79380,70244,2.81220710506,0.0186397172461
"Chesapeake city, Virginia",2015,230601,36.5,86657,5139,81518,68620,2.82883534925,0.0222852459443
"Cheshire County, New Hampshire",2009,77174,40,33713,4197,29516,55719,2.61464968153,0.0543836006945
"Cheshire County, New Hampshire",2012,77106,41.1,34700,4527,30173,56062,2.55546349385,0.0587113843281
"Cheshire County, New Hampshire",2015,76430,42,34905,4267,30638,57782,2.49461453097,0.0558288630119
"Chester County, Pennsylvania",2009,486301,38.6,183168,7856,175312,83759,2.77391735877,0.0161546038359
"Chester County, Pennsylvania",2012,499548,39.4,192257,8464,183793,86184,2.7179925242,0.0169433167583
"Chester County, Pennsylvania",2015,509797,40.1,194892,8835,186057,85976,2.74000440725,0.0173304276016
"Chester County, South Carolina",2009,32666,39.3,14944,2053,12891,31964,2.53401598014,0.0628482213923
"Chester County, South Carolina",2012,33028,40.3,14706,2234,12472,32718,2.64817190507,0.0676395785394
"Chester County, South Carolina",2015,32556,41.2,14644,2259,12385,31914,2.6286637061,0.0693881312201
"Chester County, Tennessee",2009,16106,36.8,6770,689,6081,37569,2.64857753659,0.0427790885384
"Chester County, Tennessee",2012,17043,37.6,6979,945,6034,42097,2.82449453099,0.0554479845098
"Chester County, Tennessee",2015,17324,37.2,7008,934,6074,40167,2.85215673362,0.0539136458093
"Chesterfield County, South Carolina",2009,42876,38.6,19745,3554,16191,33968,2.64813785436,0.0828901949809
"Chesterfield County, South Carolina",2012,46462,39.2,21380,3927,17453,31279,2.66212112531,0.0845206835694
"Chesterfield County, South Carolina",2015,46192,41,21328,3306,18022,32083,2.56308955721,0.0715708347766
"Chesterfield County, Virginia",2009,298009,36.3,115924,6218,109706,71661,2.71643301187,0.0208651416568
"Chesterfield County, Virginia",2012,316895,37.5,122413,9323,113090,72363,2.8021487311,0.029419839379
"Chesterfield County, Virginia",2015,328176,38.2,125393,8596,116797,72609,2.80979819687,0.026193262152
"Cheyenne County, Colorado",2009,1622,45.3,958,307,651,46313,2.49155145929,0.189272503083
"Cheyenne County, Colorado",2012,2095,41,1092,234,858,50357,2.44172494172,0.11169451074
"Cheyenne County, Colorado",2015,2002,37,899,156,743,52554,2.69448183042,0.0779220779221
"Cheyenne County, Kansas",2009,2769,49.3,1649,281,1368,30250,2.02412280702,0.101480678945
"Cheyenne County, Kansas",2012,2724,49.7,1519,207,1312,39167,2.0762195122,0.0759911894273
"Cheyenne County, Kansas",2015,2682,49.6,1496,234,1262,44500,2.12519809826,0.0872483221477
"Cheyenne County, Nebraska",2009,9829,41.3,4813,490,4323,47115,2.2736525561,0.0498524773629
"Cheyenne County, Nebraska",2012,10038,40.3,4888,450,4438,50694,2.261829653,0.0448296473401
"Cheyenne County, Nebraska",2015,10077,39.9,4917,524,4393,53814,2.2938766219,0.0519996030565
"Chickasaw County, Iowa",2009,12160,43.6,5500,333,5167,41838,2.35339655506,0.0273848684211
"Chickasaw County, Iowa",2012,12409,43.9,5672,331,5341,43741,2.3233476877,0.0266741880893
"Chickasaw County, Iowa",2015,12244,44.1,5658,346,5312,47040,2.30496987952,0.0282587389742
"Chickasaw County, Mississippi",2009,18864,36.8,8384,966,7418,29581,2.54300350499,0.0512086513995
"Chickasaw County, Mississippi",2012,17458,38.4,7548,875,6673,31028,2.61621459613,0.0501202886929
"Chickasaw County, Mississippi",2015,17391,37.7,7520,1036,6484,30926,2.68214065392,0.0595710424932
"Chicot County, Arkansas",2009,12279,40.9,6188,1032,5156,20543,2.38149728472,0.0840459320792
"Chicot County, Arkansas",2012,11759,42.5,5445,738,4707,25188,2.49819417888,0.0627604388128
"Chicot County, Arkansas",2015,11353,43.4,5404,891,4513,28913,2.51562153778,0.0784814586453
"Childress County, Texas",2009,7530,33.2,3236,804,2432,34953,3.09621710526,0.106772908367
"Childress County, Texas",2012,7047,35.2,2973,542,2431,44455,2.89880707528,0.0769121612033
"Childress County, Texas",2015,7059,34.6,3076,685,2391,36633,2.95232120452,0.0970392406856
"Chilton County, Alabama",2009,42272,37.1,18712,2536,16176,38966,2.61325420376,0.0599924299773
"Chilton County, Alabama",2012,43611,37.6,19240,2947,16293,40834,2.67667096299,0.0675746944578
"Chilton County, Alabama",2015,43819,38.8,19247,3010,16237,41627,2.69871281641,0.0686916634337
"Chippewa County, Michigan",2009,38700,38.7,20735,6074,14661,40088,2.63965623082,0.156950904393
"Chippewa County, Michigan",2012,38919,39.1,21234,6572,14662,41114,2.6544127677,0.16886353709
"Chippewa County, Michigan",2015,38586,39,21231,7234,13997,41993,2.75673358577,0.187477323382
"Chippewa County, Minnesota",2009,12454,43.2,6001,621,5380,42441,2.31486988848,0.0498634976714
"Chippewa County, Minnesota",2012,12327,42.7,5730,542,5188,46579,2.37606013878,0.0439685243774
"Chippewa County, Minnesota",2015,12154,43,5715,679,5036,50858,2.41342335187,0.0558663814382
"Chippewa County, Wisconsin",2009,59872,39.1,25926,2345,23581,49096,2.53899325728,0.039166889364
"Chippewa County, Wisconsin",2012,62362,40.2,27147,2711,24436,50327,2.55205434605,0.0434719861454
"Chippewa County, Wisconsin",2015,63209,40.6,27530,2657,24873,52109,2.54126964982,0.0420351532219
"Chisago County, Minnesota",2009,49771,36.7,19127,1242,17885,65100,2.78283477775,0.0249542906512
"Chisago County, Minnesota",2012,53526,38.6,21077,1408,19669,66592,2.72133814632,0.026304973284
"Chisago County, Minnesota",2015,53834,40.2,21293,1485,19808,71001,2.7177907916,0.0275847977115
"Chittenden County, Vermont",2009,150924,35.6,62914,3435,59479,59634,2.53743337985,0.0227597996343
"Chittenden County, Vermont",2012,156696,36.4,65713,3446,62267,63900,2.51651757753,0.0219916270996
"Chittenden County, Vermont",2015,159711,36.3,67027,3529,63498,65350,2.51521307758,0.0220961611912
"Choctaw County, Alabama",2009,14229,42.7,8109,2329,5780,30749,2.46176470588,0.163679808841
"Choctaw County, Alabama",2012,13838,44,7301,1998,5303,35123,2.60946633981,0.144385026738
"Choctaw County, Alabama",2015,13395,44.9,7232,1657,5575,33536,2.40269058296,0.123702874207
"Choctaw County, Mississippi",2009,9106,39.9,4450,738,3712,30054,2.453125,0.0810454645289
"Choctaw County, Mississippi",2012,8506,42.4,4167,790,3377,30180,2.5188036719,0.0928756172114
"Choctaw County, Mississippi",2015,8354,42.8,4161,858,3303,30692,2.52921586437,0.102705290879
"Choctaw County, Oklahoma",2009,14987,39.7,7849,1532,6317,26403,2.37248694,0.102221925669
"Choctaw County, Oklahoma",2012,15172,40.6,7551,1468,6083,29015,2.49416406378,0.0967571842868
"Choctaw County, Oklahoma",2015,15120,41.8,7533,1609,5924,30617,2.55232950709,0.106415343915
"Chouteau County, Montana",2009,5223,45.3,2798,700,2098,38664,2.48951382269,0.13402259238
"Chouteau County, Montana",2012,5811,41.5,2875,679,2196,41232,2.64617486339,0.116847358458
"Chouteau County, Montana",2015,5855,41.1,2869,581,2288,38521,2.5590034965,0.0992314261315
"Chowan County, North Carolina",2009,14629,41.9,6971,1310,5661,37825,2.5841724077,0.0895481577688
"Chowan County, North Carolina",2012,14825,44.7,7268,1401,5867,36385,2.52684506562,0.094502529511
"Chowan County, North Carolina",2015,14656,44.5,7266,1299,5967,38759,2.45617563265,0.0886326419214
"Christian County, Illinois",2009,34543,41.3,15418,1413,14005,41195,2.46647625848,0.0409055380251
"Christian County, Illinois",2012,34805,41.6,15545,1349,14196,44211,2.45174697098,0.0387587990231
"Christian County, Illinois",2015,34200,42,15539,1526,14013,45334,2.4405908799,0.0446198830409
"Christian County, Kentucky",2009,79626,27.6,28953,3317,25636,36760,3.10602278046,0.0416572476327
"Christian County, Kentucky",2012,73722,28.9,29452,3352,26100,37750,2.82459770115,0.0454681099265
"Christian County, Kentucky",2015,74159,28.5,29633,4112,25521,39521,2.90580306414,0.0554484283769
"Christian County, Missouri",2009,72551,35.6,29132,1989,27143,50830,2.67291751096,0.0274151975851
"Christian County, Missouri",2012,77474,36.7,31605,2245,29360,53549,2.63876021798,0.0289774634071
"Christian County, Missouri",2015,80904,37.8,32340,2451,29889,53270,2.7068152163,0.0302951646396
"Churchill County, Nevada",2009,24704,36.7,10788,2022,8766,53134,2.81816107689,0.0818490932642
"Churchill County, Nevada",2012,24779,39.2,10819,1598,9221,54538,2.68723565774,0.064490092417
"Churchill County, Nevada",2015,24252,38.9,10738,1263,9475,47415,2.55957783641,0.0520781791192
"Ciales Municipio, Puerto Rico",2009,20615,33.6,6753,957,5796,13976,3.55676328502,0.0464225078826
"Ciales Municipio, Puerto Rico",2012,18712,35.8,7035,1476,5559,13722,3.36607303472,0.0788798631894
"Ciales Municipio, Puerto Rico",2015,17928,38.9,7421,1522,5899,12630,3.03915917952,0.0848951361
"Cibola County, New Mexico",2009,27120,35.5,10868,2828,8040,36146,3.37313432836,0.104277286136
"Cibola County, New Mexico",2012,27293,37.2,11087,3060,8027,35674,3.40014949545,0.112116659949
"Cibola County, New Mexico",2015,27382,36.2,11088,2555,8533,34565,3.20895347475,0.0933094733767
"Cidra Municipio, Puerto Rico",2009,47899,34.2,14604,1408,13196,19930,3.62981206426,0.0293951857033
"Cidra Municipio, Puerto Rico",2012,43414,36.2,15246,1956,13290,23804,3.26666666667,0.045054590685
"Cidra Municipio, Puerto Rico",2015,42298,37.6,16328,2423,13905,23315,3.04192736426,0.057284032342
"Cimarron County, Oklahoma",2009,2652,43.8,1607,440,1167,31655,2.27249357326,0.165912518854
"Cimarron County, Oklahoma",2012,2451,44.3,1583,510,1073,37261,2.28424976701,0.208078335373
"Cimarron County, Oklahoma",2015,2341,44.6,1580,563,1017,46680,2.30186823992,0.240495514737
"Citrus County, Florida",2009,138161,52.9,74780,15591,59189,37807,2.33423440166,0.112846606495
"Citrus County, Florida",2012,140805,54.2,77825,18334,59491,39034,2.36682859592,0.130208444302
"Citrus County, Florida",2015,139654,55.4,77819,16807,61012,38312,2.28895954894,0.120347430077
"Clackamas County, Oregon",2009,375858,39.4,151160,10790,140370,62030,2.67762342381,0.0287076502296
"Clackamas County, Oregon",2012,377206,40.6,156933,11929,145004,63951,2.60134892831,0.0316246295128
"Clackamas County, Oregon",2015,389438,41.3,159754,10232,149522,65965,2.60455317612,0.0262737585957
"Claiborne County, Mississippi",2009,10910,29.1,4485,851,3634,24104,3.00220143093,0.0780018331806
"Claiborne County, Mississippi",2012,9681,31.7,4231,974,3257,24078,2.97236720909,0.100609441173
"Claiborne County, Mississippi",2015,9330,32.7,4217,1025,3192,23259,2.92293233083,0.109860664523
"Claiborne County, Tennessee",2009,31081,40,14981,2260,12721,32212,2.44328276079,0.072713233165
"Claiborne County, Tennessee",2012,32025,41.5,14877,2170,12707,33568,2.52026442119,0.0677595628415
"Claiborne County, Tennessee",2015,31748,41.8,15001,2296,12705,34899,2.49885871704,0.07231951619
"Claiborne Parish, Louisiana",2009,16311,39.6,8187,1911,6276,29345,2.59894837476,0.117160198639
"Claiborne Parish, Louisiana",2012,17059,41.8,7777,2142,5635,32316,3.02732919255,0.125564218301
"Claiborne Parish, Louisiana",2015,16639,42.2,7760,1908,5852,32072,2.84330143541,0.114670352786
"Clallam County, Washington",2009,70208,48.1,33600,3340,30260,44342,2.32015862525,0.0475729261623
"Clallam County, Washington",2012,71411,49,35510,4633,30877,46431,2.31275706837,0.0648779599782
"Clallam County, Washington",2015,72397,50.1,35747,4426,31321,47253,2.31145238019,0.0611351299087
"Clare County, Michigan",2009,30670,44.5,23132,10115,13017,34957,2.35614965046,0.329801108575
"Clare County, Michigan",2012,30924,45.5,23218,9917,13301,33334,2.32493797459,0.320689432156
"Clare County, Michigan",2015,30710,46.4,23153,9898,13255,33015,2.31686156167,0.322305437968
"Clarendon County, South Carolina",2009,32863,41.1,16295,3654,12641,31761,2.5997152124,0.111188875027
"Clarendon County, South Carolina",2012,34746,41.9,17396,5181,12215,33267,2.84453540729,0.149110689
"Clarendon County, South Carolina",2015,34178,42.8,17402,4241,13161,33162,2.59691512803,0.124085669144
"Clarion County, Pennsylvania",2009,39857,39.8,20060,4415,15645,39083,2.54758708853,0.110771006348
"Clarion County, Pennsylvania",2012,39991,39.6,19971,4333,15638,43059,2.55729632945,0.10834937861
"Clarion County, Pennsylvania",2015,39454,40.3,19965,4135,15830,42536,2.49235628553,0.104805596391
"Clark County, Arkansas",2009,23601,31.8,10765,2074,8691,31409,2.71556782879,0.0878776323037
"Clark County, Arkansas",2012,23050,33.6,10402,2258,8144,32393,2.83030451866,0.0979609544469
"Clark County, Arkansas",2015,22751,34,10392,1711,8681,35031,2.62078101601,0.0752054854732
"Clark County, Idaho",2009,984,38.1,557,170,387,38405,2.54263565891,0.172764227642
"Clark County, Idaho",2012,780,37.3,550,254,296,35833,2.63513513514,0.325641025641
"Clark County, Idaho",2015,901,32.7,539,265,274,33672,3.28832116788,0.294117647059
"Clark County, Illinois",2009,16778,40.7,8082,1050,7032,43364,2.38594994312,0.0625819525569
"Clark County, Illinois",2012,16353,42.8,7779,1186,6593,47176,2.48035795541,0.0725249189751
"Clark County, Illinois",2015,16159,43.4,7744,1097,6647,50517,2.43102151346,0.067887864348
"Clark County, Indiana",2009,105280,37.5,47488,3743,43745,47011,2.40667504858,0.0355528115502
"Clark County, Indiana",2012,110100,38.1,47828,4980,42848,50559,2.56954817028,0.0452316076294
"Clark County, Indiana",2015,113181,38.7,48626,5652,42974,51699,2.63370875413,0.0499377103931
"Clark County, Kansas",2009,2133,45.2,1122,193,929,35701,2.29601722282,0.0904828879512
"Clark County, Kansas",2012,2198,43.5,1154,248,906,39563,2.42604856512,0.112829845314
"Clark County, Kansas",2015,2145,44.4,1162,235,927,42589,2.31391585761,0.109557109557
"Clark County, Kentucky",2009,35481,38.4,15786,1113,14673,45171,2.41811490493,0.0313689016657
"Clark County, Kentucky",2012,35555,40.3,15710,1163,14547,45486,2.44414655943,0.032709886092
"Clark County, Kentucky",2015,35657,41.7,15744,1571,14173,47959,2.51583997742,0.0440586701069
"Clark County, Missouri",2009,7178,42.1,3605,611,2994,39936,2.39746158985,0.0851212036779
"Clark County, Missouri",2012,7082,43.1,3472,691,2781,40466,2.54656598346,0.0975713075402
"Clark County, Missouri",2015,6919,43.7,3451,618,2833,43883,2.44228732792,0.0893192657899
"Clark County, Nevada",2009,1821507,34.4,777520,104613,672907,56080,2.70692235331,0.057432115276
"Clark County, Nevada",2012,1954773,35.5,838894,132857,706037,54218,2.76865518379,0.0679654363959
"Clark County, Nevada",2015,2035572,36.4,857131,132685,724446,51575,2.80983261692,0.0651831524505
"Clark County, Ohio",2009,140419,39.8,62200,6625,55575,43870,2.52665766982,0.0471802248983
"Clark County, Ohio",2012,138278,40.6,61454,6495,54959,43684,2.51602103386,0.0469705954671
"Clark County, Ohio",2015,136827,41,61241,6432,54809,43625,2.49643306756,0.0470082659124
"Clark County, South Dakota",2009,3526,46.2,1918,366,1552,42604,2.27190721649,0.103800340329
"Clark County, South Dakota",2012,3653,45.4,1726,358,1368,48438,2.67032163743,0.0980016424856
"Clark County, South Dakota",2015,3625,44,1785,297,1488,49600,2.43615591398,0.0819310344828
"Clark County, Washington",2009,416205,35.8,159638,8326,151312,58095,2.75064105953,0.0200045650581
"Clark County, Washington",2012,426984,36.8,167412,9047,158365,58764,2.69620181227,0.0211881475652
"Clark County, Washington",2015,444506,37.4,170937,8496,162441,60756,2.73641506762,0.0191133528006
"Clark County, Wisconsin",2009,33493,37.8,14512,1811,12701,42876,2.63703645382,0.0540709999104
"Clark County, Wisconsin",2012,34610,37.1,15058,1975,13083,43147,2.64541771765,0.057064432245
"Clark County, Wisconsin",2015,34518,37.1,15053,2256,12797,45048,2.69735094163,0.0653572049366
"Clarke County, Alabama",2009,26438,38.9,13086,3827,9259,27080,2.85538395075,0.144753763522
"Clarke County, Alabama",2012,25768,39.9,12632,3311,9321,30954,2.76451024568,0.128492704129
"Clarke County, Alabama",2015,25070,41.1,12600,2978,9622,32011,2.60548742465,0.118787395293
"Clarke County, Georgia",2009,113112,24.5,49881,7730,42151,33364,2.6834950535,0.0683393450739
"Clarke County, Georgia",2012,117762,25.9,51006,10087,40919,33846,2.87792956817,0.0856558142695
"Clarke County, Georgia",2015,120905,26.5,51529,8173,43356,32162,2.78865670265,0.0675985277697
"Clarke County, Iowa",2009,9068,40.1,4151,461,3690,45684,2.45745257453,0.0508381120423
"Clarke County, Iowa",2012,9286,41.5,4105,478,3627,44211,2.56024262476,0.0514753392203
"Clarke County, Iowa",2015,9280,39.6,4126,382,3744,43327,2.47863247863,0.0411637931034
"Clarke County, Mississippi",2009,17333,39.8,8549,1453,7096,31029,2.44264374295,0.0838285351641
"Clarke County, Mississippi",2012,16688,40.8,7903,1457,6446,31831,2.58889233633,0.0873082454458
"Clarke County, Mississippi",2015,16362,41.3,7885,1399,6486,35993,2.52266419981,0.0855029947439
"Clarke County, Virginia",2009,14359,42.3,6204,717,5487,68768,2.61691270275,0.0499338394039
"Clarke County, Virginia",2012,14143,44.7,6226,646,5580,80186,2.53458781362,0.0456763062999
"Clarke County, Virginia",2015,14299,45.7,6261,735,5526,71295,2.58758595729,0.0514021959578
"Clatsop County, Oregon",2009,36927,42.4,20950,4824,16126,40426,2.28990450205,0.130636119912
"Clatsop County, Oregon",2012,37068,43.5,21563,5806,15757,44330,2.35247826363,0.156631056437
"Clatsop County, Oregon",2015,37382,43.9,21779,6053,15726,46408,2.37708253847,0.16192285057
"Clay County, Alabama",2009,13769,41.6,6753,979,5774,37652,2.38465535158,0.0711017503087
"Clay County, Alabama",2012,13828,41.7,6762,1028,5734,34556,2.41158004883,0.0743419149552
"Clay County, Alabama",2015,13537,43.8,6738,1319,5419,35327,2.49806237313,0.0974366550934
"Clay County, Arkansas",2009,16045,43.5,8735,1572,7163,29282,2.23998324724,0.0979744468682
"Clay County, Arkansas",2012,15981,42.9,8057,1209,6848,32695,2.33367406542,0.0756523371504
"Clay County, Arkansas",2015,15400,43.8,8046,1435,6611,32552,2.32945091514,0.0931818181818
"Clay County, Florida",2009,179850,37.1,70593,5237,65356,60352,2.75185139849,0.0291187100361
"Clay County, Florida",2012,190891,38.2,75413,7843,67570,59649,2.82508509694,0.041086274366
"Clay County, Florida",2015,197417,39,76888,7835,69053,58290,2.85891996003,0.0396875649007
"Clay County, Georgia",2009,3156,44.6,2187,910,1277,26769,2.47141738449,0.288339670469
"Clay County, Georgia",2012,3174,42.7,2078,793,1285,22582,2.47003891051,0.249842470069
"Clay County, Georgia",2015,3104,40.3,1883,700,1183,20438,2.62383770076,0.225515463918
"Clay County, Illinois",2009,13729,41.5,6599,725,5874,37660,2.33724889343,0.0528079248307
"Clay County, Illinois",2012,13828,42.5,6403,812,5591,39966,2.47326059739,0.05872143477
"Clay County, Illinois",2015,13582,42.8,6380,855,5525,44209,2.45828054299,0.0629509645119
"Clay County, Indiana",2009,26682,38.6,11691,1267,10424,43943,2.55966999233,0.0474851960123
"Clay County, Indiana",2012,26908,40.7,11710,1582,10128,46817,2.65679304897,0.0587929240375
"Clay County, Indiana",2015,26686,40.4,11693,1348,10345,47602,2.57960367327,0.0505133778011
"Clay County, Iowa",2009,16676,42.5,8097,649,7448,43757,2.23899033298,0.0389182058047
"Clay County, Iowa",2012,16649,42.8,8049,789,7260,46880,2.29325068871,0.0473902336477
"Clay County, Iowa",2015,16537,42.2,8069,923,7146,50389,2.31416176882,0.0558142347463
"Clay County, Kansas",2009,8662,43.3,4206,519,3687,39044,2.34933550312,0.0599168783191
"Clay County, Kansas",2012,8547,44.1,4051,563,3488,43879,2.45040137615,0.0658710658711
"Clay County, Kansas",2015,8421,42.2,4052,675,3377,52066,2.49363340243,0.0801567509797
"Clay County, Kentucky",2009,23792,37.2,9972,2775,7197,22986,3.30582187022,0.116635843981
"Clay County, Kentucky",2012,21833,37.4,8928,1957,6971,22296,3.13197532635,0.0896349562589
"Clay County, Kentucky",2015,21300,39.1,8866,1159,7707,21549,2.76372129233,0.0544131455399
"Clay County, Minnesota",2009,54902,32.5,22976,1681,21295,47806,2.57816388824,0.0306181924156
"Clay County, Minnesota",2012,58937,32.1,23930,1573,22357,52136,2.63617658899,0.0266895159238
"Clay County, Minnesota",2015,60879,32.4,24688,2014,22674,57965,2.68496956867,0.0330820151448
"Clay County, Mississippi",2009,20881,36.8,9136,1138,7998,30765,2.61077769442,0.0544993055888
"Clay County, Mississippi",2012,20633,38.8,9187,1314,7873,31228,2.62072907405,0.0636843890854
"Clay County, Mississippi",2015,20279,38.8,9188,1393,7795,31669,2.60153944836,0.0686917500863
"Clay County, Missouri",2009,217596,35.7,92476,6045,86431,57797,2.51756892782,0.0277808415596
"Clay County, Missouri",2012,222048,36.4,93397,6696,86701,60560,2.5610777269,0.0301556420233
"Clay County, Missouri",2015,230361,36.6,94546,6870,87676,62099,2.62741229071,0.0298227564562
"Clay County, Nebraska",2009,6334,44.4,3114,409,2705,39642,2.3415896488,0.0645721503
"Clay County, Nebraska",2012,6497,43.8,3005,358,2647,45711,2.45447676615,0.055102354933
"Clay County, Nebraska",2015,6382,43.2,2984,367,2617,51470,2.43867023309,0.0575054841742
"Clay County, North Carolina",2009,10084,49,6662,2072,4590,35089,2.19694989107,0.205474018247
"Clay County, North Carolina",2012,10575,49.6,7130,2730,4400,38536,2.40340909091,0.258156028369
"Clay County, North Carolina",2015,10656,50.5,7195,2655,4540,37076,2.34713656388,0.249155405405
"Clay County, South Dakota",2009,13431,24,5750,455,5295,31952,2.53654390935,0.0338768520587
"Clay County, South Dakota",2012,13966,25.5,5649,507,5142,38377,2.71606378841,0.0363024488042
"Clay County, South Dakota",2015,14011,25.2,5749,414,5335,36608,2.62624179944,0.029548212119
"Clay County, Tennessee",2009,7937,44.9,4417,834,3583,32134,2.2151828077,0.105077485196
"Clay County, Tennessee",2012,7842,45.1,4270,981,3289,30184,2.38431134083,0.125095638868
"Clay County, Tennessee",2015,7780,46.9,4265,1023,3242,28804,2.39975323874,0.131491002571
"Clay County, Texas",2009,11102,43.4,5196,613,4583,51145,2.42243072223,0.0552152765268
"Clay County, Texas",2012,10718,44.8,5151,879,4272,54298,2.50889513109,0.0820115693226
"Clay County, Texas",2015,10479,45.7,5136,990,4146,48297,2.52749638205,0.0944746636129
"Clay County, West Virginia",2009,10061,40.6,5022,1188,3834,31148,2.62415232134,0.118079713746
"Clay County, West Virginia",2012,9432,41.9,4599,1158,3441,33165,2.74106364429,0.122773536896
"Clay County, West Virginia",2015,9141,43.3,4583,1123,3460,31325,2.64190751445,0.122853079532
"Clayton County, Georgia",2009,271652,31,105229,17158,88071,44308,3.08446594225,0.063161692165
"Clayton County, Georgia",2012,262066,31.7,104796,18824,85972,42569,3.04827153027,0.0718292338571
"Clayton County, Georgia",2015,267234,32.4,104656,15863,88793,40938,3.00962913743,0.0593599616815
"Clayton County, Iowa",2009,17667,44.5,8929,1314,7615,45603,2.32002626395,0.0743759551707
"Clayton County, Iowa",2012,18056,44.7,8989,1318,7671,46617,2.35380002607,0.0729951262738
"Clayton County, Iowa",2015,17806,45.4,9025,1417,7608,48007,2.34043112513,0.0795799168819
"Clear Creek County, Colorado",2009,8886,43.9,5459,1428,4031,62823,2.20441577772,0.160702228224
"Clear Creek County, Colorado",2012,9059,45.8,5679,1666,4013,60517,2.25741340643,0.183905508334
"Clear Creek County, Colorado",2015,9136,48,5684,1453,4231,67710,2.1593004018,0.159041155867
"Clearfield County, Pennsylvania",2009,82482,41.9,38899,5772,33127,36470,2.4898723096,0.0699789044883
"Clearfield County, Pennsylvania",2012,81668,42.8,38660,6225,32435,40768,2.51789733313,0.0762232453348
"Clearfield County, Pennsylvania",2015,81343,43.9,38614,6797,31817,42257,2.55658924474,0.0835597408505
"Clearwater County, Idaho",2009,8192,47.7,4317,615,3702,41875,2.21285791464,0.0750732421875
"Clearwater County, Idaho",2012,8679,49.5,4449,828,3621,41914,2.39685169843,0.0954026961632
"Clearwater County, Idaho",2015,8560,50.2,4466,818,3648,38837,2.34649122807,0.0955607476636
"Clearwater County, Minnesota",2009,8231,42.8,4277,966,3311,37744,2.48595590456,0.117361195481
"Clearwater County, Minnesota",2012,8672,42.3,4748,1109,3639,41896,2.3830722726,0.127882841328
"Clearwater County, Minnesota",2015,8752,42.5,4756,1270,3486,43421,2.51061388411,0.145109689214
"Cleburne County, Alabama",2009,14579,40,6462,1183,5279,33742,2.76169729115,0.0811441113931
"Cleburne County, Alabama",2012,14905,41.2,6706,1188,5518,37244,2.70115984052,0.079704797048
"Cleburne County, Alabama",2015,15002,41.3,6692,916,5776,38056,2.59729916898,0.0610585255299
"Cleburne County, Arkansas",2009,25292,45.8,14708,4563,10145,36405,2.49305076392,0.180412778744
"Cleburne County, Arkansas",2012,25849,46.4,15765,5334,10431,39410,2.47809414246,0.206352276684
"Cleburne County, Arkansas",2015,25711,47.1,15841,5684,10157,42905,2.53135768436,0.221072692622
"Clermont County, Ohio",2009,193377,37.3,77598,5965,71633,57217,2.69955188251,0.0308464812258
"Clermont County, Ohio",2012,197543,38.6,80661,6802,73859,60590,2.67459619004,0.034433009522
"Clermont County, Ohio",2015,200285,39.5,81668,6856,74812,60805,2.67717745816,0.0342312205108
"Cleveland County, Arkansas",2009,8640,40.5,4031,661,3370,35063,2.56379821958,0.0765046296296
"Cleveland County, Arkansas",2012,8685,40.2,4054,744,3310,38060,2.62386706949,0.0856649395509
"Cleveland County, Arkansas",2015,8510,42.4,4054,720,3334,43158,2.5524895021,0.0846063454759
"Cleveland County, North Carolina",2009,98331,39.3,43039,5188,37851,37889,2.59784417849,0.0527605739797
"Cleveland County, North Carolina",2012,97890,40.5,43321,5623,37698,38181,2.59668947955,0.0574420267647
"Cleveland County, North Carolina",2015,97178,41.4,43291,5838,37453,39453,2.59466531386,0.060075325691
"Cleveland County, Oklahoma",2009,235855,32.2,98321,8098,90223,51068,2.6141338683,0.0343346547667
"Cleveland County, Oklahoma",2012,256550,32.7,104945,9521,95424,54883,2.68852699531,0.0371116741376
"Cleveland County, Oklahoma",2015,268614,33.2,108874,9598,99276,56452,2.70572948145,0.0357315702086
"Clinch County, Georgia",2009,7004,35.1,2928,352,2576,32410,2.71894409938,0.0502569960023
"Clinch County, Georgia",2012,6800,37.1,2995,403,2592,33967,2.62345679012,0.0592647058824
"Clinch County, Georgia",2015,6791,36.1,2974,393,2581,24015,2.63115071678,0.0578707112355
"Clinton County, Illinois",2009,36235,39.2,15038,1167,13871,54313,2.61228462259,0.032206430247
"Clinton County, Illinois",2012,37793,39.4,15297,1239,14058,60661,2.68836249822,0.0327838488609
"Clinton County, Illinois",2015,37929,40.1,15504,1638,13866,63236,2.7353959325,0.0431859527011
"Clinton County, Indiana",2009,34081,36.4,13683,1584,12099,47453,2.8168443673,0.0464775094628
"Clinton County, Indiana",2012,33179,37.8,13333,1644,11689,48321,2.83848062281,0.0495494137858
"Clinton County, Indiana",2015,32835,38.4,13253,1610,11643,48478,2.82014944602,0.0490330440079
"Clinton County, Iowa",2009,49129,40.4,22282,1605,20677,44787,2.37602166659,0.0326690956462
"Clinton County, Iowa",2012,49074,41.6,21753,1830,19923,49010,2.46318325553,0.0372906223255
"Clinton County, Iowa",2015,48365,42.1,21760,1693,20067,50498,2.4101759107,0.0350046521245
"Clinton County, Kentucky",2009,9443,41.1,5104,1030,4074,23187,2.31786941581,0.109075505666
"Clinton County, Kentucky",2012,10244,41.5,5301,1393,3908,26885,2.62128966223,0.135982038266
"Clinton County, Kentucky",2015,10188,40.7,5264,1406,3858,28025,2.64074650078,0.138005496663
"Clinton County, Michigan",2009,69534,39.2,29588,1910,27678,59529,2.5122479948,0.0274685765237
"Clinton County, Michigan",2012,75274,38.5,30670,2028,28642,58231,2.62809859647,0.0269415734517
"Clinton County, Michigan",2015,76905,39.7,30897,2040,28857,60909,2.66503794573,0.0265262336649
"Clinton County, Missouri",2009,20810,40.2,8886,721,8165,50761,2.54868340478,0.034646804421
"Clinton County, Missouri",2012,20687,40.6,8876,845,8031,53234,2.57589341302,0.0408469086866
"Clinton County, Missouri",2015,20498,41,8884,808,8076,54773,2.53813769193,0.0394184798517
"Clinton County, New York",2009,81755,37.8,34633,4244,30389,47786,2.69028266807,0.0519111980919
"Clinton County, New York",2012,82054,39.1,35809,3989,31820,50522,2.57869264613,0.0486143271504
"Clinton County, New York",2015,81685,39.4,35918,4020,31898,49930,2.56081886012,0.0492134418804
"Clinton County, Ohio",2009,42820,37.4,18023,1612,16411,47842,2.60922551947,0.0376459598319
"Clinton County, Ohio",2012,42161,38.4,18130,2112,16018,46443,2.63210138594,0.0500936884799
"Clinton County, Ohio",2015,41892,39.3,18063,1990,16073,46787,2.60635848939,0.0475031032178
"Clinton County, Pennsylvania",2009,37063,38.9,18905,3794,15111,39198,2.45271656409,0.102366241265
"Clinton County, Pennsylvania",2012,39261,38.7,19064,3778,15286,40682,2.5684286275,0.096227808767
"Clinton County, Pennsylvania",2015,39614,38.1,19035,4239,14796,45078,2.67734522844,0.107007623567
"Cloud County, Kansas",2009,9367,43.7,4841,721,4120,33517,2.27354368932,0.0769723497384
"Cloud County, Kansas",2012,9479,43.3,4670,685,3985,37382,2.37867001255,0.0722650068573
"Cloud County, Kansas",2015,9339,42.3,4637,673,3964,39282,2.35595358224,0.0720633900846
"Coahoma County, Mississippi",2009,27571,31.1,11704,1667,10037,25489,2.74693633556,0.0604620797214
"Coahoma County, Mississippi",2012,26099,32.8,10828,1552,9276,25574,2.81360500216,0.0594658799188
"Coahoma County, Mississippi",2015,25254,33.5,10747,1387,9360,28851,2.69807692308,0.0549219925556
"Coal County, Oklahoma",2009,5697,39.8,2832,488,2344,28911,2.43046075085,0.0856591188345
"Coal County, Oklahoma",2012,5906,40.5,2812,458,2354,33512,2.50892098556,0.0775482560108
"Coal County, Oklahoma",2015,5812,42.3,2798,510,2288,38243,2.54020979021,0.0877494838266
"Coamo Municipio, Puerto Rico",2009,39544,33.6,13813,1469,12344,14145,3.20349967596,0.0371484928181
"Coamo Municipio, Puerto Rico",2012,40577,35.1,14995,1943,13052,16658,3.10887220349,0.0478842694137
"Coamo Municipio, Puerto Rico",2015,40293,37.7,16427,2779,13648,18233,2.9523007034,0.0689697962425
"Cobb County, Georgia",2009,690430,34.5,276103,25708,250395,66515,2.75736336588,0.0372347667396
"Cobb County, Georgia",2012,691820,35.4,286528,26813,259715,65180,2.66376605125,0.0387571911769
"Cobb County, Georgia",2015,719133,36,290963,22347,268616,65873,2.67717857462,0.0310749193821
"Cochise County, Arizona",2009,127613,40.4,57068,8656,48412,43304,2.63597868297,0.0678300800075
"Cochise County, Arizona",2012,131118,39.9,59160,9940,49220,45505,2.66391710687,0.075809576107
"Cochise County, Arizona",2015,129647,40,60087,11262,48825,45075,2.65534050179,0.0868666455838
"Cochran County, Texas",2009,3080,37.1,1602,329,1273,34744,2.41948153967,0.106818181818
"Cochran County, Texas",2012,3087,34.2,1363,294,1069,40406,2.88774555659,0.0952380952381
"Cochran County, Texas",2015,2993,34.9,1363,333,1030,39113,2.90582524272,0.111259605747
"Cocke County, Tennessee",2009,35406,40.5,16680,2433,14247,30027,2.48515476943,0.0687171665819
"Cocke County, Tennessee",2012,35631,42.8,17420,2629,14791,29764,2.40896491109,0.0737840644383
"Cocke County, Tennessee",2015,35321,44.3,17387,2677,14710,31187,2.40115567641,0.075790606155
"Coconino County, Arizona",2009,127312,30.2,59957,15642,44315,48259,2.87288728422,0.122863516401
"Coconino County, Arizona",2012,134011,30.9,63270,17552,45718,48320,2.93125246074,0.130974323003
"Coconino County, Arizona",2015,136701,30.8,63955,17336,46619,50234,2.93230228019,0.126816921603
"Codington County, South Dakota",2009,26129,37.7,12193,835,11358,41716,2.30049304455,0.0319568295763
"Codington County, South Dakota",2012,27284,38.2,12414,821,11593,46383,2.3534891745,0.0300908957631
"Codington County, South Dakota",2015,27750,38,12621,687,11934,48912,2.32528908999,0.0247567567568
"Coffee County, Alabama",2009,46802,36.9,21817,2967,18850,41973,2.48286472149,0.0633947267211
"Coffee County, Alabama",2012,49966,37.8,22384,3382,19002,44626,2.62951268288,0.067686026498
"Coffee County, Alabama",2015,50884,38.8,22776,3616,19160,46729,2.65574112735,0.0710635956293
"Coffee County, Georgia",2009,40198,34.1,16828,2342,14486,33119,2.77495512909,0.058261605055
"Coffee County, Georgia",2012,42566,34.8,17060,2296,14764,35583,2.88309401246,0.053939764131
"Coffee County, Georgia",2015,43003,35.2,16974,2653,14321,33965,3.00279310104,0.06169337023
"Coffee County, Tennessee",2009,51694,39.4,22843,2147,20696,39456,2.49777734828,0.0415328664835
"Coffee County, Tennessee",2012,52853,38.8,23386,2330,21056,38151,2.51011588146,0.0440845363556
"Coffee County, Tennessee",2015,53448,39.7,23529,2359,21170,41590,2.5247047709,0.0441363568328
"Coffey County, Kansas",2009,8472,43.4,3938,582,3356,47420,2.52443384982,0.0686968838527
"Coffey County, Kansas",2012,8553,44,3978,484,3494,50106,2.44791070406,0.0565883315796
"Coffey County, Kansas",2015,8458,44.1,3999,430,3569,57433,2.36985149902,0.0508394419485
"Coke County, Texas",2009,3491,48.1,2994,1538,1456,33375,2.39766483516,0.440561443712
"Coke County, Texas",2012,3298,48.6,2684,1273,1411,40844,2.33734939759,0.385991510006
"Coke County, Texas",2015,3238,49.3,2667,1066,1601,42467,2.02248594628,0.329215565164
"Colbert County, Alabama",2009,54546,40.9,26322,3441,22881,39366,2.3838993051,0.0630843691563
"Colbert County, Alabama",2012,54451,41.7,25796,3506,22290,40158,2.44284432481,0.0643881655066
"Colbert County, Alabama",2015,54444,42.2,26068,3864,22204,40576,2.45199063232,0.0709720079348
"Cole County, Missouri",2009,73737,36.8,31963,2929,29034,52385,2.53967761934,0.0397222561265
"Cole County, Missouri",2012,75813,37.8,32322,2766,29556,55465,2.56506293138,0.036484507934
"Cole County, Missouri",2015,76533,38,32657,3209,29448,53088,2.5989201304,0.041929625129
"Coleman County, Texas",2009,8538,44.6,5363,1829,3534,27538,2.41595925297,0.214218786601
"Coleman County, Texas",2012,8817,45.8,5527,2016,3511,30690,2.51125035602,0.228649200408
"Coleman County, Texas",2015,8536,47.1,5526,2121,3405,35156,2.50690161527,0.248477038425
"Coles County, Illinois",2009,52144,29.9,23435,2359,21076,35102,2.47409375593,0.0452401043265
"Coles County, Illinois",2012,53683,32.3,23463,2307,21156,38088,2.53748345623,0.0429744984446
"Coles County, Illinois",2015,53037,33.3,23464,2401,21063,39588,2.51801737644,0.04527028301
"Colfax County, Nebraska",2009,10100,35.1,4130,561,3569,45919,2.82992434856,0.0555445544554
"Colfax County, Nebraska",2012,10453,34.4,4098,463,3635,48561,2.87565337001,0.0442935042572
"Colfax County, Nebraska",2015,10522,34.2,4107,473,3634,51367,2.89543203082,0.0449534309067
"Colfax County, New Mexico",2009,13133,45.5,9426,3650,5776,39249,2.27371883657,0.277925835681
"Colfax County, New Mexico",2012,13614,46.3,9991,4274,5717,38263,2.38131887354,0.313941530777
"Colfax County, New Mexico",2015,12997,47.6,10067,4521,5546,32380,2.34349080418,0.347849503732
"Colleton County, South Carolina",2009,39128,38.5,19212,4483,14729,34135,2.65652793808,0.114572684523
"Colleton County, South Carolina",2012,38665,41,19832,4713,15119,31289,2.55737813347,0.121893185051
"Colleton County, South Carolina",2015,38004,41.7,19749,4975,14774,32804,2.5723568431,0.130907272919
"Collier County, Florida",2009,313165,45.2,189734,71445,118289,58133,2.64745665277,0.228138521227
"Collier County, Florida",2012,323548,47.1,197535,76597,120938,56104,2.67532123898,0.236740761804
"Collier County, Florida",2015,341091,48.5,201582,71694,129888,57452,2.62603935698,0.210190242487
"Collin County, Texas",2009,729514,34.5,273312,17512,255800,80545,2.85189210321,0.0240050225218
"Collin County, Texas",2012,788580,35.1,301250,18225,283025,83238,2.78625563113,0.0231111618352
"Collin County, Texas",2015,862215,35.9,320429,14602,305827,84735,2.81928999075,0.0169354511346
"Collingsworth County, Texas",2009,2993,36.4,1671,429,1242,39524,2.40982286634,0.143334447043
"Collingsworth County, Texas",2012,3050,36.7,1556,359,1197,41940,2.54803675856,0.117704918033
"Collingsworth County, Texas",2015,3058,37,1476,367,1109,39743,2.75743913436,0.120013080445
"Colonial Heights city, Virginia",2009,17707,40.7,7669,450,7219,49734,2.45283280233,0.0254136782064
"Colonial Heights city, Virginia",2012,17426,41.6,7815,811,7004,51612,2.48800685323,0.0465396533915
"Colonial Heights city, Virginia",2015,17515,40,7808,702,7106,50304,2.46481846327,0.0400799314873
"Colorado County, Texas",2009,20554,40.9,9743,2016,7727,39031,2.66002329494,0.0980830981804
"Colorado County, Texas",2012,20784,43.1,10487,2439,8048,43273,2.58250497018,0.117349884527
"Colorado County, Texas",2015,20757,43.6,10544,2887,7657,46618,2.71085281442,0.139085609674
"Colquitt County, Georgia",2009,44633,34.1,18414,2508,15906,31707,2.80604803219,0.0561916071068
"Colquitt County, Georgia",2012,45531,34.9,18300,2534,15766,33186,2.88792337942,0.0556543893172
"Colquitt County, Georgia",2015,46024,35.5,18316,2579,15737,32409,2.92457266315,0.0560359812272
"Columbia County, Arkansas",2009,24292,37.2,11983,1717,10266,35258,2.36625754919,0.0706817059114
"Columbia County, Arkansas",2012,24644,36.1,11617,2119,9498,34895,2.59465150558,0.0859844181139
"Columbia County, Arkansas",2015,24327,36,11572,1975,9597,36619,2.53485464208,0.0811855140379
"Columbia County, Florida",2009,67397,38,25986,3590,22396,39078,3.00933202358,0.0532664658664
"Columbia County, Florida",2012,67546,40,28451,4662,23789,37534,2.83937954517,0.0690196310662
"Columbia County, Florida",2015,67806,40.4,28392,4684,23708,41926,2.86004724144,0.0690794324986
"Columbia County, Georgia",2009,108015,36.6,42673,3973,38700,67115,2.79108527132,0.0367819284359
"Columbia County, Georgia",2012,124665,36.9,48843,5058,43785,67295,2.84720794793,0.0405727349296
"Columbia County, Georgia",2015,136204,36.6,52267,6779,45488,71021,2.99428420682,0.0497709318375
"Columbia County, New York",2009,62217,44,31875,6516,25359,54573,2.45344847983,0.104730218429
"Columbia County, New York",2012,62881,45.3,32710,7234,25476,56445,2.46824462239,0.115042699703
"Columbia County, New York",2015,62195,46.6,32802,7567,25235,59105,2.46463245492,0.121665728756
"Columbia County, Oregon",2009,48612,40.6,19662,1226,18436,56903,2.63679756997,0.0252201102608
"Columbia County, Oregon",2012,49317,41.5,20639,1579,19060,55358,2.58746065058,0.032017357098
"Columbia County, Oregon",2015,49389,42.9,20692,1907,18785,53179,2.62917221187,0.0386118366438
"Columbia County, Pennsylvania",2009,64837,39.3,28953,3427,25526,41613,2.54003760871,0.0528556225612
"Columbia County, Pennsylvania",2012,66984,39.7,29477,3465,26012,44680,2.57511917577,0.0517287710498
"Columbia County, Pennsylvania",2015,66912,40.1,29597,3419,26178,45374,2.55603942242,0.0510969631755
"Columbia County, Washington",2009,3984,47.7,2120,332,1788,40774,2.22818791946,0.0833333333333
"Columbia County, Washington",2012,4001,48.9,2133,420,1713,45417,2.33566841798,0.104973756561
"Columbia County, Washington",2015,3989,49.5,2126,440,1686,38581,2.36595492289,0.110303334169
"Columbia County, Wisconsin",2009,54949,40.9,25268,2734,22534,55155,2.438492944,0.0497552275747
"Columbia County, Wisconsin",2012,56596,41.3,26108,3118,22990,57869,2.46176598521,0.0550922326666
"Columbia County, Wisconsin",2015,56607,42,26185,3570,22615,59769,2.50307318152,0.0630664052149
"Columbiana County, Ohio",2009,108683,41.3,46875,5117,41758,40551,2.60268691029,0.0470818803309
"Columbiana County, Ohio",2012,107598,42.3,47025,4549,42476,41870,2.53314813071,0.0422777375044
"Columbiana County, Ohio",2015,105987,43.2,46777,4690,42087,44497,2.51828355549,0.0442507099927
"Columbus County, North Carolina",2009,54050,39.1,24952,3952,21000,32283,2.57380952381,0.0731174838113
"Columbus County, North Carolina",2012,57612,40.4,25966,4424,21542,35182,2.67440349086,0.076789557731
"Columbus County, North Carolina",2015,57230,41.5,25912,3906,22006,34949,2.60065436699,0.068250917351
"Colusa County, California",2009,21001,33,7443,753,6690,47150,3.13916292975,0.0358554354555
"Colusa County, California",2012,21329,33.9,7866,982,6884,52165,3.09834398605,0.0460406019973
"Colusa County, California",2015,21396,34,7931,965,6966,52168,3.07149009475,0.0451018882034
"Comal County, Texas",2009,104960,40.8,44212,6125,38087,63544,2.75579594087,0.0583555640244
"Comal County, Texas",2012,108985,42.7,47288,6176,41112,63480,2.6509291691,0.0566683488553
"Comal County, Texas",2015,119632,42.4,50288,6337,43951,65833,2.72194034265,0.0529707770496
"Comanche County, Kansas",2009,1850,48.8,1192,291,901,40781,2.05327413984,0.157297297297
"Comanche County, Kansas",2012,1893,44,990,179,811,39950,2.33415536375,0.094558901215
"Comanche County, Kansas",2015,2010,45.7,993,209,784,45288,2.5637755102,0.103980099502
"Comanche County, Oklahoma",2009,112828,31.2,47288,5611,41677,43024,2.70720061425,0.0497305633353
"Comanche County, Oklahoma",2012,123101,31.5,50657,6340,44317,46320,2.77773766275,0.0515024248381
"Comanche County, Oklahoma",2015,125531,31.8,51481,8241,43240,46241,2.90312210916,0.0656491225275
"Comanche County, Texas",2009,13517,43.2,7349,1916,5433,34068,2.48794404565,0.141747429163
"Comanche County, Texas",2012,13875,43.4,7221,1925,5296,36599,2.61990181269,0.138738738739
"Comanche County, Texas",2015,13623,43.6,7242,2123,5119,37470,2.66126196523,0.155839389268
"Comerío Municipio, Puerto Rico",2009,19378,33.9,7180,887,6293,12054,3.07929445416,0.0457735576427
"Comerío Municipio, Puerto Rico",2012,20745,35,7524,1333,6191,12481,3.35083185269,0.0642564473367
"Comerío Municipio, Puerto Rico",2015,20339,36.4,7777,1285,6492,13124,3.13293284042,0.0631791140174
"Concho County, Texas",2009,3610,41.1,1547,567,980,45625,3.68367346939,0.157063711911
"Concho County, Texas",2012,4073,40.9,1627,709,918,50278,4.43681917211,0.174073164743
"Concho County, Texas",2015,4086,40.8,1626,813,813,48368,5.0258302583,0.198972099853
"Concordia Parish, Louisiana",2009,18979,39.3,9668,1895,7773,26968,2.44165701788,0.0998471995363
"Concordia Parish, Louisiana",2012,20624,37.5,9394,1629,7765,28971,2.65602060528,0.078985647789
"Concordia Parish, Louisiana",2015,20449,38.3,9418,1522,7896,29654,2.5897922999,0.0744290674361
"Conecuh County, Alabama",2009,13114,42.5,7492,2091,5401,27216,2.42806887613,0.159447918255
"Conecuh County, Alabama",2012,13188,43.3,7103,2224,4879,27064,2.70301291248,0.168638155899
"Conecuh County, Alabama",2015,12865,43.7,7070,1902,5168,24900,2.48935758514,0.147842984843
"Conejos County, Colorado",2009,8021,39.6,4297,1203,3094,33141,2.59243697479,0.14998129909
"Conejos County, Colorado",2012,8241,38.2,4287,1150,3137,32860,2.62703219637,0.139546171581
"Conejos County, Colorado",2015,8249,38.4,4301,1353,2948,36652,2.79816824966,0.164019881198
"Contra Costa County, California",2009,1015571,38,391260,26924,364336,77838,2.78745718238,0.0265111941952
"Contra Costa County, California",2012,1052047,38.5,400098,26953,373145,78187,2.81940532501,0.0256195778325
"Contra Costa County, California",2015,1096068,38.8,405001,20355,384646,80185,2.84954997582,0.0185709280811
"Converse County, Wyoming",2009,12959,38.8,5974,690,5284,55240,2.45249810749,0.0532448491396
"Converse County, Wyoming",2012,13779,40,6366,758,5608,62554,2.4570256776,0.0550112490021
"Converse County, Wyoming",2015,14101,40.3,6478,801,5677,62307,2.48388233222,0.0568044819516
"Conway County, Arkansas",2009,20619,39.4,9401,1216,8185,33554,2.51912034209,0.0589747320433
"Conway County, Arkansas",2012,21203,40.4,9703,1472,8231,32625,2.57599319645,0.0694241380937
"Conway County, Arkansas",2015,21110,40.7,9725,1363,8362,37732,2.52451566611,0.0645665561345
"Cook County, Georgia",2009,16419,36.2,7075,777,6298,31521,2.60701810098,0.0473232230952
"Cook County, Georgia",2012,17073,36.5,7273,843,6430,35983,2.65520995334,0.0493762080478
"Cook County, Georgia",2015,17033,36.7,7247,1090,6157,35683,2.76644469709,0.0639934245289
"Cook County, Illinois",2009,5257001,34.7,2170750,229333,1941417,53903,2.70781650722,0.0436243021449
"Cook County, Illinois",2012,5197677,35.3,2178739,245069,1933670,54648,2.68798554045,0.0471497170755
"Cook County, Illinois",2015,5236393,35.9,2176549,233590,1942959,55251,2.69506098688,0.044608951238
"Cook County, Minnesota",2009,5411,48.6,5429,2722,2707,47933,1.9988917621,0.503049343929
"Cook County, Minnesota",2012,5206,49.8,5512,2882,2630,50309,1.97946768061,0.55359200922
"Cook County, Minnesota",2015,5194,51.3,5671,3019,2652,52299,1.95852187029,0.581247593377
"Cooke County, Texas",2009,38424,37.8,15876,1820,14056,50030,2.73363688105,0.0473662294399
"Cooke County, Texas",2012,38427,38.8,16575,2086,14489,49735,2.65214990683,0.0542847477034
"Cooke County, Texas",2015,38761,39.6,16661,2063,14598,52406,2.65522674339,0.0532236010423
"Cooper County, Missouri",2009,17371,36,7128,886,6242,41576,2.78292214034,0.0510045478096
"Cooper County, Missouri",2012,17542,37.6,7466,958,6508,45200,2.69545175169,0.0546117888496
"Cooper County, Missouri",2015,17593,38.6,7459,971,6488,44549,2.71162145499,0.0551924060706
"Coos County, New Hampshire",2009,32217,45.1,20116,5794,14322,42786,2.24947633012,0.179842940063
"Coos County, New Hampshire",2012,32872,46.6,21240,6536,14704,41774,2.23558215452,0.198831832563
"Coos County, New Hampshire",2015,31870,48.1,21284,7086,14198,42312,2.24468234963,0.222340759335
"Coos County, Oregon",2009,63230,46.4,30056,2705,27351,36754,2.31179847172,0.0427803257947
"Coos County, Oregon",2012,62937,47.2,30569,4002,26567,37853,2.36899160613,0.0635873969207
"Coos County, Oregon",2015,62775,48.1,30482,4594,25888,38605,2.42486866502,0.0731819992035
"Coosa County, Alabama",2009,10777,43.4,6364,1836,4528,33595,2.3800795053,0.170362809687
"Coosa County, Alabama",2012,11305,44.4,6466,1893,4573,37425,2.47211895911,0.167448031844
"Coosa County, Alabama",2015,11027,45.1,6462,2012,4450,31212,2.47797752809,0.182461231523
"Copiah County, Mississippi",2009,29150,35.1,11550,1538,10012,35342,2.91150619257,0.0527615780446
"Copiah County, Mississippi",2012,29324,36.4,12138,2124,10014,36645,2.92830037947,0.0724321374983
"Copiah County, Mississippi",2015,28921,38.1,12130,2290,9840,35130,2.93912601626,0.0791812178002
"Corozal Municipio, Puerto Rico",2009,38808,32.9,12207,1307,10900,12590,3.56036697248,0.0336786229643
"Corozal Municipio, Puerto Rico",2012,37074,34.8,12595,2032,10563,15828,3.50979835274,0.0548093003183
"Corozal Municipio, Puerto Rico",2015,35975,36.4,13144,2105,11039,15098,3.2589002627,0.0585128561501
"Corson County, South Dakota",2009,4146,29.4,1584,378,1206,29750,3.43781094527,0.0911722141823
"Corson County, South Dakota",2012,4046,29.8,1542,378,1164,29451,3.47594501718,0.0934256055363
"Corson County, South Dakota",2015,4149,29.8,1527,298,1229,31676,3.37591537836,0.0718245360328
"Cortland County, New York",2009,48207,35.8,20397,2520,17877,44853,2.69659338815,0.0522745659344
"Cortland County, New York",2012,49453,35.8,20524,2715,17809,47497,2.77685439946,0.054900612703
"Cortland County, New York",2015,49043,36.1,20527,2592,17935,49514,2.7344856426,0.0528515792264
"Coryell County, Texas",2009,72617,28.9,23544,3690,19854,45678,3.65755011585,0.0508145475577
"Coryell County, Texas",2012,75728,29.9,25226,4762,20464,50104,3.70054730258,0.0628829495035
"Coryell County, Texas",2015,76128,30.6,25847,4018,21829,49340,3.48747079573,0.052779529214
"Coshocton County, Ohio",2009,36215,40.1,16217,2060,14157,40021,2.55809846719,0.0568825072484
"Coshocton County, Ohio",2012,36880,41.3,16493,1977,14516,41885,2.54064480573,0.0536062906725
"Coshocton County, Ohio",2015,36724,41.5,16408,2073,14335,41701,2.56184164632,0.0564480993356
"Costilla County, Colorado",2009,3282,48,2319,1013,1306,23041,2.51301684533,0.308653260207
"Costilla County, Colorado",2012,3556,47.4,2602,1184,1418,25309,2.5077574048,0.332958380202
"Costilla County, Colorado",2015,3581,49,2669,1212,1457,31321,2.45778997941,0.338452946104
"Cottle County, Texas",2009,1696,44,1151,488,663,32009,2.5580693816,0.287735849057
"Cottle County, Texas",2012,1600,49.4,999,280,719,34770,2.22531293463,0.175
"Cottle County, Texas",2015,1510,50.1,963,328,635,34955,2.37795275591,0.217218543046
"Cotton County, Oklahoma",2009,6351,38.4,3152,498,2654,42386,2.39299171063,0.0784128483703
"Cotton County, Oklahoma",2012,6171,40.2,3004,649,2355,48596,2.62038216561,0.105169340463
"Cotton County, Oklahoma",2015,6112,41.5,3019,590,2429,46361,2.51626183615,0.0965314136126
"Cottonwood County, Minnesota",2009,11343,43.1,5434,539,4895,39878,2.31726251277,0.0475182932205
"Cottonwood County, Minnesota",2012,11665,43.6,5395,565,4830,43225,2.41511387164,0.0484354907844
"Cottonwood County, Minnesota",2015,11632,42.8,5386,607,4779,46750,2.4339820046,0.0521836313618
"Covington County, Alabama",2009,36688,41.6,19127,4476,14651,33278,2.50412941096,0.12200174444
"Covington County, Alabama",2012,37803,42.5,18821,3922,14899,35321,2.5372843815,0.103748379758
"Covington County, Alabama",2015,37886,42.6,18773,3824,14949,36444,2.53435012375,0.100934382094
"Covington County, Mississippi",2009,20315,35.5,8489,1042,7447,30483,2.72794413858,0.0512921486586
"Covington County, Mississippi",2012,19571,37.2,8480,1659,6821,32345,2.86922738601,0.0847682795974
"Covington County, Mississippi",2015,19471,37.6,8502,1533,6969,31631,2.79394461185,0.0787324739356
"Covington city, Virginia",2009,6171,42.6,3227,493,2734,35758,2.25713240673,0.0798898071625
"Covington city, Virginia",2012,5903,43.8,3066,482,2584,36067,2.28444272446,0.081653396578
"Covington city, Virginia",2015,5736,43.7,3035,559,2476,34746,2.31663974152,0.0974546722455
"Coweta County, Georgia",2009,118531,35.6,45434,4075,41359,61854,2.86590584879,0.0343791919413
"Coweta County, Georgia",2012,127212,36.7,50106,3790,46316,60675,2.74661024268,0.029792786844
"Coweta County, Georgia",2015,133416,37.6,51447,2670,48777,62461,2.73522356849,0.0200125921928
"Cowley County, Kansas",2009,34055,38.6,16216,2641,13575,40229,2.50865561694,0.0775510204082
"Cowley County, Kansas",2012,36259,38.4,16033,2312,13721,41905,2.64259164784,0.063763479412
"Cowley County, Kansas",2015,36079,38.2,15995,2307,13688,43860,2.63581239041,0.0639430139416
"Cowlitz County, Washington",2009,99874,38.8,41767,3270,38497,46379,2.59433202587,0.03274125398
"Cowlitz County, Washington",2012,102138,40.1,43343,3660,39683,46568,2.57384774337,0.0358338718205
"Cowlitz County, Washington",2015,102338,41.2,43503,3740,39763,47452,2.57369916757,0.0365455646974
"Craig County, Oklahoma",2009,15079,40.8,6621,1017,5604,39335,2.69075660243,0.0674447907686
"Craig County, Oklahoma",2012,14922,42,6726,996,5730,40496,2.60418848168,0.0667470848412
"Craig County, Oklahoma",2015,14744,42.3,6709,1291,5418,38876,2.72129937246,0.0875610417797
"Craig County, Virginia",2009,5055,43.4,2582,412,2170,48845,2.32949308756,0.0815034619189
"Craig County, Virginia",2012,5186,45,2730,657,2073,47691,2.50168837434,0.126687234863
"Craig County, Virginia",2015,5212,47.1,2955,741,2214,44330,2.35411020777,0.142171910975
"Craighead County, Arkansas",2009,91474,33.1,38971,3812,35159,39431,2.60172359851,0.0416730437064
"Craighead County, Arkansas",2012,96709,33.1,40699,3342,37357,41054,2.58877854217,0.0345572800877
"Craighead County, Arkansas",2015,101409,33.5,42600,3876,38724,42475,2.61876355748,0.0382214596338
"Crane County, Texas",2009,3906,37.2,1657,168,1489,43185,2.62323707186,0.0430107526882
"Crane County, Texas",2012,4359,38,1634,83,1551,49974,2.81044487427,0.0190410644643
"Crane County, Texas",2015,4730,33.5,1652,110,1542,58333,3.06744487678,0.0232558139535
"Craven County, North Carolina",2009,96789,36.8,43985,4217,39768,44298,2.43384127942,0.0435690006096
"Craven County, North Carolina",2012,102904,36.5,45061,4787,40274,47383,2.55509758157,0.0465190857498
"Craven County, North Carolina",2015,104450,35.9,45745,5614,40131,47985,2.60272607211,0.0537482048827
"Crawford County, Arkansas",2009,58740,36.4,23343,1993,21350,38942,2.75128805621,0.0339291794348
"Crawford County, Arkansas",2012,61670,38,25985,2709,23276,39981,2.64951022512,0.0439273552781
"Crawford County, Arkansas",2015,61748,38.8,26378,2729,23649,41268,2.61101949342,0.0441957634255
"Crawford County, Georgia",2009,12511,38.6,5769,683,5086,35979,2.45988989383,0.054591959076
"Crawford County, Georgia",2012,12701,40.8,5310,618,4692,39403,2.70694799659,0.0486575860168
"Crawford County, Georgia",2015,12539,43.5,5257,719,4538,41825,2.76311150286,0.0573410957812
"Crawford County, Illinois",2009,19545,42.1,9002,935,8067,40006,2.4228337672,0.0478383218214
"Crawford County, Illinois",2012,19777,42,8682,941,7741,44617,2.55483787624,0.0475805228295
"Crawford County, Illinois",2015,19541,42.4,8643,1023,7620,47468,2.56443569554,0.0523514661481
"Crawford County, Indiana",2009,10795,40.1,5429,1125,4304,34883,2.50813197026,0.104214914312
"Crawford County, Indiana",2012,10702,41.3,5513,1254,4259,40027,2.51279643109,0.117174359933
"Crawford County, Indiana",2015,10591,43.1,5460,1359,4101,38695,2.5825408437,0.128316495137
"Crawford County, Iowa",2009,16479,39.7,7068,531,6537,43502,2.52088113814,0.0322228290552
"Crawford County, Iowa",2012,17100,38,6943,640,6303,46601,2.71299381247,0.0374269005848
"Crawford County, Iowa",2015,17252,38,6981,626,6355,48084,2.71471282455,0.0362856480408
"Crawford County, Kansas",2009,38732,32.6,18234,2317,15917,34181,2.43337312308,0.0598213363627
"Crawford County, Kansas",2012,39133,32.7,17821,2527,15294,36927,2.55871583628,0.0645746556615
"Crawford County, Kansas",2015,39304,32.6,17864,2799,15065,36534,2.60896116827,0.0712141257887
"Crawford County, Michigan",2009,14519,44,10730,4897,5833,37584,2.48911366364,0.337282181968
"Crawford County, Michigan",2012,14119,47.5,11073,5152,5921,39982,2.38456341834,0.364898363907
"Crawford County, Michigan",2015,13895,49.3,11107,5153,5954,41743,2.33372522674,0.370852824757
"Crawford County, Missouri",2009,23825,38.8,11412,2473,8939,34813,2.66528694485,0.103798530955
"Crawford County, Missouri",2012,24753,40.2,11915,2315,9600,35794,2.5784375,0.0935240172908
"Crawford County, Missouri",2015,24660,41.2,11925,2616,9309,36743,2.64904930712,0.106082725061
"Crawford County, Ohio",2009,44181,40.9,20683,2050,18633,41575,2.37111576236,0.0464000362147
"Crawford County, Ohio",2012,43623,42.2,20144,2480,17664,41877,2.46959918478,0.0568507438736
"Crawford County, Ohio",2015,42725,42.6,20052,2254,17798,40795,2.40055062367,0.0527559976594
"Crawford County, Pennsylvania",2009,88810,40.6,43673,8649,35024,38469,2.5356898127,0.0973876815674
"Crawford County, Pennsylvania",2012,88492,41.7,44612,9380,35232,41664,2.51169391462,0.105998282331
"Crawford County, Pennsylvania",2015,87343,42.4,44442,9867,34575,44579,2.52618944324,0.112968411893
"Crawford County, Wisconsin",2009,16845,42.7,9036,1993,7043,41040,2.39173647593,0.118314039774
"Crawford County, Wisconsin",2012,16677,44.5,8840,1999,6841,41743,2.43780149101,0.119865683276
"Crawford County, Wisconsin",2015,16483,45.9,8821,2198,6623,44459,2.48875132115,0.133349511618
"Creek County, Oklahoma",2009,68974,39.8,29755,3163,26592,41260,2.59378760529,0.0458578594833
"Creek County, Oklahoma",2012,69934,40.1,29755,3329,26426,43363,2.64640883978,0.0476020247662
"Creek County, Oklahoma",2015,70761,40.6,29950,3746,26204,45016,2.70038925355,0.0529387657043
"Crenshaw County, Alabama",2009,13687,39.6,6886,1029,5857,31058,2.33686187468,0.0751808285234
"Crenshaw County, Alabama",2012,13971,40.3,6742,1094,5648,37309,2.47361898017,0.0783050604824
"Crenshaw County, Alabama",2015,13938,41.3,6703,1320,5383,36022,2.58926249303,0.0947051226862
"Crisp County, Georgia",2009,22062,35.5,10163,1731,8432,27545,2.61646110057,0.078460701659
"Crisp County, Georgia",2012,23460,37.7,10714,1840,8874,32320,2.64367816092,0.078431372549
"Crisp County, Georgia",2015,23314,38.4,10720,2061,8659,31615,2.69245871348,0.0884018186497
"Crittenden County, Arkansas",2009,52199,32.9,22722,2718,20004,32323,2.60942811438,0.0520699630261
"Crittenden County, Arkansas",2012,50618,33.8,21560,3000,18560,36521,2.72726293103,0.0592674542653
"Crittenden County, Arkansas",2015,49765,34.6,21568,3220,18348,38004,2.71228471768,0.0647041093138
"Crittenden County, Kentucky",2009,9108,43.2,4611,862,3749,34554,2.42944785276,0.0946420729029
"Crittenden County, Kentucky",2012,9321,42.4,4575,740,3835,32839,2.43050847458,0.0793906233237
"Crittenden County, Kentucky",2015,9222,43,4561,806,3755,35316,2.45592543276,0.0873996963782
"Crockett County, Tennessee",2009,14408,39.4,6388,913,5475,35370,2.63159817352,0.0633675735702
"Crockett County, Tennessee",2012,14567,40.3,6407,812,5595,37601,2.6035746202,0.0557424315233
"Crockett County, Tennessee",2015,14600,39.7,6406,953,5453,35464,2.67742527049,0.0652739726027
"Crockett County, Texas",2009,3784,34.3,2072,692,1380,47143,2.74202898551,0.182875264271
"Crockett County, Texas",2012,3669,38.1,1741,468,1273,49850,2.88216810683,0.12755519215
"Crockett County, Texas",2015,3699,40.5,1753,320,1433,53678,2.58129797627,0.0865098675318
"Crook County, Oregon",2009,22473,42,9995,1202,8793,45987,2.55578300921,0.0534864059093
"Crook County, Oregon",2012,21102,45.7,10204,1459,8745,40263,2.41303602058,0.0691403658421
"Crook County, Oregon",2015,20956,48.1,10294,1215,9079,37106,2.30818372067,0.0579786218744
"Crook County, Wyoming",2009,6338,43.9,3185,661,2524,48591,2.51109350238,0.104291574629
"Crook County, Wyoming",2012,7036,44.2,3574,628,2946,51319,2.38832315003,0.0892552586697
"Crook County, Wyoming",2015,7229,43.4,3587,629,2958,60445,2.44388100068,0.0870106515424
"Crosby County, Texas",2009,6312,37.1,3236,823,2413,34485,2.61583091587,0.130386565272
"Crosby County, Texas",2012,6100,37.6,2916,721,2195,36768,2.77904328018,0.118196721311
"Crosby County, Texas",2015,6007,38.2,2900,711,2189,37434,2.74417542257,0.118361911104
"Cross County, Arkansas",2009,18801,36.9,8523,1354,7169,36036,2.62254149812,0.0720174458805
"Cross County, Arkansas",2012,17891,39.4,7876,1082,6794,39665,2.63335295849,0.0604773349729
"Cross County, Arkansas",2015,17467,40.1,7871,953,6918,38103,2.52486267707,0.0545600274804
"Crow Wing County, Minnesota",2009,61435,41.9,39556,12959,26597,44075,2.30984697522,0.210938390168
"Crow Wing County, Minnesota",2012,62521,42.7,40179,13263,26916,46822,2.32281914103,0.212136722061
"Crow Wing County, Minnesota",2015,63048,43.5,40658,14293,26365,49435,2.39135217144,0.226700291841
"Crowley County, Colorado",2009,6311,36.4,1592,379,1213,35494,5.20280296785,0.0600538741879
"Crowley County, Colorado",2012,5747,39.4,1560,353,1207,38507,4.7613918807,0.0614233513137
"Crowley County, Colorado",2015,5551,35.5,1546,377,1169,31151,4.74850299401,0.0679156908665
"Culberson County, Texas",2009,2476,32.6,1092,342,750,38365,3.30133333333,0.138126009693
"Culberson County, Texas",2012,2386,38.1,1132,278,854,33500,2.79391100703,0.116512992456
"Culberson County, Texas",2015,2296,39.2,1020,232,788,35000,2.91370558376,0.101045296167
"Culebra Municipio, Puerto Rico",2009,2114,38.3,1068,403,665,20399,3.17894736842,0.190633869442
"Culebra Municipio, Puerto Rico",2012,1535,39.9,1207,744,463,16375,3.31533477322,0.484690553746
"Culebra Municipio, Puerto Rico",2015,1557,38.9,1491,973,518,18649,3.00579150579,0.624919717405
"Cullman County, Alabama",2009,80630,39.1,36646,5653,30993,38394,2.60155518988,0.0701103807516
"Cullman County, Alabama",2012,80403,40.1,37026,5739,31287,39244,2.5698532937,0.0713779336592
"Cullman County, Alabama",2015,80965,40.5,37103,5816,31287,38971,2.58781602583,0.0718335083061
"Culpeper County, Virginia",2009,44923,36.5,18266,1676,16590,64359,2.70783604581,0.0373082830621
"Culpeper County, Virginia",2012,46894,37.9,17762,1936,15826,65567,2.96309869834,0.0412845993091
"Culpeper County, Virginia",2015,48424,38.9,17989,1474,16515,66697,2.93212231305,0.0304394515116
"Cumberland County, Illinois",2009,10802,40.3,5074,761,4313,42215,2.50452121493,0.0704499166821
"Cumberland County, Illinois",2012,11044,40.6,4882,746,4136,44430,2.67021276596,0.0675479898587
"Cumberland County, Illinois",2015,10943,41.6,4858,548,4310,46061,2.53897911833,0.0500776752262
"Cumberland County, Kentucky",2009,6832,43,3630,1098,2532,27802,2.69826224329,0.160714285714
"Cumberland County, Kentucky",2012,6857,43.3,3683,1078,2605,29885,2.63224568138,0.157211608575
"Cumberland County, Kentucky",2015,6807,44.8,3658,915,2743,32019,2.48158950055,0.134420449537
"Cumberland County, Maine",2009,276227,39.7,132725,18583,114142,54342,2.42002943702,0.0672743794053
"Cumberland County, Maine",2012,282143,41.1,138445,20831,117614,57159,2.39888958797,0.0738313550221
"Cumberland County, Maine",2015,286119,41.9,139772,22637,117135,60051,2.44264310411,0.0791174301602
"Cumberland County, New Jersey",2009,155266,36,55279,4506,50773,50035,3.05804266047,0.0290211636804
"Cumberland County, New Jersey",2012,156864,36.8,55880,5147,50733,51530,3.09195198392,0.0328118625051
"Cumberland County, New Jersey",2015,157035,36.9,56216,5848,50368,49984,3.11775333545,0.0372401057089
"Cumberland County, North Carolina",2009,309316,30,130433,14764,115669,42733,2.67414778376,0.0477311228646
"Cumberland County, North Carolina",2012,319329,30.9,136701,16978,119723,45413,2.66723186021,0.0531677360966
"Cumberland County, North Carolina",2015,324603,31.1,142119,19476,122643,44171,2.64673075512,0.0599994454765
"Cumberland County, Pennsylvania",2009,227858,39.7,94543,4117,90426,60400,2.51982836795,0.0180682705896
"Cumberland County, Pennsylvania",2012,235314,40.5,99848,5072,94776,60883,2.48284375791,0.0215541786719
"Cumberland County, Pennsylvania",2015,241427,40.8,102046,6096,95950,61820,2.51617509119,0.0252498684903
"Cumberland County, Tennessee",2009,52852,46.9,24254,3491,20763,36346,2.5454895728,0.0660523726633
"Cumberland County, Tennessee",2012,56144,48.3,27980,4548,23432,37963,2.39603960396,0.081005984611
"Cumberland County, Tennessee",2015,57455,49.7,28483,4306,24177,38576,2.37643214625,0.0749456096075
"Cumberland County, Virginia",2009,9536,40.4,4486,536,3950,38430,2.41417721519,0.0562080536913
"Cumberland County, Virginia",2012,9951,41.8,4621,605,4016,43137,2.47783864542,0.0607979097578
"Cumberland County, Virginia",2015,9859,44.3,4650,638,4012,39301,2.4573778664,0.0647124454813
"Cuming County, Nebraska",2009,9330,43.3,4332,428,3904,41900,2.38985655738,0.0458735262594
"Cuming County, Nebraska",2012,9140,43.4,4213,463,3750,47325,2.43733333333,0.0506564551422
"Cuming County, Nebraska",2015,9078,43.6,4196,497,3699,50013,2.45417680454,0.0547477417933
"Currituck County, North Carolina",2009,23713,39.9,13738,4435,9303,55261,2.5489627002,0.187028212373
"Currituck County, North Carolina",2012,23677,41,14463,5292,9171,57446,2.58172500273,0.223508045783
"Currituck County, North Carolina",2015,24492,42.6,14849,5549,9300,60600,2.6335483871,0.226563775927
"Curry County, New Mexico",2009,44986,30.4,20476,2777,17699,36621,2.54172552122,0.0617303160983
"Curry County, New Mexico",2012,48101,31.6,20135,2438,17697,41250,2.71803130474,0.0506850169435
"Curry County, New Mexico",2015,50497,30.7,20574,2412,18162,41084,2.7803655985,0.0477652137751
"Curry County, Oregon",2009,21553,52.1,12222,1792,10430,36175,2.06644295302,0.0831438778824
"Curry County, Oregon",2012,22344,53.2,12569,2249,10320,38401,2.16511627907,0.100653419262
"Curry County, Oregon",2015,22338,54.6,12622,2168,10454,40884,2.13678974555,0.0970543468529
"Custer County, Colorado",2009,3598,50,3629,1808,1821,44713,1.97583745195,0.502501389661
"Custer County, Colorado",2012,4208,52.7,4177,2124,2053,42534,2.04968339016,0.504752851711
"Custer County, Colorado",2015,4303,56.4,4323,2327,1996,35000,2.15581162325,0.540785498489
"Custer County, Idaho",2009,4129,44.9,2942,973,1969,41958,2.0970035551,0.235650278518
"Custer County, Idaho",2012,4338,47.9,3035,1157,1878,41698,2.30990415335,0.266712770862
"Custer County, Idaho",2015,4234,52,3133,1366,1767,39457,2.3961516695,0.322626358054
"Custer County, Montana",2009,11129,42.2,5358,333,5025,38627,2.21472636816,0.0299218258604
"Custer County, Montana",2012,11706,41.7,5558,483,5075,43232,2.30660098522,0.0412608918503
"Custer County, Montana",2015,11945,41.2,5585,758,4827,48750,2.47462191838,0.063457513604
"Custer County, Nebraska",2009,10894,44.6,5558,946,4612,42282,2.36209887251,0.0868367908941
"Custer County, Nebraska",2012,10904,44.7,5567,931,4636,44306,2.35202761001,0.085381511372
"Custer County, Nebraska",2015,10802,43.8,5566,821,4745,46468,2.27650158061,0.0760044436216
"Custer County, Oklahoma",2009,26012,30.1,12068,1540,10528,38537,2.47074468085,0.059203444564
"Custer County, Oklahoma",2012,27583,31.1,12197,1776,10421,43917,2.64686690337,0.0643874850451
"Custer County, Oklahoma",2015,28978,30.7,12369,2005,10364,46125,2.79602470089,0.0691904203189
"Custer County, South Dakota",2009,7865,49.4,4324,761,3563,45775,2.20740948639,0.0967577876669
"Custer County, South Dakota",2012,8219,50.5,4623,1021,3602,46984,2.28178789561,0.124224358194
"Custer County, South Dakota",2015,8394,52.8,4795,1036,3759,52218,2.23304070231,0.123421491542
"Cuyahoga County, Ohio",2009,1296287,39.2,621092,79034,542058,43145,2.39141752359,0.0609695229529
"Cuyahoga County, Ohio",2012,1278024,40.2,621184,86285,534899,43861,2.38928096706,0.0675143815766
"Cuyahoga County, Ohio",2015,1263189,40.4,619303,84584,534719,44190,2.36234171593,0.0669606844265
"Dade County, Georgia",2009,16070,36.8,6494,774,5720,40081,2.80944055944,0.0481642812694
"Dade County, Georgia",2012,16598,39.2,7249,786,6463,41677,2.56815720254,0.0473551030245
"Dade County, Georgia",2015,16445,40.7,7269,1119,6150,46434,2.67398373984,0.0680449984798
"Dade County, Missouri",2009,7503,45,3882,657,3225,32636,2.32651162791,0.0875649740104
"Dade County, Missouri",2012,7811,46.3,3965,821,3144,34000,2.48441475827,0.105108180771
"Dade County, Missouri",2015,7618,47.1,3944,749,3195,37035,2.38435054773,0.0983197689682
"Daggett County, Utah",2009,779,37.9,1158,823,335,38021,2.32537313433,1.05648267009
"Daggett County, Utah",2012,897,48.2,1140,797,343,44792,2.61516034985,0.888517279822
"Daggett County, Utah",2015,776,41.3,1165,902,263,56750,2.95057034221,1.16237113402
"Dakota County, Minnesota",2009,389434,35.6,154927,6723,148204,73209,2.6276888613,0.017263515769
"Dakota County, Minnesota",2012,399443,36.8,159725,6565,153160,73288,2.60801123009,0.0164353862754
"Dakota County, Minnesota",2015,408456,37.5,162066,5600,156466,75567,2.61050963149,0.0137101670682
"Dakota County, Nebraska",2009,20295,32.2,7760,352,7408,44564,2.73960583153,0.0173441734417
"Dakota County, Nebraska",2012,20869,32.8,7670,417,7253,44928,2.87729215497,0.0199817911735
"Dakota County, Nebraska",2015,20798,33.7,7727,437,7290,49786,2.85294924554,0.0210116357342
"Dale County, Alabama",2009,48233,34.9,22672,3415,19257,42225,2.50469958976,0.070802147907
"Dale County, Alabama",2012,50129,36,22700,3091,19609,45247,2.55642817074,0.0616609148397
"Dale County, Alabama",2015,49866,36.8,22822,3804,19018,45028,2.62204227574,0.0762844423054
"Dallam County, Texas",2009,6153,33.4,2779,719,2060,40714,2.98689320388,0.116853567366
"Dallam County, Texas",2012,6734,31.4,2842,503,2339,42781,2.87900812313,0.0746955746956
"Dallam County, Texas",2015,7014,30.7,2880,624,2256,41345,3.10904255319,0.0889649272883
"Dallas County, Alabama",2009,42748,36.7,20990,3913,17077,26442,2.50324998536,0.0915364461495
"Dallas County, Alabama",2012,43572,37.3,20248,4067,16181,26178,2.69278783759,0.0933397594786
"Dallas County, Alabama",2015,42154,38.7,20243,3830,16413,27306,2.56832998233,0.0908573326375
"Dallas County, Arkansas",2009,8214,41.4,4533,1236,3297,28233,2.49135577798,0.150474799123
"Dallas County, Arkansas",2012,8122,42.9,4317,1189,3128,30309,2.59654731458,0.146392514159
"Dallas County, Arkansas",2015,7868,43.4,4300,1052,3248,34084,2.4224137931,0.1337061515
"Dallas County, Iowa",2009,57115,34.7,22726,1665,21061,67146,2.7118845259,0.0291517114593
"Dallas County, Iowa",2012,66997,34.3,27182,1621,25561,71878,2.62106333868,0.024195113214
"Dallas County, Iowa",2015,74892,34.7,29257,1664,27593,76320,2.71416663647,0.0222186615393
"Dallas County, Missouri",2009,16579,40.4,7315,1174,6141,34367,2.69972317212,0.0708124736112
"Dallas County, Missouri",2012,16825,41.7,7630,1098,6532,40286,2.57578077159,0.0652600297177
"Dallas County, Missouri",2015,16564,43,7595,1343,6252,38062,2.6493921945,0.0810794494084
"Dallas County, Texas",2009,2383126,31.6,934468,101734,832734,47059,2.86180941333,0.0426893080769
"Dallas County, Texas",2012,2379214,32.5,944055,94181,849874,49159,2.79949027738,0.0395849217431
"Dallas County, Texas",2015,2485003,33.1,964713,83434,881279,50270,2.81976876789,0.0335750097686
"Dane County, Wisconsin",2009,476381,33.8,210009,16976,193033,59546,2.4678733688,0.0356353422995
"Dane County, Wisconsin",2012,490379,34.4,216027,12019,204008,61790,2.40372436375,0.0245096139924
"Dane County, Wisconsin",2015,510198,34.6,220503,9389,211114,62865,2.41669429787,0.0184026593597
"Daniels County, Montana",2009,1483,49,1055,341,714,34300,2.07703081232,0.229939312205
"Daniels County, Montana",2012,1734,51.7,1089,236,853,43563,2.03282532239,0.136101499423
"Daniels County, Montana",2015,1758,50.3,1118,252,866,49239,2.03002309469,0.143344709898
"Danville city, Virginia",2009,44978,42.9,23331,3121,20210,29482,2.22553191489,0.069389479301
"Danville city, Virginia",2012,43185,42.7,22488,3502,18986,30505,2.27457073633,0.0810929720968
"Danville city, Virginia",2015,42450,41.8,22376,3817,18559,32315,2.28729996228,0.0899175500589
"Dare County, North Carolina",2009,33976,43.3,32275,16592,15683,52173,2.16642224064,0.488344713916
"Dare County, North Carolina",2012,34019,43.5,33476,18400,15076,55780,2.25650039798,0.540874217349
"Dare County, North Carolina",2015,34863,45,33863,18894,14969,54496,2.32901329414,0.541949918251
"Darke County, Ohio",2009,52196,40.1,22342,1709,20633,45165,2.52973392139,0.0327419725649
"Darke County, Ohio",2012,52776,40.8,22688,1832,20856,44311,2.53049482163,0.0347127482189
"Darke County, Ohio",2015,52356,41.8,22723,1858,20865,44632,2.50927390367,0.0354878141951
"Darlington County, South Carolina",2009,66771,38.5,30199,5045,25154,38753,2.65448835175,0.0755567536805
"Darlington County, South Carolina",2012,68500,39.3,30303,3778,26525,37490,2.58246936852,0.0551532846715
"Darlington County, South Carolina",2015,67922,40.8,30244,3827,26417,35409,2.57114736723,0.0563440416949
"Dauphin County, Pennsylvania",2009,256400,39.2,116395,11136,105259,51559,2.4358962179,0.0434321372855
"Dauphin County, Pennsylvania",2012,267891,39.2,120302,12306,107996,54066,2.48056409497,0.0459365936146
"Dauphin County, Pennsylvania",2015,271094,39.6,121546,11923,109623,53754,2.47296643952,0.043981054542
"Davidson County, North Carolina",2009,156033,39.1,68913,6800,62113,44016,2.5120828168,0.0435805246326
"Davidson County, North Carolina",2012,162628,40.4,72495,7796,64699,44318,2.51360917479,0.0479376245173
"Davidson County, North Carolina",2015,163867,41.5,72895,8596,64299,43363,2.54851552901,0.0524571756363
"Davidson County, Tennessee",2009,621465,34.3,278283,26111,252172,45828,2.46444886823,0.0420152381872
"Davidson County, Tennessee",2012,629113,33.9,284328,28441,255887,46676,2.45855787906,0.0452080945712
"Davidson County, Tennessee",2015,658506,34.2,290647,26436,264211,48368,2.4923489181,0.0401454200873
"Davie County, North Carolina",2009,40297,40.9,17360,2056,15304,51110,2.63310245687,0.0510211678289
"Davie County, North Carolina",2012,41183,42.6,18187,1968,16219,51844,2.53918244035,0.0477867081077
"Davie County, North Carolina",2015,41447,43.8,18205,2392,15813,51527,2.62107127047,0.0577122590296
"Daviess County, Indiana",2009,30205,35.5,12357,1451,10906,42562,2.76957637997,0.0480384042377
"Daviess County, Indiana",2012,31604,35.7,12472,1384,11088,45927,2.85028860029,0.0437919250728
"Daviess County, Indiana",2015,32411,35,12462,1010,11452,47342,2.83016067063,0.0311622597266
"Daviess County, Kentucky",2009,93975,38.2,42714,3598,39116,42268,2.40246957767,0.0382867783985
"Daviess County, Kentucky",2012,96711,39,41589,4007,37582,45507,2.57333297855,0.0414327222343
"Daviess County, Kentucky",2015,98173,39.1,42217,3681,38536,45989,2.54756591239,0.0374950342762
"Daviess County, Missouri",2009,8061,39.1,3995,852,3143,38640,2.56474705695,0.10569408262
"Daviess County, Missouri",2012,8341,40.3,4196,1118,3078,42617,2.70987654321,0.134036686249
"Daviess County, Missouri",2015,8277,40.5,4179,1132,3047,41642,2.71644240236,0.136764528211
"Davis County, Iowa",2009,8549,40.4,3667,377,3290,45954,2.59848024316,0.0440987249971
"Davis County, Iowa",2012,8718,38.6,3601,512,3089,46807,2.82227258012,0.0587290662996
"Davis County, Iowa",2015,8742,38,3583,418,3165,48888,2.76208530806,0.0478151452757
"Davis County, Utah",2009,286502,28.6,91467,4393,87074,65892,3.29032776719,0.0153332262951
"Davis County, Utah",2012,306664,29.4,97740,3591,94149,69355,3.25721993861,0.0117098844338
"Davis County, Utah",2015,323374,30.2,101756,3846,97910,71112,3.30276784802,0.0118933494962
"Davison County, South Dakota",2009,18932,37.6,8668,796,7872,44242,2.4049796748,0.0420452144517
"Davison County, South Dakota",2012,19513,38.4,8859,464,8395,47493,2.32435973794,0.0237790191155
"Davison County, South Dakota",2015,19787,38.4,9067,487,8580,49991,2.30617715618,0.0246121190681
"Dawes County, Nebraska",2009,8736,28.7,4048,825,3223,31052,2.71051815079,0.0944368131868
"Dawes County, Nebraska",2012,9176,34.9,4237,465,3772,36974,2.43266171792,0.0506756756757
"Dawes County, Nebraska",2015,9136,33.7,4226,615,3611,41038,2.53004707837,0.0673161120841
"Dawson County, Georgia",2009,21330,40,9782,2130,7652,52658,2.78750653424,0.0998593530239
"Dawson County, Georgia",2012,22246,40.5,10408,2098,8310,53289,2.6770156438,0.0943090892745
"Dawson County, Georgia",2015,22673,41.5,10541,2328,8213,56943,2.76062340192,0.102677193137
"Dawson County, Montana",2009,8547,42.4,4102,465,3637,47706,2.35001374759,0.0544050544051
"Dawson County, Montana",2012,9022,42.1,4249,460,3789,49894,2.38110319345,0.0509864774994
"Dawson County, Montana",2015,9365,41.1,4317,343,3974,52738,2.35656768998,0.0366257341164
"Dawson County, Nebraska",2009,24789,35.6,9885,1064,8821,40842,2.810225598,0.0429222639074
"Dawson County, Nebraska",2012,24267,36.5,10124,1271,8853,45208,2.74110471027,0.0523756541806
"Dawson County, Nebraska",2015,24069,36.2,10139,1384,8755,48329,2.74917190177,0.0575013502846
"Dawson County, Texas",2009,13831,36.2,5529,989,4540,33586,3.04647577093,0.0715060371629
"Dawson County, Texas",2012,13761,33.4,5230,848,4382,40152,3.14034687357,0.0616234285299
"Dawson County, Texas",2015,13542,33.4,5209,977,4232,41095,3.19990548204,0.0721459164082
"Day County, South Dakota",2009,5637,45.7,3622,1169,2453,33810,2.29800244598,0.207379811957
"Day County, South Dakota",2012,5673,47.7,3643,1181,2462,40095,2.30422420796,0.208179093954
"Day County, South Dakota",2015,5618,48,3670,1137,2533,39216,2.21792341098,0.202385190459
"De Baca County, New Mexico",2009,1934,47.6,1375,476,899,27821,2.15127919911,0.246122026887
"De Baca County, New Mexico",2012,2069,47,1175,424,751,32554,2.75499334221,0.204929917835
"De Baca County, New Mexico",2015,2020,47.3,967,447,520,32500,3.88461538462,0.221287128713
"De Soto Parish, Louisiana",2009,26247,38.6,11845,2055,9790,36867,2.68100102145,0.0782946622471
"De Soto Parish, Louisiana",2012,26695,39.9,12254,2039,10215,40200,2.61331375428,0.0763813448211
"De Soto Parish, Louisiana",2015,26965,39.8,12369,2125,10244,41468,2.63227254979,0.0788058594474
"De Witt County, Illinois",2009,16290,40.9,7546,577,6969,46623,2.33749461903,0.0354205033763
"De Witt County, Illinois",2012,16562,42,7535,765,6770,49626,2.44638109306,0.0461900736626
"De Witt County, Illinois",2015,16388,42.8,7522,682,6840,53959,2.39590643275,0.0416158164511
"DeKalb County, Alabama",2009,68183,37.6,29255,4256,24999,33634,2.72742909716,0.0624202513823
"DeKalb County, Alabama",2012,70949,37.9,30974,5424,25550,36853,2.77686888454,0.0764492804691
"DeKalb County, Alabama",2015,71068,39.3,31058,6045,25013,38192,2.84124255387,0.085059379749
"DeKalb County, Georgia",2009,733060,33.9,305103,34979,270124,51973,2.71379070353,0.0477164215753
"DeKalb County, Georgia",2012,694671,34.3,304858,40582,264276,51252,2.628581483,0.0584190213785
"DeKalb County, Georgia",2015,716331,35.1,306218,38822,267396,51376,2.67891441906,0.0541956162724
"DeKalb County, Illinois",2009,104279,27.2,38255,2074,36181,53291,2.88214808878,0.0198889517544
"DeKalb County, Illinois",2012,104820,29.4,40932,2973,37959,53575,2.76140045839,0.028362907842
"DeKalb County, Illinois",2015,104345,30.3,41009,3740,37269,54101,2.799779978,0.0358426374048
"DeKalb County, Indiana",2009,41759,36.8,17430,1600,15830,45792,2.63796588756,0.0383150937522
"DeKalb County, Indiana",2012,42218,37.9,17580,1230,16350,46065,2.58214067278,0.0291344923966
"DeKalb County, Indiana",2015,42449,38.6,17604,1357,16247,48341,2.61272850372,0.0319677730924
"DeKalb County, Missouri",2009,12235,38.7,4166,304,3862,43302,3.16804764371,0.0248467511238
"DeKalb County, Missouri",2012,12878,40.2,4318,495,3823,43898,3.36855872352,0.0384376455971
"DeKalb County, Missouri",2015,12782,40.1,4304,548,3756,41406,3.40308839191,0.0428727898607
"DeKalb County, Tennessee",2009,18624,39.2,8846,2240,6606,34067,2.81925522252,0.120274914089
"DeKalb County, Tennessee",2012,18770,40.2,9387,2285,7102,36713,2.64291748803,0.121736814065
"DeKalb County, Tennessee",2015,19038,41,9427,2507,6920,38319,2.75115606936,0.13168400042
"DeSoto County, Florida",2009,34890,35.6,14587,3628,10959,37226,3.18368464276,0.103983949556
"DeSoto County, Florida",2012,34628,38.5,14593,4085,10508,35683,3.29539398553,0.117968118286
"DeSoto County, Florida",2015,34957,40.1,14681,3443,11238,35165,3.11060686955,0.0984924335612
"DeSoto County, Mississippi",2009,148795,34.3,57645,3663,53982,57995,2.75638175688,0.0246177626936
"DeSoto County, Mississippi",2012,161536,35.1,61657,4139,57518,58851,2.8084425745,0.0256227713946
"DeSoto County, Mississippi",2015,168586,36,63321,3311,60010,58278,2.80929845026,0.0196398277437
"DeWitt County, Texas",2009,19821,42.4,9008,1775,7233,37621,2.74035669847,0.0895514857979
"DeWitt County, Texas",2012,20156,42.7,9172,2282,6890,45457,2.92539912917,0.113216908117
"DeWitt County, Texas",2015,20540,42.2,9181,2120,7061,49736,2.90893641127,0.103213242454
"Deaf Smith County, Texas",2009,18332,30.7,7049,963,6086,38849,3.01215905357,0.0525310931704
"Deaf Smith County, Texas",2012,19275,31.1,7077,809,6268,42577,3.07514358647,0.0419714656291
"Deaf Smith County, Texas",2015,19245,31.5,7064,870,6194,43373,3.10703907007,0.0452065471551
"Dearborn County, Indiana",2009,49608,39.4,19975,1678,18297,55949,2.71126414166,0.0338251894856
"Dearborn County, Indiana",2012,49904,40.2,20173,1718,18455,58098,2.70409103224,0.0344260981084
"Dearborn County, Indiana",2015,49679,41.7,20231,1597,18634,58680,2.666040571,0.032146379758
"Decatur County, Georgia",2009,28495,35.7,13776,2050,11726,32769,2.43006993007,0.0719424460432
"Decatur County, Georgia",2012,27815,37,12222,1724,10498,30061,2.64955229568,0.061980945533
"Decatur County, Georgia",2015,27378,37.4,12137,1523,10614,31284,2.57942340305,0.0556286069107
"Decatur County, Indiana",2009,25066,37.1,10813,907,9906,45265,2.53038562487,0.0361844729913
"Decatur County, Indiana",2012,25772,38.8,11183,1302,9881,48298,2.60823803259,0.0505199441254
"Decatur County, Indiana",2015,26240,39.5,11217,1143,10074,49799,2.60472503474,0.0435594512195
"Decatur County, Iowa",2009,8321,37.5,3868,492,3376,33247,2.46475118483,0.0591275087129
"Decatur County, Iowa",2012,8382,38.4,3830,634,3196,34942,2.62265331665,0.0756382724887
"Decatur County, Iowa",2015,8249,37.4,3847,703,3144,38560,2.62372773537,0.0852224512062
"Decatur County, Kansas",2009,2966,50.2,1831,305,1526,34268,1.94364351245,0.1028320971
"Decatur County, Kansas",2012,2939,51.4,1805,324,1481,38750,1.98446995273,0.110241578768
"Decatur County, Kansas",2015,2905,52.3,1812,339,1473,40657,1.97216564834,0.11669535284
"Decatur County, Tennessee",2009,11472,43.8,6790,1792,4998,25333,2.29531812725,0.156206415621
"Decatur County, Tennessee",2012,11732,44.3,6859,1712,5147,34146,2.27938605013,0.145925673372
"Decatur County, Tennessee",2015,11686,45.3,6845,1867,4978,37263,2.34752912816,0.159763819956
"Deer Lodge County, Montana",2009,8876,45.1,4999,967,4032,33429,2.20138888889,0.108945470933
"Deer Lodge County, Montana",2012,9277,46.2,5126,1226,3900,34716,2.37871794872,0.13215479142
"Deer Lodge County, Montana",2015,9211,46.8,5131,1280,3851,39399,2.3918462737,0.138964281837
"Defiance County, Ohio",2009,38516,39,16889,1570,15319,45079,2.51426333312,0.0407622806107
"Defiance County, Ohio",2012,38975,39.1,16734,1432,15302,46377,2.54705267285,0.0367415009622
"Defiance County, Ohio",2015,38669,39.7,16709,1430,15279,50663,2.53085934943,0.0369805270372
"Del Norte County, California",2009,28729,37.4,11053,1303,9750,38408,2.94656410256,0.0453548679035
"Del Norte County, California",2012,28496,38.8,11185,1482,9703,39626,2.93682366278,0.0520072992701
"Del Norte County, California",2015,27788,38.8,11305,1885,9420,40847,2.94989384289,0.0678350367065
"Delaware County, Indiana",2009,115548,34.4,52914,6353,46561,37386,2.48164773093,0.0549814795583
"Delaware County, Indiana",2012,117459,34.6,52364,6296,46068,38215,2.5496874186,0.0536016822891
"Delaware County, Indiana",2015,117335,34.8,52348,6587,45761,38830,2.56408295273,0.0561384071249
"Delaware County, Iowa",2009,17445,41,7941,754,7187,48152,2.42729929039,0.0432215534537
"Delaware County, Iowa",2012,17721,41.9,8022,918,7104,51663,2.49451013514,0.0518029456577
"Delaware County, Iowa",2015,17507,43.1,8031,1058,6973,58274,2.51068406712,0.0604329696693
"Delaware County, New York",2009,46194,44.5,29727,10626,19101,41656,2.41840741322,0.23002987401
"Delaware County, New York",2012,47851,45.3,31143,11223,19920,43004,2.40215863454,0.234540552967
"Delaware County, New York",2015,46901,46.4,31202,11940,19262,43720,2.43489772609,0.254578793629
"Delaware County, Ohio",2009,159868,36.2,61419,3199,58220,85054,2.74592923394,0.0200102584632
"Delaware County, Ohio",2012,174454,37.2,66294,2918,63376,90499,2.75268240343,0.0167264723079
"Delaware County, Ohio",2015,185433,37.8,68668,3020,65648,91955,2.8246557397,0.0162862057994
"Delaware County, Oklahoma",2009,40076,43,24093,8682,15411,35937,2.6004801765,0.216638387065
"Delaware County, Oklahoma",2012,41332,44.9,24766,8371,16395,36423,2.52101250381,0.202530726798
"Delaware County, Oklahoma",2015,41409,45.8,24869,8308,16561,37942,2.50039248838,0.200632712695
"Delaware County, Pennsylvania",2009,555018,38.3,220716,16235,204481,61605,2.71427663206,0.0292513035613
"Delaware County, Pennsylvania",2012,558874,38.8,222632,16611,206021,64242,2.71270404473,0.0297222629788
"Delaware County, Pennsylvania",2015,561683,38.9,222249,18432,203817,65123,2.75582017202,0.0328156629273
"Delta County, Colorado",2009,30353,44.5,13243,1409,11834,40658,2.56489775224,0.0464204526735
"Delta County, Colorado",2012,30710,46.1,14497,1836,12661,42786,2.42555880262,0.0597850862911
"Delta County, Colorado",2015,30214,47.3,14500,2442,12058,42452,2.50572234201,0.0808234593235
"Delta County, Michigan",2009,37413,44.4,20213,3706,16507,42020,2.26649300297,0.0990564776949
"Delta County, Michigan",2012,37075,45.5,20212,4141,16071,42504,2.30695040757,0.111692515172
"Delta County, Michigan",2015,36712,46.4,20200,4515,15685,42031,2.34058017214,0.122984310307
"Delta County, Texas",2009,5434,40.7,2501,416,2085,41103,2.60623501199,0.0765550239234
"Delta County, Texas",2012,5240,43.6,2467,512,1955,41406,2.68030690537,0.0977099236641
"Delta County, Texas",2015,5223,43.5,2468,540,1928,42432,2.70902489627,0.103388856979
"Denali Borough, Alaska",2009,1529,42.9,1249,728,521,76250,2.93474088292,0.476128188358
"Denali Borough, Alaska",2012,1917,41.4,1581,864,717,74044,2.67364016736,0.450704225352
"Denali Borough, Alaska",2015,2060,35.9,1724,1043,681,81544,3.02496328928,0.506310679612
"Dent County, Missouri",2009,15036,42.3,7235,1124,6111,34292,2.46048109966,0.0747539239159
"Dent County, Missouri",2012,15595,42.9,7277,1350,5927,36288,2.63117934874,0.0865662071177
"Dent County, Missouri",2015,15612,43.4,7267,1347,5920,36831,2.63716216216,0.0862797847809
"Denton County, Texas",2009,611842,32.4,219299,16948,202351,70002,3.0236667968,0.0276999617548
"Denton County, Texas",2012,667934,33,255790,18058,237732,72939,2.8096091397,0.0270356053143
"Denton County, Texas",2015,731851,34.2,273765,16490,257275,75050,2.84462540084,0.0225319088175
"Denver County, Colorado",2009,582447,33.3,274061,27291,246770,45438,2.36028285448,0.0468557654173
"Denver County, Colorado",2012,604356,33.7,285495,23659,261836,49091,2.30814708443,0.0391474561351
"Denver County, Colorado",2015,649654,34.1,294191,18396,275795,53637,2.35556844758,0.0283166116117
"Des Moines County, Iowa",2009,40700,40.8,18929,1803,17126,42193,2.37650356184,0.0442997542998
"Des Moines County, Iowa",2012,40268,41.8,18541,1608,16933,43427,2.37807830863,0.0399324525678
"Des Moines County, Iowa",2015,40208,42.1,18477,1736,16741,44423,2.40176811421,0.0431754874652
"Deschutes County, Oregon",2009,151879,39.5,74849,13104,61745,53913,2.45977811969,0.0862792091072
"Deschutes County, Oregon",2012,158884,40.4,80039,15580,64459,51468,2.46488465536,0.0980589612548
"Deschutes County, Oregon",2015,166622,41.9,81773,15436,66337,51223,2.51175060675,0.0926408277418
"Desha County, Arkansas",2009,13737,38.1,6907,1138,5769,27072,2.38117524701,0.082841959671
"Desha County, Arkansas",2012,12922,39.1,6289,965,5324,29504,2.42712246431,0.0746788422845
"Desha County, Arkansas",2015,12379,39.4,6269,997,5272,27197,2.34806525038,0.080539623556
"Deuel County, Nebraska",2009,1988,46,1077,152,925,38933,2.14918918919,0.0764587525151
"Deuel County, Nebraska",2012,1962,49.1,1053,199,854,40093,2.29742388759,0.101427115189
"Deuel County, Nebraska",2015,1946,47.1,989,167,822,50962,2.36739659367,0.0858170606372
"Deuel County, South Dakota",2009,4238,43,2306,486,1820,46341,2.32857142857,0.114676734309
"Deuel County, South Dakota",2012,4376,43.6,2200,404,1796,47302,2.43652561247,0.0923217550274
"Deuel County, South Dakota",2015,4341,44.6,2223,323,1900,53152,2.28473684211,0.0744068187054
"Dewey County, Oklahoma",2009,4391,45.2,2441,575,1866,36173,2.35316184352,0.130949669779
"Dewey County, Oklahoma",2012,4775,42.3,2455,648,1807,43583,2.64250138351,0.135706806283
"Dewey County, Oklahoma",2015,4863,41.5,2440,589,1851,50904,2.62722852512,0.121118651038
"Dewey County, South Dakota",2009,6007,28.1,2226,335,1891,36587,3.17662612374,0.0557682703513
"Dewey County, South Dakota",2012,5358,29.1,2022,288,1734,34797,3.08996539792,0.053751399776
"Dewey County, South Dakota",2015,5579,29.1,1996,356,1640,37206,3.40182926829,0.0638107187668
"Dickens County, Texas",2009,2479,41,1378,513,865,28750,2.86589595376,0.206938281565
"Dickens County, Texas",2012,2399,45.4,1364,489,875,33950,2.74171428571,0.203834931221
"Dickens County, Texas",2015,2281,43.1,1423,545,878,39700,2.5979498861,0.238930293731
"Dickenson County, Virginia",2009,16099,41.8,7921,1456,6465,28296,2.4901778809,0.0904404000248
"Dickenson County, Virginia",2012,15877,43.5,7590,1186,6404,32622,2.47923173017,0.0746992504881
"Dickenson County, Virginia",2015,15463,43.4,7525,1320,6205,33624,2.49202256245,0.0853650649939
"Dickey County, North Dakota",2009,5341,42,2677,489,2188,36896,2.44104204753,0.0915558884104
"Dickey County, North Dakota",2012,5280,41.8,2648,467,2181,41934,2.42090784044,0.088446969697
"Dickey County, North Dakota",2015,5195,43.2,2629,497,2132,53750,2.43667917448,0.0956689124158
"Dickinson County, Iowa",2009,16616,46.5,12478,4399,8079,49680,2.05669018443,0.264744824266
"Dickinson County, Iowa",2012,16778,48.3,12845,4771,8074,53426,2.07802823879,0.284360472047
"Dickinson County, Iowa",2015,16967,48.7,13087,5283,7804,57265,2.17414146591,0.311369128308
"Dickinson County, Kansas",2009,18976,42.1,8979,1340,7639,45198,2.4840947768,0.0706155143339
"Dickinson County, Kansas",2012,19766,41.6,8984,1171,7813,49535,2.52988608729,0.0592431447941
"Dickinson County, Kansas",2015,19516,41.7,9066,1244,7822,49096,2.4950140629,0.0637425701988
"Dickinson County, Michigan",2009,27003,44.5,14165,2789,11376,41288,2.3736814346,0.103284820205
"Dickinson County, Michigan",2012,26286,45.4,13995,2673,11322,44272,2.32167461579,0.101689112075
"Dickinson County, Michigan",2015,26012,46.4,14008,2949,11059,43779,2.35211140248,0.113370751961
"Dickson County, Tennessee",2009,47140,37.5,19940,1547,18393,44988,2.56293155005,0.0328171404328
"Dickson County, Tennessee",2012,49704,38.4,20793,2050,18743,45109,2.65187003148,0.0412441654595
"Dickson County, Tennessee",2015,50472,39.9,21030,2474,18556,44680,2.7199827549,0.049017276906
"Dillingham Census Area, Alaska",2009,4946,29.6,2411,968,1443,60466,3.42758142758,0.195713708047
"Dillingham Census Area, Alaska",2012,4887,28.6,2427,1093,1334,56857,3.66341829085,0.22365459382
"Dillingham Census Area, Alaska",2015,4979,29.7,2422,1073,1349,54173,3.69088213491,0.21550512151
"Dillon County, South Carolina",2009,30777,36,13031,1612,11419,27588,2.69524476749,0.0523767748643
"Dillon County, South Carolina",2012,31733,37.5,13687,1913,11774,26668,2.69517581111,0.0602842466833
"Dillon County, South Carolina",2015,31435,37.8,13619,2105,11514,28938,2.73015459441,0.0669635756323
"Dimmit County, Texas",2009,9833,33.5,4260,741,3519,24268,2.79425973288,0.0753584867284
"Dimmit County, Texas",2012,10054,37,4341,913,3428,32960,2.93290548425,0.0908096280088
"Dimmit County, Texas",2015,10682,34.6,4353,785,3568,36825,2.99383408072,0.0734881108407
"Dinwiddie County, Virginia",2009,25787,40.2,11017,1400,9617,51556,2.68139752522,0.0542909217823
"Dinwiddie County, Virginia",2012,27926,40.8,11396,1608,9788,51582,2.85308541071,0.0575807491227
"Dinwiddie County, Virginia",2015,28110,42.4,11542,1603,9939,51397,2.82825233927,0.0570259694059
District of Columbia,2009,588433,35.4,283590,32867,250723,56519,2.34694463611,0.0558551270918
"District of Columbia, District of Columbia",2012,605759,33.9,296671,35479,261192,64267,2.31920962357,0.0585694971102
"District of Columbia, District of Columbia",2015,647484,33.7,303312,29922,273390,70848,2.36835290245,0.0462127249476
"Divide County, North Dakota",2009,1863,50.8,1337,439,898,46953,2.07461024499,0.23564143854
"Divide County, North Dakota",2012,2095,51.7,1384,365,1019,51208,2.05593719333,0.174224343675
"Divide County, North Dakota",2015,2314,51.7,1488,407,1081,56042,2.14061054579,0.175885911841
"Dixie County, Florida",2009,14800,41.6,7933,3919,4014,31426,3.68709516692,0.264797297297
"Dixie County, Florida",2012,16301,44.9,9219,3205,6014,35476,2.71050881277,0.196613704681
"Dixie County, Florida",2015,16091,46.9,9192,3141,6051,36292,2.65922987936,0.195202286993
"Dixon County, Nebraska",2009,6224,42.8,2741,348,2393,42016,2.6009193481,0.055912596401
"Dixon County, Nebraska",2012,5982,41,2682,309,2373,45814,2.5208596713,0.0516549648947
"Dixon County, Nebraska",2015,5866,41.9,2681,376,2305,51223,2.54490238612,0.0640981929765
"Doddridge County, West Virginia",2009,7238,42.3,3809,970,2839,30725,2.54948925678,0.134014921249
"Doddridge County, West Virginia",2012,8147,41.9,3944,1171,2773,31261,2.9379733141,0.143733889775
"Doddridge County, West Virginia",2015,8201,43.7,3920,1246,2674,39974,3.06694091249,0.151932691135
"Dodge County, Georgia",2009,19695,36.1,8516,1580,6936,31334,2.83953287197,0.0802234069561
"Dodge County, Georgia",2012,21509,39.5,9772,1574,8198,36042,2.62368870456,0.0731786693942
"Dodge County, Georgia",2015,21180,40.2,9767,1703,8064,34271,2.62648809524,0.0804060434372
"Dodge County, Minnesota",2009,19504,36.5,7797,604,7193,62269,2.71152509384,0.0309680065628
"Dodge County, Minnesota",2012,20071,37,7962,604,7358,66959,2.72777928785,0.0300931692492
"Dodge County, Minnesota",2015,20290,37.9,8015,459,7556,68116,2.68528321863,0.0226219812716
"Dodge County, Nebraska",2009,35774,40.3,16061,1571,14490,44904,2.46887508627,0.0439145748309
"Dodge County, Nebraska",2012,36590,40.2,16565,1272,15293,46475,2.39259792062,0.0347635966111
"Dodge County, Nebraska",2015,36725,39.4,16606,1496,15110,49068,2.43050959629,0.0407351940095
"Dodge County, Wisconsin",2009,87597,39.6,36575,2603,33972,52658,2.57850582833,0.0297156295307
"Dodge County, Wisconsin",2012,88741,40.6,37004,3238,33766,53782,2.62811704081,0.0364882072548
"Dodge County, Wisconsin",2015,88547,42,37229,3907,33322,53783,2.65731348659,0.0441234598575
"Dolores County, Colorado",2009,1771,43.7,1252,578,674,41961,2.62759643917,0.326369282891
"Dolores County, Colorado",2012,1806,46.5,1415,608,807,43098,2.23791821561,0.33665559247
"Dolores County, Colorado",2015,1862,39.9,1335,629,706,31875,2.63739376771,0.337808807734
"Doniphan County, Kansas",2009,7732,38.5,3577,520,3057,40238,2.52927706902,0.0672529746508
"Doniphan County, Kansas",2012,7931,37.9,3574,432,3142,46346,2.52418841502,0.0544698020426
"Doniphan County, Kansas",2015,7859,38.8,3556,447,3109,47209,2.52782245095,0.0568774653264
"Donley County, Texas",2009,3703,38.8,2450,1005,1445,36250,2.56262975779,0.271401566298
"Donley County, Texas",2012,3652,40.7,2149,801,1348,41875,2.70919881306,0.219331872946
"Donley County, Texas",2015,3588,42.9,2136,825,1311,36681,2.73684210526,0.229933110368
"Dooly County, Georgia",2009,11641,38.7,4620,830,3790,30172,3.07150395778,0.0712997165192
"Dooly County, Georgia",2012,14528,40.7,6217,1223,4994,30789,2.90909090909,0.0841822687225
"Dooly County, Georgia",2015,14293,41.4,6239,1235,5004,28696,2.85631494804,0.0864059329742
"Door County, Wisconsin",2009,27901,48.1,21923,8474,13449,46581,2.07457803554,0.303716712663
"Door County, Wisconsin",2012,27872,49.6,23689,9994,13695,48707,2.03519532676,0.358567738232
"Door County, Wisconsin",2015,27731,51.7,24238,11270,12968,51928,2.13841764343,0.406404384984
"Dorado Municipio, Puerto Rico",2009,36293,34.5,14448,2776,11672,23531,3.10940712817,0.0764885790648
"Dorado Municipio, Puerto Rico",2012,38179,36.9,15225,3040,12185,28530,3.13327862126,0.0796249246968
"Dorado Municipio, Puerto Rico",2015,38166,38.3,15896,3564,12332,26947,3.09487512163,0.0933815437824
"Dorchester County, Maryland",2009,31646,42.9,16367,3057,13310,45095,2.37761081893,0.0965998862415
"Dorchester County, Maryland",2012,32570,42.9,16557,2988,13569,46199,2.40032426855,0.0917408658274
"Dorchester County, Maryland",2015,32534,43.8,16688,3423,13265,47093,2.45261967584,0.10521300793
"Dorchester County, South Carolina",2009,122442,35.5,46794,4119,42675,54139,2.86917398946,0.0336404175038
"Dorchester County, South Carolina",2012,136836,35.6,54912,5519,49393,54912,2.77035207418,0.0403329533164
"Dorchester County, South Carolina",2015,145715,35.8,57003,5147,51856,54901,2.8099930577,0.0353223758707
"Dougherty County, Georgia",2009,95330,32.8,41624,4869,36755,34597,2.59366072643,0.05107521242
"Dougherty County, Georgia",2012,94591,33.4,40820,4902,35918,31789,2.63352636561,0.0518231121354
"Dougherty County, Georgia",2015,93310,34.2,40706,5251,35455,32084,2.63178677196,0.0562747829815
"Douglas County, Colorado",2009,269451,35.5,97523,3772,93751,99522,2.87411334279,0.0139988346675
"Douglas County, Colorado",2012,286883,36.7,106829,4640,102189,101108,2.80737652781,0.0161738409038
"Douglas County, Colorado",2015,306974,37.6,115068,3955,111113,102964,2.76271903378,0.0128838272948
"Douglas County, Georgia",2009,122657,33.5,47770,5347,42423,55512,2.89128538764,0.0435931092396
"Douglas County, Georgia",2012,132124,35,51452,5547,45905,54526,2.87820498856,0.041983288426
"Douglas County, Georgia",2015,136520,35.9,51775,4696,47079,53881,2.89980670787,0.034397890419
"Douglas County, Illinois",2009,19436,38.1,8345,749,7596,47431,2.55871511322,0.0385367359539
"Douglas County, Illinois",2012,19908,38.3,8370,757,7613,50589,2.61500065677,0.0380249146072
"Douglas County, Illinois",2015,19826,38.3,8392,774,7618,51810,2.60252034655,0.0390396449107
"Douglas County, Kansas",2009,113724,26.8,46433,2999,43434,44835,2.61831744716,0.0263708627906
"Douglas County, Kansas",2012,111073,28.3,46746,3324,43422,48395,2.55798903781,0.0299262647088
"Douglas County, Kansas",2015,114967,28.8,47812,4083,43729,50939,2.62907910083,0.0355145389547
"Douglas County, Minnesota",2009,35854,42.5,19848,3676,16172,44918,2.21704180064,0.10252691471
"Douglas County, Minnesota",2012,36167,43.6,20006,4087,15919,50365,2.27193919216,0.113003566787
"Douglas County, Minnesota",2015,36620,44.1,20396,4837,15559,54531,2.35362169805,0.132086291644
"Douglas County, Missouri",2009,13470,42.3,6175,1324,4851,30675,2.77674706246,0.098292501856
"Douglas County, Missouri",2012,13690,44.9,6491,1414,5077,31277,2.69647429584,0.103287070855
"Douglas County, Missouri",2015,13516,47.3,6465,1188,5277,30508,2.56130377108,0.0878958271678
"Douglas County, Nebraska",2009,497939,33.3,211594,17213,194381,50107,2.56166497754,0.0345684913212
"Douglas County, Nebraska",2012,518271,33.6,219688,17473,202215,53295,2.56297010608,0.0337140222007
"Douglas County, Nebraska",2015,537655,34,225046,16505,208541,54659,2.57817407608,0.0306981242618
"Douglas County, Nevada",2009,45674,46.6,22971,4326,18645,63531,2.44966478949,0.0947147173447
"Douglas County, Nevada",2012,47056,47.3,23664,4438,19226,61099,2.44751898471,0.0943131587895
"Douglas County, Nevada",2015,47259,49.4,23710,3931,19779,58535,2.38935234339,0.0831799234008
"Douglas County, Oregon",2009,103385,45.3,46221,3851,42370,40324,2.44005192353,0.0372491173768
"Douglas County, Oregon",2012,107391,46.1,48775,5097,43678,40096,2.45869774257,0.0474620778278
"Douglas County, Oregon",2015,107194,46.9,49018,5220,43798,41312,2.44746335449,0.0486967554154
"Douglas County, South Dakota",2009,3050,47.7,1478,199,1279,38963,2.38467552776,0.0652459016393
"Douglas County, South Dakota",2012,2992,48.1,1450,203,1247,48836,2.3993584603,0.0678475935829
"Douglas County, South Dakota",2015,2973,48,1434,138,1296,52500,2.29398148148,0.0464177598385
"Douglas County, Washington",2009,36145,36.5,14634,1382,13252,47408,2.72751282825,0.0382348872596
"Douglas County, Washington",2012,38369,36.8,15952,1896,14056,52285,2.7297239613,0.0494148922307
"Douglas County, Washington",2015,39599,37,16164,1952,14212,53636,2.7863073459,0.0492941740953
"Douglas County, Wisconsin",2009,43954,39.6,21515,3092,18423,43026,2.38582207024,0.0703462711016
"Douglas County, Wisconsin",2012,43963,40,22767,3601,19166,45370,2.29380152353,0.0819097877761
"Douglas County, Wisconsin",2015,43799,40.6,22887,4306,18581,47095,2.35719283139,0.0983127468664
"Doña Ana County, New Mexico",2009,197819,31,76526,6982,69544,35544,2.84451570229,0.035294890784
"Doña Ana County, New Mexico",2012,208794,32.4,81477,8294,73183,38462,2.85303964035,0.0397233636982
"Doña Ana County, New Mexico",2015,213963,32.4,83586,8824,74762,38853,2.86192183195,0.0412407752742
"Drew County, Arkansas",2009,18699,34.8,8860,1156,7704,32061,2.42718068536,0.0618214877801
"Drew County, Arkansas",2012,18615,37.5,8473,979,7494,32087,2.48398718975,0.0525919957024
"Drew County, Arkansas",2015,18740,37.5,8478,1164,7314,32819,2.56220946131,0.0621131270011
"DuPage County, Illinois",2009,925530,37.2,357449,20394,337055,76355,2.74593167287,0.0220349421413
"DuPage County, Illinois",2012,918608,38.2,356370,20838,335532,78538,2.73776569746,0.022684322366
"DuPage County, Illinois",2015,930412,38.8,357016,18933,338083,79658,2.75202243236,0.0203490496683
"Dubois County, Indiana",2009,41207,39.1,16842,1087,15755,53286,2.61548714694,0.0263790132744
"Dubois County, Indiana",2012,41995,40.6,17358,1413,15945,54168,2.63374098463,0.0336468627218
"Dubois County, Indiana",2015,42291,41.2,17540,1350,16190,53513,2.61216800494,0.031921685465
"Dubuque County, Iowa",2009,92046,38.1,38785,1823,36962,48012,2.49028732211,0.0198053147339
"Dubuque County, Iowa",2012,93776,38.7,39150,1827,37323,50885,2.51255258152,0.0194825968265
"Dubuque County, Iowa",2015,95906,38.8,40077,2186,37891,54605,2.5311023726,0.0227931516276
"Duchesne County, Utah",2009,16327,29.3,7945,2078,5867,51504,2.78285324697,0.127273840877
"Duchesne County, Utah",2012,18537,29.8,9353,2526,6827,55724,2.71524827889,0.136268004531
"Duchesne County, Utah",2015,19817,30.2,9715,3109,6606,61133,2.99984862246,0.156885502346
"Dukes County, Massachusetts",2009,15675,44.4,16057,10435,5622,62472,2.78815368196,0.665709728868
"Dukes County, Massachusetts",2012,16581,45.4,17140,11358,5782,65896,2.86769283985,0.68500090465
"Dukes County, Massachusetts",2015,17048,45.9,17446,11439,6007,64222,2.83802230731,0.670987799155
"Dundy County, Nebraska",2009,1939,49.1,1130,265,865,38346,2.24161849711,0.136668385766
"Dundy County, Nebraska",2012,1996,47.4,1145,239,906,39596,2.20309050773,0.119739478958
"Dundy County, Nebraska",2015,2015,46.2,1130,230,900,42500,2.23888888889,0.114143920596
"Dunklin County, Missouri",2009,31528,39.1,15146,1893,13253,29124,2.37893307176,0.0600418675463
"Dunklin County, Missouri",2012,31970,39.5,14450,1786,12664,30379,2.52447883765,0.0558648733187
"Dunklin County, Missouri",2015,31562,39.8,14352,1729,12623,31077,2.50035649212,0.0547810658387
"Dunn County, North Dakota",2009,3318,44.5,1981,675,1306,45270,2.54058192956,0.203435804702
"Dunn County, North Dakota",2012,3648,43.3,2201,740,1461,54539,2.49691991786,0.202850877193
"Dunn County, North Dakota",2015,4195,41.7,2404,847,1557,69732,2.69428387925,0.201907032181
"Dunn County, Wisconsin",2009,42416,32.4,17399,1744,15655,48253,2.70942190993,0.0411165597888
"Dunn County, Wisconsin",2012,43788,33.6,17938,1590,16348,47847,2.67849278199,0.0363113181694
"Dunn County, Wisconsin",2015,44159,34.1,18072,1631,16441,49788,2.68590718326,0.0369347131955
"Duplin County, North Carolina",2009,52358,35.4,21578,3799,17779,33703,2.94493503572,0.0725581573017
"Duplin County, North Carolina",2012,58510,37.4,25481,3656,21825,33896,2.68087056128,0.0624850452914
"Duplin County, North Carolina",2015,59453,38.8,25584,3638,21946,35035,2.70905859838,0.0611911930432
"Durham County, North Carolina",2009,256296,33.1,115227,11959,103268,49928,2.48185304257,0.0466608920935
"Durham County, North Carolina",2012,269283,33.4,120317,11208,109109,50997,2.46801822031,0.0416216396876
"Durham County, North Carolina",2015,288817,34.4,125685,9710,115975,52503,2.49033843501,0.0336199046455
"Dutchess County, New York",2009,292187,39.2,112204,9348,102856,68472,2.84073850821,0.031993209828
"Dutchess County, New York",2012,297291,40.2,118256,10522,107734,71508,2.7594909685,0.0353929315048
"Dutchess County, New York",2015,296928,41.2,118996,12225,106771,71904,2.78097985408,0.0411715971549
"Duval County, Florida",2009,846385,34.7,385379,48652,336727,49135,2.51356440084,0.0574821151131
"Duval County, Florida",2012,866431,35.7,388497,58195,330302,48906,2.62314790707,0.0671663410012
"Duval County, Florida",2015,890673,36,393571,55671,337900,47690,2.6359070731,0.0625044208144
"Duval County, Texas",2009,12199,36,5801,1346,4455,26117,2.73827160494,0.110336912862
"Duval County, Texas",2012,11821,37.2,5532,1689,3843,35167,3.07598230549,0.142881312918
"Duval County, Texas",2015,11577,37.3,5533,1596,3937,33939,2.94056388113,0.137859549106
"Dyer County, Tennessee",2009,37698,38.7,17098,1970,15128,36121,2.49193548387,0.0522574141864
"Dyer County, Tennessee",2012,38234,39.5,16731,1778,14953,38167,2.55694509463,0.046503112413
"Dyer County, Tennessee",2015,38054,40.3,16772,1841,14931,42468,2.54865715625,0.048378619856
"Eagle County, Colorado",2009,50614,32.8,26548,10073,16475,69139,3.07216995448,0.199016082507
"Eagle County, Colorado",2012,51850,34.2,31085,12678,18407,71030,2.81686314989,0.244513018322
"Eagle County, Colorado",2015,52576,35.6,31474,13634,17840,72214,2.94708520179,0.259319841753
"Early County, Georgia",2009,11812,37.8,5533,1100,4433,28063,2.66456124521,0.0931256349475
"Early County, Georgia",2012,10928,39,5006,907,4099,29772,2.66601610149,0.0829978038067
"Early County, Georgia",2015,10579,40.3,4930,949,3981,31680,2.65737251947,0.0897060213631
"East Baton Rouge Parish, Louisiana",2009,427820,31.7,184865,17502,167363,44215,2.55624002916,0.0409097283904
"East Baton Rouge Parish, Louisiana",2012,439662,32.7,187599,20301,167298,48274,2.62801707133,0.0461741064727
"East Baton Rouge Parish, Louisiana",2015,444690,33.2,190343,21223,169120,49285,2.62943472091,0.0477253817266
"East Carroll Parish, Louisiana",2009,8265,32.6,3611,507,3104,21994,2.66269329897,0.0613430127042
"East Carroll Parish, Louisiana",2012,7738,33.1,2890,519,2371,25413,3.26360185576,0.0670715947273
"East Carroll Parish, Louisiana",2015,7501,33.3,3156,478,2678,21099,2.80097087379,0.0637248366884
"East Feliciana Parish, Louisiana",2009,20871,39.2,8387,1297,7090,36707,2.9437235543,0.0621436442911
"East Feliciana Parish, Louisiana",2012,20252,40.6,8030,1174,6856,43868,2.95390898483,0.057969583251
"East Feliciana Parish, Louisiana",2015,19855,41.8,8138,1201,6937,45520,2.86218826582,0.060488541929
"Eastland County, Texas",2009,18260,39.6,9813,2687,7126,33149,2.56244737581,0.147152245345
"Eastland County, Texas",2012,18519,41.2,10236,3091,7145,35044,2.59188243527,0.166909660349
"Eastland County, Texas",2015,18328,42.9,10259,3449,6810,34888,2.69133627019,0.188182016587
"Eaton County, Michigan",2009,106894,38.8,45685,3335,42350,54858,2.52406139315,0.0311991318502
"Eaton County, Michigan",2012,107861,40.4,46999,3699,43300,55301,2.49101616628,0.0342941378255
"Eaton County, Michigan",2015,108341,41,47092,3460,43632,54993,2.48306288962,0.0319362014381
"Eau Claire County, Wisconsin",2009,97422,32.2,41395,2425,38970,45178,2.49992301771,0.0248917082384
"Eau Claire County, Wisconsin",2012,98952,33.2,42144,2434,39710,47821,2.49186602871,0.0245977847845
"Eau Claire County, Wisconsin",2015,101281,33.8,42708,2815,39893,49513,2.53881633369,0.0277939593803
"Echols County, Georgia",2009,4157,30.5,1513,248,1265,35230,3.28616600791,0.0596584075054
"Echols County, Georgia",2012,4024,32.4,1592,259,1333,27933,3.01875468867,0.0643638170974
"Echols County, Georgia",2015,4048,35.4,1665,249,1416,32959,2.85875706215,0.0615118577075
"Ector County, Texas",2009,128988,30.7,51519,4958,46561,44322,2.77030132514,0.0384376841257
"Ector County, Texas",2012,138193,31.2,53227,4162,49065,50851,2.81652909406,0.0301172997185
"Ector County, Texas",2015,149557,30.7,55357,4489,50868,57150,2.94009986632,0.0300153118878
"Eddy County, New Mexico",2009,51348,37.3,22420,2997,19423,44510,2.64366987592,0.0583664407572
"Eddy County, New Mexico",2012,53693,37,22630,2686,19944,47940,2.69218812675,0.0500251429423
"Eddy County, New Mexico",2015,55641,36.5,23166,2528,20638,56618,2.6960461285,0.0454341223199
"Eddy County, North Dakota",2009,2417,44.7,1322,271,1051,38050,2.29971455756,0.112122465867
"Eddy County, North Dakota",2012,2393,48.4,1349,265,1084,40000,2.20756457565,0.110739657334
"Eddy County, North Dakota",2015,2370,48.3,1325,265,1060,48583,2.2358490566,0.111814345992
"Edgar County, Illinois",2009,18750,42.6,8848,949,7899,38624,2.37371819218,0.0506133333333
"Edgar County, Illinois",2012,18513,43,8802,923,7879,42730,2.3496636629,0.0498568573435
"Edgar County, Illinois",2015,17992,43.4,8753,1037,7716,45691,2.33177812338,0.0576367274344
"Edgecombe County, North Carolina",2009,52586,37.8,25365,3444,21921,30734,2.39888691209,0.0654927166927
"Edgecombe County, North Carolina",2012,56253,40,24841,3614,21227,33917,2.65006830923,0.0642454624642
"Edgecombe County, North Carolina",2015,55280,39.9,24707,3681,21026,32659,2.62912584419,0.0665882778582
"Edgefield County, South Carolina",2009,25469,38.5,9948,1096,8852,44391,2.877202892,0.0430327064274
"Edgefield County, South Carolina",2012,26763,40.6,10521,1505,9016,44208,2.96838952972,0.0562343533983
"Edgefield County, South Carolina",2015,26466,42.1,10608,1512,9096,46637,2.90963060686,0.0571299025164
"Edmonson County, Kentucky",2009,11941,40.7,6470,1750,4720,34678,2.52987288136,0.146553889959
"Edmonson County, Kentucky",2012,12141,41.7,6467,1648,4819,35243,2.51940236564,0.13573840705
"Edmonson County, Kentucky",2015,12105,42.5,6452,1793,4659,41710,2.59819703799,0.148120611318
"Edmunds County, South Dakota",2009,3981,45.6,2084,421,1663,46169,2.39386650631,0.105752323537
"Edmunds County, South Dakota",2012,4050,45.9,1939,353,1586,51379,2.55359394704,0.0871604938272
"Edmunds County, South Dakota",2015,4018,46.1,1911,325,1586,56000,2.53341740227,0.0808860129418
"Edwards County, Illinois",2009,6526,43.6,3317,428,2889,40741,2.25891311873,0.0655838185719
"Edwards County, Illinois",2012,6691,43.1,3193,451,2742,39238,2.4401896426,0.0674039754895
"Edwards County, Illinois",2015,6649,43.7,3170,385,2785,44497,2.38743267504,0.0579034441269
"Edwards County, Kansas",2009,3118,44.3,1686,307,1379,37682,2.26105873822,0.0984605516357
"Edwards County, Kansas",2012,3021,43.6,1641,329,1312,43953,2.30259146341,0.108904336312
"Edwards County, Kansas",2015,2991,45.2,1630,356,1274,47303,2.34772370487,0.11902373788
"Edwards County, Texas",2009,1908,40.3,1324,565,759,34426,2.51383399209,0.296121593291
"Edwards County, Texas",2012,2023,45.1,1615,761,854,41613,2.36885245902,0.376173999011
"Edwards County, Texas",2015,1906,49.5,1713,966,747,41813,2.5515394913,0.506820566632
"Effingham County, Georgia",2009,50357,34.6,18666,1503,17163,53883,2.93404416477,0.0298468931827
"Effingham County, Georgia",2012,52203,35.4,19857,1878,17979,62953,2.9035541465,0.0359749439687
"Effingham County, Georgia",2015,54630,36.1,20361,1929,18432,63100,2.9638671875,0.0353102690829
"Effingham County, Illinois",2009,34329,38.4,14607,1195,13412,46658,2.55957351625,0.0348102187655
"Effingham County, Illinois",2012,34258,39.5,14620,977,13643,51009,2.5110312981,0.0285188860996
"Effingham County, Illinois",2015,34332,38.9,14727,1397,13330,52224,2.57554388597,0.0406909006175
"El Dorado County, California",2009,175941,41.6,82227,16848,65379,70765,2.69109347038,0.095759373881
"El Dorado County, California",2012,180441,43.5,87828,19982,67846,70117,2.65956725525,0.110739798605
"El Dorado County, California",2015,182093,44.9,88639,21553,67086,69584,2.71432191515,0.118362594938
"El Paso County, Colorado",2009,586446,34.5,242262,21094,221168,56570,2.65158612457,0.0359692111465
"El Paso County, Colorado",2012,622816,34.1,253014,18956,234058,57531,2.66094728657,0.0304359554026
"El Paso County, Colorado",2015,655024,33.6,261745,16458,245287,58206,2.67043911826,0.0251257969174
"El Paso County, Texas",2009,729396,30.7,253038,18672,234366,35249,3.11220910883,0.0255992629518
"El Paso County, Texas",2012,801115,31.2,271104,18678,252426,39699,3.17366277642,0.0233150047122
"El Paso County, Texas",2015,831095,31.6,282616,23004,259612,41637,3.20129655024,0.0276791461867
"Elbert County, Colorado",2009,22786,42.2,8752,678,8074,74345,2.8221451573,0.0297551127886
"Elbert County, Colorado",2012,23058,43,8942,747,8195,80811,2.81366687004,0.0323965651835
"Elbert County, Colorado",2015,23855,45.1,9034,617,8417,84963,2.83414518237,0.0258645986166
"Elbert County, Georgia",2009,20574,39,9515,1670,7845,32213,2.62256214149,0.0811704092544
"Elbert County, Georgia",2012,20103,41.2,9568,1842,7726,35053,2.60199326948,0.0916281152067
"Elbert County, Georgia",2015,19537,41.3,9521,1777,7744,35388,2.52285640496,0.0909556226647
"Elk County, Kansas",2009,3016,48.1,1925,553,1372,31361,2.19825072886,0.183355437666
"Elk County, Kansas",2012,2856,49,1757,525,1232,33239,2.31818181818,0.183823529412
"Elk County, Kansas",2015,2683,50.4,1740,484,1256,36458,2.13614649682,0.180395080134
"Elk County, Pennsylvania",2009,32594,43.2,18428,4497,13931,43077,2.3396741081,0.13797017856
"Elk County, Pennsylvania",2012,31981,45.1,17619,3988,13631,44741,2.34619617049,0.124699040055
"Elk County, Pennsylvania",2015,31370,46.4,17535,4291,13244,46671,2.36861975234,0.136786738923
"Elkhart County, Indiana",2009,197851,33.8,77294,6201,71093,47840,2.78298847988,0.0313417672895
"Elkhart County, Indiana",2012,198214,34.8,77709,7548,70161,46712,2.82513077066,0.0380800548902
"Elkhart County, Indiana",2015,200685,35.2,77880,7441,70439,47913,2.84906088956,0.0370780078232
"Elko County, Nevada",2009,46442,33.9,19505,2207,17298,63327,2.68481905423,0.0475216398949
"Elko County, Nevada",2012,49133,33.4,19624,2112,17512,70411,2.80567610781,0.0429853662508
"Elko County, Nevada",2015,51562,33.5,20192,2496,17696,71799,2.91376582278,0.0484077421357
"Elliott County, Kentucky",2009,8291,39,3300,826,2474,23426,3.35125303153,0.099626100591
"Elliott County, Kentucky",2012,7774,40.9,3369,861,2508,24841,3.09968102073,0.1107537947
"Elliott County, Kentucky",2015,7725,41.7,3364,614,2750,28224,2.80909090909,0.0794822006472
"Ellis County, Kansas",2009,27352,30.9,12426,1048,11378,41704,2.4039374231,0.0383152968704
"Ellis County, Kansas",2012,28525,31.8,12869,1131,11738,44253,2.43014142103,0.0396494303243
"Ellis County, Kansas",2015,28993,32.2,12996,1149,11847,45579,2.4472862328,0.0396302555789
"Ellis County, Oklahoma",2009,3855,45.9,2177,524,1653,40401,2.33212341198,0.135927367056
"Ellis County, Oklahoma",2012,4095,44.8,2258,480,1778,47933,2.3031496063,0.117216117216
"Ellis County, Oklahoma",2015,4121,44.3,2267,557,1710,50855,2.40994152047,0.1351613686
"Ellis County, Texas",2009,142348,34.1,49917,3510,46407,58809,3.06738207598,0.0246578806868
"Ellis County, Texas",2012,149712,35,54354,4027,50327,62832,2.97478490671,0.0268983114246
"Ellis County, Texas",2015,157058,35.7,56353,3700,52653,62465,2.9828879646,0.0235581759605
"Ellsworth County, Kansas",2009,6247,43.7,3312,644,2668,43418,2.34145427286,0.103089482952
"Ellsworth County, Kansas",2012,6477,44.2,3226,614,2612,46350,2.47970903522,0.0947969739077
"Ellsworth County, Kansas",2015,6410,44.2,3219,634,2585,47736,2.47969052224,0.0989079563183
"Elmore County, Alabama",2009,76714,36.8,28829,3412,25417,52971,3.01821615454,0.0444768881821
"Elmore County, Alabama",2012,79330,37.7,32498,4355,28143,55514,2.81881817859,0.0548972645909
"Elmore County, Alabama",2015,80763,37.9,33140,4489,28651,53555,2.81885449024,0.0555823830219
"Elmore County, Idaho",2009,28791,28.5,11906,2234,9672,44015,2.9767369727,0.0775936924733
"Elmore County, Idaho",2012,26655,30.3,12137,2583,9554,43886,2.78993091899,0.096904895892
"Elmore County, Idaho",2015,26175,30.8,12195,2410,9785,43848,2.67501277466,0.0920725883477
"Emanuel County, Georgia",2009,22620,35.3,9734,1352,8382,27924,2.69863994273,0.0597701149425
"Emanuel County, Georgia",2012,22600,36.9,9955,1849,8106,31675,2.78805822847,0.081814159292
"Emanuel County, Georgia",2015,22731,36.9,9904,1748,8156,32229,2.78702795488,0.0768993885003
"Emery County, Utah",2009,10408,32.6,4341,651,3690,47446,2.82059620596,0.0625480399693
"Emery County, Utah",2012,10902,33,4474,823,3651,51372,2.98603122432,0.0754907356448
"Emery County, Utah",2015,10728,34.5,4483,952,3531,49787,3.03823279524,0.0887397464579
"Emmet County, Iowa",2009,10357,39.6,4948,619,4329,43098,2.39246939247,0.0597663416047
"Emmet County, Iowa",2012,10263,40.2,4782,574,4208,46547,2.43892585551,0.0559290655754
"Emmet County, Iowa",2015,9917,41.5,4765,620,4145,47795,2.39252110977,0.0625189069275
"Emmet County, Michigan",2009,33467,41.9,20959,7086,13873,48773,2.41238376703,0.211730958855
"Emmet County, Michigan",2012,32799,43.1,21272,7731,13541,50686,2.42219924673,0.235708405744
"Emmet County, Michigan",2015,33018,44.3,21319,7371,13948,51018,2.36722110697,0.223241868072
"Emmons County, North Dakota",2009,3542,49.6,2169,538,1631,33947,2.17167381974,0.151891586674
"Emmons County, North Dakota",2012,3544,50.5,2031,408,1623,37304,2.18361059766,0.115124153499
"Emmons County, North Dakota",2015,3463,51.2,2108,509,1599,44051,2.16572858036,0.146982385215
"Emporia city, Virginia",2009,5605,42.2,2794,331,2463,33412,2.27568006496,0.0590544157003
"Emporia city, Virginia",2012,5825,39.2,2754,268,2486,29093,2.34312148029,0.046008583691
"Emporia city, Virginia",2015,5672,43.4,2686,227,2459,28601,2.30662871086,0.0400211565585
"Erath County, Texas",2009,35454,29.1,15429,2308,13121,37729,2.7020806341,0.0650984374119
"Erath County, Texas",2012,38192,30.9,16873,2650,14223,40176,2.68522815159,0.0693862589024
"Erath County, Texas",2015,40039,30.3,17251,2679,14572,41416,2.74766675817,0.0669097629811
"Erie County, New York",2009,914200,40,423285,42720,380565,46609,2.40221775518,0.0467293808795
"Erie County, New York",2012,919542,40.3,420143,40163,379980,49977,2.41997473551,0.0436771784214
"Erie County, New York",2015,921584,40.4,420782,37936,382846,51247,2.40719244814,0.0411639090956
"Erie County, Ohio",2009,77400,42.6,37498,5743,31755,46403,2.43741143127,0.0741989664083
"Erie County, Ohio",2012,76952,43.3,37838,6126,31712,46906,2.42658930373,0.0796080673667
"Erie County, Ohio",2015,76141,44,37739,5972,31767,48011,2.39685837504,0.0784334327104
"Erie County, Pennsylvania",2009,279721,38.2,118222,10664,107558,43456,2.60065267112,0.0381237018315
"Erie County, Pennsylvania",2012,280181,38.5,119162,10156,109006,45249,2.57032640405,0.0362479968306
"Erie County, Pennsylvania",2015,279858,38.8,119827,9893,109934,45971,2.54569105099,0.0353500703928
"Escambia County, Alabama",2009,37561,38,17024,2802,14222,32321,2.64104907889,0.074598652858
"Escambia County, Alabama",2012,38122,38.7,16525,2646,13879,31075,2.74673967865,0.0694087403599
"Escambia County, Alabama",2015,37935,40.3,16435,2776,13659,32330,2.7772896991,0.0731778041387
"Escambia County, Florida",2009,303292,36.6,138196,20760,117436,43148,2.58261521169,0.0684488875407
"Escambia County, Florida",2012,298864,37.5,137117,25105,112012,43806,2.668142699,0.0840014187055
"Escambia County, Florida",2015,306327,37.2,138178,24518,113660,45390,2.69511701566,0.0800386515064
"Esmeralda County, Nevada",2009,849,54.5,860,412,448,44118,1.89508928571,0.485276796231
"Esmeralda County, Nevada",2012,916,51.8,928,414,514,27500,1.78210116732,0.451965065502
"Esmeralda County, Nevada",2015,1141,46.5,1003,520,483,39271,2.36231884058,0.45574057844
"Essex County, Massachusetts",2009,734889,39.8,298035,21538,276497,64280,2.65785523894,0.0293078274406
"Essex County, Massachusetts",2012,744961,40.4,306322,21178,285144,66918,2.6125782061,0.0284283338322
"Essex County, Massachusetts",2015,763849,40.6,307894,19982,287912,69068,2.65306413071,0.0261596205533
"Essex County, New Jersey",2009,771353,35.8,310379,31657,278722,54176,2.7674636376,0.0410408723373
"Essex County, New Jersey",2012,783840,36.3,312940,35487,277453,55027,2.82512713865,0.0452732700551
"Essex County, New Jersey",2015,791609,36.9,313824,35739,278085,53976,2.84664401172,0.0451472886236
"Essex County, New York",2009,37927,42.9,24380,8741,15639,44930,2.42515506107,0.230469058982
"Essex County, New York",2012,39309,44.6,25531,9333,16198,47400,2.42678108408,0.23742654354
"Essex County, New York",2015,38912,45.9,25678,10410,15268,52758,2.54859837569,0.267526726974
"Essex County, Vermont",2009,6436,43.9,4906,2165,2741,40046,2.34804815761,0.336389061529
"Essex County, Vermont",2012,6316,46.7,5020,2189,2831,37214,2.23101377605,0.346580113996
"Essex County, Vermont",2015,6207,48.8,5025,2324,2701,36599,2.29803776379,0.374415981956
"Essex County, Virginia",2009,10813,43.7,5655,1054,4601,46678,2.35014127364,0.0974752612596
"Essex County, Virginia",2012,11130,43.8,5763,1412,4351,42446,2.55803263618,0.126864330638
"Essex County, Virginia",2015,11151,44.8,5777,1445,4332,42760,2.57409972299,0.129584790602
"Estill County, Kentucky",2009,14880,38.8,7128,1345,5783,26390,2.57305896593,0.0903897849462
"Estill County, Kentucky",2012,14647,41.7,6879,1078,5801,28684,2.52490949836,0.0735986891514
"Estill County, Kentucky",2015,14476,42.7,6860,1110,5750,29770,2.51756521739,0.0766786405084
"Etowah County, Alabama",2009,103150,39.3,48304,5617,42687,36378,2.41642654672,0.0544546776539
"Etowah County, Alabama",2012,104317,40.2,47491,6931,40560,37660,2.57191814596,0.0664417113222
"Etowah County, Alabama",2015,103766,40.8,47500,7601,39899,39220,2.60071680995,0.0732513540081
"Eureka County, Nevada",2009,1387,38.9,1002,457,545,61472,2.54495412844,0.329488103821
"Eureka County, Nevada",2012,1809,38.5,1063,354,709,61331,2.5514809591,0.195688225539
"Eureka County, Nevada",2015,1669,43.9,1121,354,767,60250,2.17601043025,0.212103055722
"Evangeline Parish, Louisiana",2009,35490,34.6,15135,2406,12729,33445,2.78812161207,0.0677937447168
"Evangeline Parish, Louisiana",2012,33989,35.7,14691,2625,12066,32125,2.81692358694,0.0772308688105
"Evangeline Parish, Louisiana",2015,33768,35.8,14815,2861,11954,30009,2.82482850929,0.0847251836058
"Evans County, Georgia",2009,11446,36.3,4645,611,4034,37473,2.83738225087,0.0533810938319
"Evans County, Georgia",2012,10935,35.9,4654,532,4122,36602,2.65283842795,0.0486511202561
"Evans County, Georgia",2015,10814,35.3,4637,655,3982,37865,2.71572074335,0.0605696319586
"Fairbanks North Star Borough, Alaska",2009,96843,29.1,37720,5509,32211,65121,3.00651951197,0.0568858874673
"Fairbanks North Star Borough, Alaska",2012,97523,30.7,41371,5631,35740,69485,2.72867935087,0.0577402253827
"Fairbanks North Star Borough, Alaska",2015,99705,30.4,41697,6115,35582,71068,2.80211904896,0.0613309262324
"Fairfax County, Virginia",2009,1012751,37.1,391103,22864,368239,104259,2.75025459009,0.0225761317441
"Fairfax County, Virginia",2012,1083770,37.5,407349,18897,388452,109383,2.78997147653,0.0174363564225
"Fairfax County, Virginia",2015,1128722,37.4,409963,17608,392355,112552,2.87678760306,0.0155999440075
"Fairfax city, Virginia",2009,23369,39.6,8622,189,8433,96232,2.7711371991,0.00808763746844
"Fairfax city, Virginia",2012,22712,38.5,8690,171,8519,98563,2.6660406151,0.007529059528
"Fairfax city, Virginia",2015,23402,39.3,8780,313,8467,105297,2.7639069328,0.0133749252201
"Fairfield County, Connecticut",2009,892843,38.7,350491,24571,325920,81114,2.73945446735,0.0275199559161
"Fairfield County, Connecticut",2012,918892,39.5,360692,27724,332968,82614,2.75970063189,0.0301711191304
"Fairfield County, Connecticut",2015,939983,39.7,363556,29236,334320,84233,2.81162658531,0.031102690155
"Fairfield County, Ohio",2009,140842,37.1,55814,3840,51974,56955,2.70985492746,0.0272645943682
"Fairfield County, Ohio",2012,146138,38.2,58571,4269,54302,58971,2.69120842695,0.0292121145766
"Fairfield County, Ohio",2015,149112,39,59367,4335,55032,60567,2.7095508068,0.0290721068727
"Fairfield County, South Carolina",2009,23482,40.7,10958,2683,8275,32120,2.83770392749,0.114257729325
"Fairfield County, South Carolina",2012,23804,42.5,11640,2165,9475,35452,2.51229551451,0.0909511006554
"Fairfield County, South Carolina",2015,23108,44.1,11661,2671,8990,36004,2.57041156841,0.115587675264
"Fajardo Municipio, Puerto Rico",2009,42127,35.5,17422,4427,12995,19532,3.24178530204,0.105086998837
"Fajardo Municipio, Puerto Rico",2012,36857,37.5,17870,4865,13005,21194,2.83406382161,0.131996635646
"Fajardo Municipio, Puerto Rico",2015,34720,39.1,18641,5882,12759,19320,2.72121639627,0.169412442396
"Fall River County, South Dakota",2009,7240,50.5,3724,757,2967,38762,2.44017526121,0.10455801105
"Fall River County, South Dakota",2012,7028,51.2,4180,1070,3110,33703,2.25980707395,0.152248150256
"Fall River County, South Dakota",2015,6906,52.4,4171,1084,3087,45997,2.2371234208,0.156964958008
"Fallon County, Montana",2009,2657,44.5,1412,212,1200,53889,2.21416666667,0.0797892359804
"Fallon County, Montana",2012,3051,40.8,1474,243,1231,49732,2.47847278635,0.0796460176991
"Fallon County, Montana",2015,3057,39,1479,258,1221,53266,2.50368550369,0.0843964671246
"Falls Church city, Virginia",2009,11233,41,4710,580,4130,113313,2.71985472155,0.0516335796314
"Falls Church city, Virginia",2012,12300,36.9,5449,592,4857,122844,2.53242742434,0.0481300813008
"Falls Church city, Virginia",2015,13308,37.7,5601,435,5166,120522,2.57607433217,0.0326871055005
"Falls County, Texas",2009,17048,38.4,7873,1957,5916,30502,2.88167680865,0.114793524167
"Falls County, Texas",2012,17756,39,7726,1988,5738,33744,3.0944579993,0.111962153638
"Falls County, Texas",2015,17410,39.8,7725,2307,5418,36079,3.21336286453,0.132510051694
"Fannin County, Georgia",2009,22434,46.7,16342,5556,10786,36785,2.07991841276,0.247659802086
"Fannin County, Georgia",2012,23554,48.4,16254,6214,10040,35446,2.34601593625,0.263819308822
"Fannin County, Georgia",2015,23742,50.2,16482,6972,9510,37049,2.49652996845,0.293656810715
"Fannin County, Texas",2009,32884,39.9,13628,2284,11344,42423,2.89880112835,0.0694562705267
"Fannin County, Texas",2012,33867,40.4,14147,2364,11783,43382,2.87422557922,0.0698024625742
"Fannin County, Texas",2015,33748,41.3,14199,2225,11974,44071,2.81843995323,0.065929832879
"Faribault County, Minnesota",2009,14834,45.5,7291,746,6545,40548,2.26646294882,0.0502898746124
"Faribault County, Minnesota",2012,14546,45.9,7107,767,6340,43835,2.29432176656,0.0527292726523
"Faribault County, Minnesota",2015,14230,46.7,7055,681,6374,47540,2.23250705993,0.0478566408995
"Faulk County, South Dakota",2009,2276,46,1255,235,1020,35924,2.23137254902,0.103251318102
"Faulk County, South Dakota",2012,2374,45.6,1177,236,941,39714,2.52284803401,0.0994102780118
"Faulk County, South Dakota",2015,2359,46.9,1180,229,951,43679,2.48054679285,0.0970750317931
"Faulkner County, Arkansas",2009,104468,30.8,41895,3343,38552,44600,2.70979456319,0.0320002297354
"Faulkner County, Arkansas",2012,113730,31.4,46571,4246,42325,49008,2.68706438275,0.0373340367537
"Faulkner County, Arkansas",2015,119343,31.6,48478,5274,43204,51223,2.76231367466,0.0441919509313
"Fauquier County, Virginia",2009,66330,39.8,25555,2850,22705,82872,2.9213829553,0.0429669832655
"Fauquier County, Virginia",2012,65495,41,25672,2641,23031,88687,2.84377578047,0.0403236888312
"Fauquier County, Virginia",2015,67463,41.5,26052,2457,23595,91609,2.85920745921,0.0364199635356
"Fayette County, Alabama",2009,17651,40.7,8789,1375,7414,35754,2.38076611815,0.0778992691632
"Fayette County, Alabama",2012,17219,43.1,8450,1321,7129,33090,2.4153457708,0.0767175794181
"Fayette County, Alabama",2015,16896,43.2,8415,1378,7037,34680,2.40102316328,0.0815577651515
"Fayette County, Georgia",2009,105303,40.9,38775,2236,36539,81206,2.88193437149,0.021233962945
"Fayette County, Georgia",2012,106525,42.3,40743,2963,37780,81242,2.81961355214,0.0278150668857
"Fayette County, Georgia",2015,108655,43.3,41132,2597,38535,79066,2.81964447905,0.0239013391008
"Fayette County, Illinois",2009,21015,40.4,9352,1172,8180,39615,2.56907090465,0.0557696883179
"Fayette County, Illinois",2012,22082,39.7,9296,1105,8191,43724,2.69588572824,0.0500407571778
"Fayette County, Illinois",2015,22136,40.1,9234,1473,7761,43944,2.85220976678,0.0665431875678
"Fayette County, Indiana",2009,24313,39.8,11323,1212,10111,38060,2.40460884186,0.0498498745527
"Fayette County, Indiana",2012,24220,40.7,10915,1292,9623,36602,2.51688662579,0.0533443435178
"Fayette County, Indiana",2015,23773,42.2,10831,1495,9336,39379,2.54637960583,0.0628864678417
"Fayette County, Iowa",2009,20484,42.8,9719,1079,8640,39043,2.37083333333,0.0526752587385
"Fayette County, Iowa",2012,20894,42.3,9560,1014,8546,42995,2.44488649661,0.0485306786637
"Fayette County, Iowa",2015,20589,43.1,9554,998,8556,44928,2.40638148668,0.0484724853077
"Fayette County, Kentucky",2009,287537,33.4,130258,11706,118552,46874,2.42540825967,0.0407112823741
"Fayette County, Kentucky",2012,296766,33.8,134977,12184,122793,48779,2.4167990032,0.041055916109
"Fayette County, Kentucky",2015,308306,34.1,137885,12133,125752,49778,2.45169858133,0.0393537589278
"Fayette County, Ohio",2009,28205,38.4,12667,1012,11655,40249,2.41999141999,0.0358801630917
"Fayette County, Ohio",2012,28931,39.4,12679,1205,11474,38864,2.52143977689,0.0416508243752
"Fayette County, Ohio",2015,28769,41.1,12668,1079,11589,40503,2.48244024506,0.037505648441
"Fayette County, Pennsylvania",2009,143925,42,67427,8556,58871,34018,2.44475208507,0.0594476289734
"Fayette County, Pennsylvania",2012,136914,43.3,62976,8246,54730,38108,2.50162616481,0.060227588121
"Fayette County, Pennsylvania",2015,134851,44.2,62878,8881,53997,39636,2.49737948405,0.0658578727633
"Fayette County, Tennessee",2009,36820,39.9,13980,1422,12558,54577,2.93199554069,0.0386203150462
"Fayette County, Tennessee",2012,38370,41.8,15656,1244,14412,56297,2.66236469609,0.0324211623664
"Fayette County, Tennessee",2015,38814,43.7,16092,1246,14846,54890,2.61444160043,0.0321018189313
"Fayette County, Texas",2009,22620,45.7,11510,2120,9390,44031,2.4089456869,0.0937223695844
"Fayette County, Texas",2012,24557,47.2,13741,3271,10470,45478,2.34546322827,0.133200309484
"Fayette County, Texas",2015,24849,47.6,13854,4296,9558,47808,2.59981167608,0.172884220693
"Fayette County, West Virginia",2009,46240,40.8,22412,3525,18887,32579,2.44824482448,0.0762326989619
"Fayette County, West Virginia",2012,46000,42.3,21647,3914,17733,34891,2.59403372244,0.0850869565217
"Fayette County, West Virginia",2015,45534,43.2,21540,3871,17669,36293,2.57705586055,0.0850133965828
"Fentress County, Tennessee",2009,17412,41.2,7996,1354,6642,28407,2.62149954833,0.0777624626694
"Fentress County, Tennessee",2012,17945,42.4,8908,1518,7390,27773,2.42828146143,0.0845918083031
"Fentress County, Tennessee",2015,17931,44.2,8928,1624,7304,30259,2.45495618839,0.0905694049412
"Fergus County, Montana",2009,11218,46.5,5562,845,4717,36568,2.37820648717,0.0753253699412
"Fergus County, Montana",2012,11507,48.1,5828,908,4920,39276,2.33882113821,0.0789084904841
"Fergus County, Montana",2015,11468,47,5825,946,4879,40881,2.35048165608,0.0824904080921
"Ferry County, Washington",2009,7444,44.8,3972,1480,2492,36096,2.98715890851,0.198817839871
"Ferry County, Washington",2012,7584,47,4383,1506,2877,35742,2.63607924922,0.198575949367
"Ferry County, Washington",2015,7652,47.7,4396,1293,3103,38125,2.46600064454,0.16897543126
"Fillmore County, Minnesota",2009,20966,43.1,9697,1032,8665,45454,2.41961915753,0.0492225507965
"Fillmore County, Minnesota",2012,20880,42.9,9756,1231,8525,48717,2.44926686217,0.0589559386973
"Fillmore County, Minnesota",2015,20843,43,9813,1282,8531,51665,2.44320712695,0.0615074605383
"Fillmore County, Nebraska",2009,6051,45.2,2958,330,2628,42464,2.30251141553,0.0545364402578
"Fillmore County, Nebraska",2012,5867,45.9,2927,429,2498,45970,2.34867894315,0.0731208454065
"Fillmore County, Nebraska",2015,5697,47.5,2914,450,2464,52316,2.31209415584,0.0789889415482
"Finney County, Kansas",2009,41002,29.6,14017,1748,12269,48819,3.34191865678,0.0426320667285
"Finney County, Kansas",2012,36608,30.4,13300,1039,12261,49617,2.98572710219,0.0283817744755
"Finney County, Kansas",2015,37133,30.4,13290,690,12600,49227,2.94706349206,0.0185818544152
"Fisher County, Texas",2009,4028,45.1,2360,583,1777,37601,2.26674169949,0.144736842105
"Fisher County, Texas",2012,3963,42.1,2031,547,1484,42900,2.6704851752,0.138026747414
"Fisher County, Texas",2015,3858,41.9,2166,499,1667,41406,2.31433713257,0.129341627786
"Flagler County, Florida",2009,85623,47.7,47189,10471,36718,47573,2.33190805599,0.122291907548
"Flagler County, Florida",2012,95987,47.7,48400,12577,35823,48134,2.6794796639,0.131028160063
"Flagler County, Florida",2015,100783,49.6,49273,12323,36950,47866,2.72755074425,0.122272605499
"Flathead County, Montana",2009,86657,40,37775,6777,30998,45258,2.79556745596,0.0782048766978
"Flathead County, Montana",2012,90967,41.2,46537,9621,36916,45545,2.46416188103,0.105763628569
"Flathead County, Montana",2015,93333,42.1,47283,10177,37106,47851,2.51530749744,0.109039675142
"Fleming County, Kentucky",2009,14604,39,6402,850,5552,30352,2.63040345821,0.0582032319912
"Fleming County, Kentucky",2012,14415,39.9,6605,1137,5468,32677,2.63624725677,0.0788761706556
"Fleming County, Kentucky",2015,14544,40.4,6612,976,5636,35469,2.5805535841,0.0671067106711
"Florence County, South Carolina",2009,132153,36.9,54659,5470,49189,41142,2.6866372563,0.0413914175236
"Florence County, South Carolina",2012,136714,37.5,58489,6818,51671,41738,2.64585550889,0.0498705326448
"Florence County, South Carolina",2015,138330,38.2,59011,7164,51847,42080,2.66804250969,0.0517891997398
"Florence County, Wisconsin",2009,4721,47.3,4567,2461,2106,38250,2.24169040836,0.521287862741
"Florence County, Wisconsin",2012,4486,48.5,4657,2785,1872,44652,2.39636752137,0.620820329915
"Florence County, Wisconsin",2015,4476,51.1,4750,2846,1904,48643,2.35084033613,0.635835567471
"Florida Municipio, Puerto Rico",2009,15629,33.5,4599,728,3871,15769,4.03745802118,0.0465800755007
"Florida Municipio, Puerto Rico",2012,12657,35.5,4751,796,3955,16150,3.2002528445,0.0628901003397
"Florida Municipio, Puerto Rico",2015,12408,37.1,4912,548,4364,14994,2.84326306141,0.0441650548034
"Floyd County, Georgia",2009,95239,36.3,39894,4821,35073,41952,2.71545063154,0.0506200191098
"Floyd County, Georgia",2012,96204,37.7,40513,5563,34950,41442,2.75261802575,0.0578250384599
"Floyd County, Georgia",2015,96169,38,40458,5584,34874,41549,2.75761312152,0.0580644490428
"Floyd County, Indiana",2009,73031,38.3,31411,2739,28672,52242,2.54711914062,0.0375046213252
"Floyd County, Indiana",2012,74601,39.2,31969,2781,29188,53208,2.55587912841,0.0372783206659
"Floyd County, Indiana",2015,75900,39.6,32223,3135,29088,54914,2.60932343234,0.0413043478261
"Floyd County, Iowa",2009,16162,42.8,7451,809,6642,38673,2.43330322192,0.0500556861775
"Floyd County, Iowa",2012,16204,43.6,7520,607,6913,42386,2.34398958484,0.0374598864478
"Floyd County, Iowa",2015,16050,43.6,7524,623,6901,44797,2.32574989132,0.0388161993769
"Floyd County, Kentucky",2009,41965,38.4,19605,3210,16395,28479,2.55962183593,0.0764923150244
"Floyd County, Kentucky",2012,39454,39.9,18235,2633,15602,29237,2.52877836175,0.0667359456582
"Floyd County, Kentucky",2015,38649,40.5,18157,2739,15418,30096,2.50674536256,0.0708685865094
"Floyd County, Texas",2009,6683,39.4,3224,373,2851,31588,2.34408979306,0.0558132575191
"Floyd County, Texas",2012,6439,38.2,3009,411,2598,35323,2.47844495766,0.063829787234
"Floyd County, Texas",2015,6178,37.3,2999,586,2413,41026,2.56029838375,0.0948527031402
"Floyd County, Virginia",2009,14756,43.1,7441,1432,6009,40539,2.45564985855,0.0970452697208
"Floyd County, Virginia",2012,15268,44.2,7783,1707,6076,44038,2.51283739302,0.111802462667
"Floyd County, Virginia",2015,15523,45.2,7889,1618,6271,48005,2.47536278106,0.104232429298
"Fluvanna County, Virginia",2009,25162,39.9,10249,973,9276,62163,2.71259163433,0.0386694221445
"Fluvanna County, Virginia",2012,25749,41.1,10406,987,9419,71181,2.7337296953,0.0383315856926
"Fluvanna County, Virginia",2015,26014,41.6,10596,705,9891,63938,2.63006773835,0.0271007918813
"Foard County, Texas",2009,1324,42,868,276,592,24861,2.23648648649,0.208459214502
"Foard County, Texas",2012,1273,44.4,781,246,535,32443,2.37943925234,0.193244304792
"Foard County, Texas",2015,1197,49.1,821,314,507,36477,2.36094674556,0.262322472849
"Fond du Lac County, Wisconsin",2009,99336,39.2,42667,2773,39894,51768,2.48999849601,0.027915357977
"Fond du Lac County, Wisconsin",2012,101577,40.3,43880,2823,41057,53399,2.47404827435,0.0277917245046
"Fond du Lac County, Wisconsin",2015,101920,41,44326,3257,41069,55473,2.48167717743,0.0319564364207
"Ford County, Illinois",2009,13968,41.1,6234,628,5606,46141,2.49161612558,0.044959908362
"Ford County, Illinois",2012,14045,42.5,6265,633,5632,50203,2.49378551136,0.0450694197223
"Ford County, Illinois",2015,13835,42.7,6302,676,5626,49947,2.45911837895,0.0488615829418
"Ford County, Kansas",2009,32840,30.8,12068,1101,10967,45442,2.99443785903,0.0335261875761
"Ford County, Kansas",2012,33725,30.5,12032,1013,11019,50577,3.06062256103,0.0300370644922
"Ford County, Kansas",2015,34714,30.9,12081,876,11205,50777,3.09808121374,0.0252347755949
"Forest County, Pennsylvania",2009,6811,40.7,8926,6936,1990,34110,3.42261306533,1.01835266481
"Forest County, Pennsylvania",2012,7664,43.1,8761,6803,1958,36686,3.91419816139,0.8876565762
"Forest County, Pennsylvania",2015,7581,43.3,8698,6724,1974,35533,3.84042553191,0.886954227674
"Forest County, Wisconsin",2009,9764,43.6,8891,4587,4304,36425,2.26858736059,0.469786972552
"Forest County, Wisconsin",2012,9361,44,8987,5134,3853,40215,2.42953542694,0.54844567888
"Forest County, Wisconsin",2015,9150,45.3,9055,5245,3810,40636,2.40157480315,0.573224043716
"Forrest County, Mississippi",2009,78650,28.5,33141,3475,29666,33143,2.65118317266,0.0441830896376
"Forrest County, Mississippi",2012,75378,31.1,32269,4305,27964,35459,2.69553711915,0.0571121547401
"Forrest County, Mississippi",2015,76267,31.9,32481,4498,27983,36416,2.72547618197,0.0589770149606
"Forsyth County, Georgia",2009,157514,35.8,58668,4507,54161,88040,2.90825501745,0.0286133296088
"Forsyth County, Georgia",2012,177103,37,64312,7618,56694,87585,3.12384026528,0.043014516976
"Forsyth County, Georgia",2015,196236,38,69019,6724,62295,88816,3.15010835541,0.0342648647547
"Forsyth County, North Carolina",2009,346851,37.1,152743,16493,136250,47438,2.54569541284,0.0475506773802
"Forsyth County, North Carolina",2012,351368,37.3,156957,17924,139033,45809,2.5272273489,0.0510120443524
"Forsyth County, North Carolina",2015,361684,37.7,159748,16541,143207,45471,2.52560279875,0.045733292045
"Fort Bend County, Texas",2009,508099,34.6,149230,8688,140542,80638,3.61528226438,0.0170990299135
"Fort Bend County, Texas",2012,587666,35.1,196014,11832,184182,84211,3.19068095688,0.0201338855745
"Fort Bend County, Texas",2015,658331,35.5,216616,10428,206188,89152,3.19286767416,0.015840056142
"Foster County, North Dakota",2009,3424,46.6,1909,292,1617,40801,2.11750154607,0.0852803738318
"Foster County, North Dakota",2012,3368,45.7,1799,269,1530,49516,2.20130718954,0.0798693586698
"Foster County, North Dakota",2015,3366,46.9,1804,320,1484,55769,2.26819407008,0.0950683303624
"Fountain County, Indiana",2009,17075,41.8,7936,782,7154,43431,2.38677662846,0.0457979502196
"Fountain County, Indiana",2012,17212,42,7856,975,6881,45919,2.50138061328,0.0566465256798
"Fountain County, Indiana",2015,16888,42.3,7810,859,6951,46760,2.42957847792,0.0508645191852
"Franklin County, Alabama",2009,30847,38.1,14113,1741,12372,33380,2.49329130294,0.0564398482835
"Franklin County, Alabama",2012,31664,38.3,14023,1578,12445,37235,2.54431498594,0.0498357756443
"Franklin County, Alabama",2015,31634,38.8,14030,2050,11980,35372,2.64056761269,0.0648036922299
"Franklin County, Arkansas",2009,18037,41.2,8008,1208,6800,30991,2.6525,0.0669734434773
"Franklin County, Arkansas",2012,18110,40.8,8022,1338,6684,35918,2.70945541592,0.0738818332413
"Franklin County, Arkansas",2015,17866,40.4,8024,1240,6784,39285,2.6335495283,0.0694055748349
"Franklin County, Florida",2009,10998,43.3,8397,3892,4505,38436,2.44128745838,0.353882524095
"Franklin County, Florida",2012,11545,42.3,8639,4160,4479,37428,2.57758428221,0.360329146817
"Franklin County, Florida",2015,11628,42.1,8582,4244,4338,40401,2.68049792531,0.364981080151
"Franklin County, Georgia",2009,21701,39.2,9658,1729,7929,34725,2.73691512171,0.0796737477536
"Franklin County, Georgia",2012,22070,40,10508,1777,8731,32179,2.52777459627,0.0805165382873
"Franklin County, Georgia",2015,22110,40.9,10480,2047,8433,33816,2.62184276058,0.0925825418363
"Franklin County, Idaho",2009,12272,31.6,4352,333,4019,44753,3.0534958945,0.0271349413299
"Franklin County, Idaho",2012,12739,32,4531,433,4098,47598,3.10858955588,0.0339901091137
"Franklin County, Idaho",2015,12914,32.4,4631,395,4236,48133,3.04863078376,0.0305869598885
"Franklin County, Illinois",2009,39301,41.2,18492,2392,16100,33711,2.44105590062,0.0608635912572
"Franklin County, Illinois",2012,39518,41.8,18516,2434,16082,37158,2.45728143266,0.0615921858394
"Franklin County, Illinois",2015,39694,42.1,18586,2329,16257,39512,2.44165590207,0.0586738549907
"Franklin County, Indiana",2009,23074,39.1,9353,1056,8297,50937,2.7810051826,0.045765797001
"Franklin County, Indiana",2012,23108,39.9,9526,973,8553,50271,2.7017420788,0.0421066297386
"Franklin County, Indiana",2015,22935,41.2,9553,705,8848,51748,2.59211121157,0.0307390451275
"Franklin County, Iowa",2009,10594,42,4777,679,4098,44813,2.58516349439,0.0640928827638
"Franklin County, Iowa",2012,10650,43,4885,625,4260,49144,2.5,0.0586854460094
"Franklin County, Iowa",2015,10489,42.8,4865,607,4258,48605,2.46336308126,0.0578701496806
"Franklin County, Kansas",2009,26260,36.9,11217,973,10244,47767,2.56345177665,0.037052551409
"Franklin County, Kansas",2012,25916,38.6,11155,1047,10108,50240,2.56390977444,0.0403997530483
"Franklin County, Kansas",2015,25753,39,11114,1284,9830,51081,2.61983723296,0.0498582689395
"Franklin County, Kentucky",2009,48666,39.3,23000,1850,21150,48273,2.3009929078,0.0380142193729
"Franklin County, Kentucky",2012,49399,39.7,23104,2156,20948,47086,2.35817261791,0.0436446081904
"Franklin County, Kentucky",2015,49778,40.7,23252,2219,21033,47964,2.36666191223,0.0445779259914
"Franklin County, Maine",2009,29757,40.4,20304,8376,11928,39628,2.49471830986,0.281479987902
"Franklin County, Maine",2012,30704,43.3,21682,9439,12243,39416,2.50788205505,0.307419228765
"Franklin County, Maine",2015,30402,44.9,21886,10045,11841,42811,2.56751963517,0.330405894349
"Franklin County, Massachusetts",2009,71826,42.8,33095,3147,29948,52185,2.3983571524,0.0438142176928
"Franklin County, Massachusetts",2012,71489,44.3,33695,3223,30472,53298,2.34605539512,0.0450838590552
"Franklin County, Massachusetts",2015,71144,45.1,33646,3444,30202,55221,2.35560558903,0.0484088609018
"Franklin County, Mississippi",2009,8287,40.6,4353,1288,3065,34236,2.70375203915,0.15542415832
"Franklin County, Mississippi",2012,8055,41.4,4165,902,3263,31819,2.4685871897,0.111980136561
"Franklin County, Mississippi",2015,7857,43.2,4157,866,3291,38170,2.38742023701,0.110220185822
"Franklin County, Missouri",2009,99866,38,42895,4791,38104,49860,2.62087969767,0.0479742855426
"Franklin County, Missouri",2012,101440,39.4,43402,4364,39038,48322,2.5984937753,0.0430205047319
"Franklin County, Missouri",2015,101828,40.2,43733,3818,39915,48480,2.55112113241,0.0374945987351
"Franklin County, Nebraska",2009,3187,46.2,1728,362,1366,35259,2.33308931186,0.113586444933
"Franklin County, Nebraska",2012,3196,48.8,1718,336,1382,42054,2.31259044863,0.105131414268
"Franklin County, Nebraska",2015,3105,49.9,1720,311,1409,45905,2.20369056068,0.100161030596
"Franklin County, New York",2009,50374,39.3,24544,5749,18795,40587,2.68018089918,0.114126335014
"Franklin County, New York",2012,51698,39.3,25277,6107,19170,45702,2.69681794471,0.118128360865
"Franklin County, New York",2015,51280,39.8,25293,6145,19148,47923,2.67808648423,0.119832293292
"Franklin County, North Carolina",2009,57201,38.1,23901,2868,21033,43446,2.71958351162,0.0501389835842
"Franklin County, North Carolina",2012,60470,39.8,26445,3126,23319,42920,2.5931643724,0.0516950553994
"Franklin County, North Carolina",2015,62296,40.2,26788,3282,23506,42685,2.65021696588,0.0526839604469
"Franklin County, Ohio",2009,1124073,33.1,521006,67426,453580,49041,2.47822434852,0.0599836487488
"Franklin County, Ohio",2012,1167484,33.5,527886,63868,464018,50700,2.51603170567,0.0547056747673
"Franklin County, Ohio",2015,1215761,33.8,536811,55865,480946,52341,2.52785343885,0.0459506432597
"Franklin County, Pennsylvania",2009,141556,39.8,59799,3083,56716,50557,2.49587418013,0.0217793664698
"Franklin County, Pennsylvania",2012,149554,40.2,63106,5062,58044,52167,2.57656260768,0.0338473059898
"Franklin County, Pennsylvania",2015,152285,40.9,63947,5377,58570,53916,2.60005122076,0.0353087960075
"Franklin County, Tennessee",2009,41021,40.1,18832,2727,16105,41345,2.54709717479,0.0664781453402
"Franklin County, Tennessee",2012,40972,41.6,18713,2713,16000,41625,2.56075,0.0662159523577
"Franklin County, Tennessee",2015,41138,41.5,18900,2598,16302,42773,2.52349404981,0.0631532889299
"Franklin County, Texas",2009,10915,40.5,5436,1872,3564,42189,3.0625701459,0.171507100321
"Franklin County, Texas",2012,10593,42.5,5751,1544,4207,45684,2.51794628001,0.145756631738
"Franklin County, Texas",2015,10599,43.5,5779,1520,4259,41537,2.48861235032,0.143409755637
"Franklin County, Vermont",2009,47861,38.4,20935,2707,18228,52279,2.62568575817,0.0565596205679
"Franklin County, Vermont",2012,47853,39.6,21591,2962,18629,55051,2.56873691556,0.0618978956387
"Franklin County, Vermont",2015,48418,39.9,21886,3201,18685,58199,2.59127642494,0.066111776612
"Franklin County, Virginia",2009,51023,42.4,26099,4784,21315,45578,2.39376026273,0.0937616369088
"Franklin County, Virginia",2012,56012,44.3,29171,5619,23552,45049,2.37822690217,0.100317789045
"Franklin County, Virginia",2015,56315,45,29419,6230,23189,46870,2.42852214412,0.11062771908
"Franklin County, Washington",2009,69757,28.2,22091,1874,20217,45337,3.45041301875,0.0268646874149
"Franklin County, Washington",2012,78680,28.4,24585,1738,22847,51770,3.44377817657,0.0220894763599
"Franklin County, Washington",2015,86443,29.1,26029,1304,24725,56980,3.49617795753,0.0150850849693
"Franklin Parish, Louisiana",2009,19996,38.3,9043,1187,7856,31059,2.54531568228,0.0593618723745
"Franklin Parish, Louisiana",2012,20714,38.8,9033,1268,7765,32981,2.66761107534,0.0612146374433
"Franklin Parish, Louisiana",2015,20550,37.9,9091,1622,7469,30275,2.751372339,0.0789294403893
"Franklin city, Virginia",2009,8728,39.8,3974,379,3595,32060,2.42781641168,0.0434234647113
"Franklin city, Virginia",2012,8531,40.1,3911,379,3532,33447,2.41534541336,0.0444262102919
"Franklin city, Virginia",2015,8457,38,3888,435,3453,32399,2.44917463076,0.0514366796736
"Frederick County, Maryland",2009,224185,37.5,85781,4507,81274,80970,2.75838521544,0.0201039320204
"Frederick County, Maryland",2012,234268,38.5,90215,4656,85559,83706,2.73808716792,0.0198746734509
"Frederick County, Maryland",2015,241373,39.1,92708,4214,88494,83700,2.72756345063,0.0174584564139
"Frederick County, Virginia",2009,72120,37.8,28960,1736,27224,62291,2.64913311784,0.0240709927898
"Frederick County, Virginia",2012,78397,39.2,31341,2195,29146,67694,2.68980306045,0.0279985203515
"Frederick County, Virginia",2015,81340,40.1,32152,2697,29455,69098,2.76150059413,0.033157118269
"Fredericksburg city, Virginia",2009,22314,29.4,9732,829,8903,43154,2.50634617545,0.0371515640405
"Fredericksburg city, Virginia",2012,24932,28.8,10603,898,9705,45951,2.56898505925,0.0360179688753
"Fredericksburg city, Virginia",2015,27395,29.4,11252,1172,10080,51762,2.71775793651,0.0427815294762
"Freeborn County, Minnesota",2009,31211,43.7,14172,1092,13080,44018,2.38616207951,0.0349876646054
"Freeborn County, Minnesota",2012,31188,44.4,14219,922,13297,43962,2.34549146424,0.0295626523022
"Freeborn County, Minnesota",2015,30897,44.6,14192,1199,12993,47105,2.37797275456,0.0388063566042
"Freestone County, Texas",2009,18936,38.2,8689,1845,6844,44303,2.76680303916,0.097433460076
"Freestone County, Texas",2012,19631,41.4,9236,2208,7028,45510,2.79325554923,0.112475166828
"Freestone County, Texas",2015,19586,41.4,9286,1880,7406,44301,2.64461247637,0.0959869294394
"Fremont County, Colorado",2009,47393,42.2,19190,2227,16963,37852,2.79390438012,0.0469900618235
"Fremont County, Colorado",2012,47006,43,19232,2032,17200,40893,2.73290697674,0.0432285240182
"Fremont County, Colorado",2015,46809,43.5,19240,2898,16342,40423,2.86433729042,0.0619111709287
"Fremont County, Idaho",2009,12537,31.8,7799,3431,4368,43486,2.87019230769,0.273669936987
"Fremont County, Idaho",2012,13123,33.8,8495,3912,4583,43053,2.86340824787,0.29810256801
"Fremont County, Idaho",2015,12945,36.3,8626,4149,4477,47988,2.89144516417,0.320509849363
"Fremont County, Iowa",2009,7488,44.9,3582,403,3179,45197,2.3554576911,0.0538194444444
"Fremont County, Iowa",2012,7373,45.4,3439,386,3053,49245,2.41500163773,0.0523531805235
"Fremont County, Iowa",2015,7106,46.4,3432,478,2954,53324,2.40555179418,0.0672670982269
"Fremont County, Wyoming",2009,37432,38.2,16273,1784,14489,43872,2.58347712057,0.0476597563582
"Fremont County, Wyoming",2012,40103,38.3,17710,2172,15538,48565,2.58096280088,0.0541605366182
"Fremont County, Wyoming",2015,40755,38.2,17723,2393,15330,52773,2.65851272016,0.0587167218746
"Fresno County, California",2009,890750,30.3,302935,24410,278525,46230,3.19809711875,0.0274038731406
"Fresno County, California",2012,930517,30.7,315544,28462,287082,45741,3.24129342836,0.0305872971692
"Fresno County, California",2015,956749,31.4,321955,25650,296305,45233,3.22893302509,0.0268095393881
"Frio County, Texas",2009,16136,32.4,5917,1256,4661,34531,3.46191804334,0.0778383738225
"Frio County, Texas",2012,17265,31.8,5854,1023,4831,38161,3.5737942455,0.0592528236316
"Frio County, Texas",2015,18168,31.5,5872,1078,4794,36404,3.78973717146,0.059335094672
"Frontier County, Nebraska",2009,2643,43.2,1576,389,1187,41676,2.22662173547,0.147181233447
"Frontier County, Nebraska",2012,2693,44.8,1565,457,1108,51328,2.43050541516,0.169699220201
"Frontier County, Nebraska",2015,2573,44.4,1538,454,1084,49634,2.37361623616,0.176447726389
"Fulton County, Arkansas",2009,11700,46.1,6272,1811,4461,30771,2.62273032952,0.154786324786
"Fulton County, Arkansas",2012,12301,46.9,6751,1886,4865,35059,2.52846865365,0.153320868222
"Fulton County, Arkansas",2015,12224,48,6770,1470,5300,37066,2.30641509434,0.120255235602
"Fulton County, Georgia",2009,987148,34,425921,70469,355452,58573,2.77716259861,0.0713864587681
"Fulton County, Georgia",2012,929535,34.2,437502,71362,366140,57664,2.53874201125,0.0767717191929
"Fulton County, Georgia",2015,983903,34.8,444761,64804,379957,57207,2.58951144472,0.0658642162896
"Fulton County, Illinois",2009,36860,41.8,16497,1620,14877,40681,2.47765006386,0.043950081389
"Fulton County, Illinois",2012,36989,42.3,16210,1545,14665,43363,2.52226389362,0.0417691746195
"Fulton County, Illinois",2015,36323,42.2,16167,1792,14375,46083,2.5268173913,0.04933513201
"Fulton County, Indiana",2009,20251,40.7,9638,1207,8431,41483,2.40196892421,0.0596019949632
"Fulton County, Indiana",2012,20762,40.3,9703,1266,8437,40910,2.46082730828,0.0609767845102
"Fulton County, Indiana",2015,20527,41.7,9663,1700,7963,45332,2.57779731257,0.0828177522288
"Fulton County, Kentucky",2009,6918,42.8,3764,623,3141,28973,2.20248328558,0.0900549291703
"Fulton County, Kentucky",2012,6758,42.8,3386,425,2961,36813,2.28233704829,0.0628884285292
"Fulton County, Kentucky",2015,6422,42.8,3360,792,2568,28359,2.5007788162,0.123326066646
"Fulton County, New York",2009,55031,41.8,28165,5614,22551,41425,2.44029089619,0.102015227781
"Fulton County, New York",2012,55358,41.7,28525,6014,22511,45333,2.45915330283,0.108638317858
"Fulton County, New York",2015,54606,42.8,28617,6336,22281,46969,2.45078766662,0.116031205362
"Fulton County, Ohio",2009,42482,39.2,17248,1055,16193,50262,2.62347928117,0.0248340473612
"Fulton County, Ohio",2012,42635,39.6,17370,1012,16358,53039,2.60636997188,0.0237363668348
"Fulton County, Ohio",2015,42485,39.8,17368,1139,16229,55120,2.61784459917,0.0268094621631
"Fulton County, Pennsylvania",2009,14808,40.4,7299,1648,5651,44517,2.6204211644,0.111291193949
"Fulton County, Pennsylvania",2012,14829,42,7140,1167,5973,47470,2.48267202411,0.0786971474813
"Fulton County, Pennsylvania",2015,14694,43.2,7104,1144,5960,48311,2.46543624161,0.0778549067647
"Furnas County, Nebraska",2009,4681,46.9,2809,587,2222,38406,2.10666066607,0.125400555437
"Furnas County, Nebraska",2012,4922,47.1,2715,538,2177,40759,2.2609095085,0.109305160504
"Furnas County, Nebraska",2015,4887,46.8,2712,436,2276,39934,2.14718804921,0.0892162881113
"Gadsden County, Florida",2009,46725,37.6,18938,2906,16032,35423,2.91448353293,0.0621936864633
"Gadsden County, Florida",2012,46823,38.9,19476,2868,16608,35593,2.8193039499,0.0612519488286
"Gadsden County, Florida",2015,46424,40.2,19452,2488,16964,35567,2.736618722,0.0535929691539
"Gage County, Nebraska",2009,22935,42.5,10507,1084,9423,41569,2.43393823623,0.0472640069762
"Gage County, Nebraska",2012,22209,43.6,10434,1407,9027,46164,2.46028580924,0.0633526948534
"Gage County, Nebraska",2015,21818,44.6,10419,1179,9240,50010,2.36125541126,0.0540379503163
"Gaines County, Texas",2009,14840,30.7,5596,654,4942,47808,3.00283286119,0.0440700808625
"Gaines County, Texas",2012,17572,29.2,6267,865,5402,50850,3.25286930766,0.0492260414295
"Gaines County, Texas",2015,18916,28.9,6340,725,5615,57635,3.36883348175,0.0383273419328
"Galax city, Virginia",2009,6806,48.1,3623,245,3378,22105,2.01480165779,0.0359976491331
"Galax city, Virginia",2012,6942,44.7,3836,482,3354,24059,2.06976744186,0.069432440219
"Galax city, Virginia",2015,6876,45.6,3514,553,2961,30604,2.32218844985,0.0804246655032
"Gallatin County, Illinois",2009,5921,41.9,3192,417,2775,33954,2.13369369369,0.070427292687
"Gallatin County, Illinois",2012,5592,45,2765,401,2364,38934,2.3654822335,0.0717095851216
"Gallatin County, Illinois",2015,5385,45.1,2736,328,2408,39636,2.23629568106,0.0609099350046
"Gallatin County, Kentucky",2009,8090,39.1,3637,791,2846,40700,2.84258608573,0.0977750309023
"Gallatin County, Kentucky",2012,8513,39.4,3790,771,3019,43860,2.81980788341,0.0905673675555
"Gallatin County, Kentucky",2015,8567,37.8,3829,732,3097,48370,2.7662253794,0.0854441461422
"Gallatin County, Montana",2009,86532,30,36973,4075,32898,49343,2.63031187306,0.0470924051218
"Gallatin County, Montana",2012,90339,32.4,42205,5546,36659,52211,2.46430617311,0.0613909828535
"Gallatin County, Montana",2015,95323,33.2,43996,5704,38292,55553,2.48937114802,0.0598386538401
"Gallia County, Ohio",2009,30837,38.7,13438,1576,11862,36675,2.59964592817,0.0511074358725
"Gallia County, Ohio",2012,30877,39.8,13892,2007,11885,39399,2.59798064788,0.0649998380672
"Gallia County, Ohio",2015,30565,41,13820,2230,11590,37319,2.63718723037,0.0729592671356
"Galveston County, Texas",2009,282440,36.7,130739,23606,107133,54398,2.63634921079,0.0835788131993
"Galveston County, Texas",2012,292874,37.3,133207,24065,109142,61555,2.68342159755,0.0821684410361
"Galveston County, Texas",2015,308163,37.5,138023,24157,113866,62313,2.70636537685,0.078390332389
"Garden County, Nebraska",2009,1856,51.8,1236,379,857,33692,2.16569428238,0.204202586207
"Garden County, Nebraska",2012,2011,51.4,1344,475,869,40125,2.31415420023,0.236200895077
"Garden County, Nebraska",2015,1823,52.3,1322,477,845,45845,2.1573964497,0.261656609984
"Garfield County, Colorado",2009,52878,34.5,21281,2127,19154,64837,2.76067662107,0.0402246681039
"Garfield County, Colorado",2012,56330,34.7,23177,2905,20272,60215,2.77870955012,0.0515710988816
"Garfield County, Colorado",2015,57076,35.9,23338,2716,20622,56590,2.76772379013,0.04758567524
"Garfield County, Montana",2009,1135,45.8,925,412,513,32880,2.21247563353,0.362995594714
"Garfield County, Montana",2012,1100,48,853,386,467,40125,2.35546038544,0.350909090909
"Garfield County, Montana",2015,1047,46.5,835,398,437,39732,2.39588100686,0.380133715377
"Garfield County, Nebraska",2009,1902,47.9,1051,183,868,35455,2.19124423963,0.096214511041
"Garfield County, Nebraska",2012,2106,49.1,1162,280,882,39241,2.38775510204,0.132953466287
"Garfield County, Nebraska",2015,1933,51.4,1191,288,903,43179,2.14064230343,0.14899120538
"Garfield County, Oklahoma",2009,57700,37.6,26896,3430,23466,40720,2.45887667263,0.059445407279
"Garfield County, Oklahoma",2012,60272,37.5,26809,2950,23859,43458,2.52617460916,0.0489447836475
"Garfield County, Oklahoma",2015,62192,36.2,26856,2919,23937,48238,2.59815348623,0.0469352971443
"Garfield County, Utah",2009,4488,39.3,3271,1337,1934,44861,2.32057911065,0.297905525847
"Garfield County, Utah",2012,5107,40.8,3708,1713,1995,44345,2.55989974937,0.335421969845
"Garfield County, Utah",2015,5069,39.6,3794,2043,1751,42614,2.89491719018,0.403038074571
"Garfield County, Washington",2009,2129,48.3,1250,330,920,40135,2.31413043478,0.15500234852
"Garfield County, Washington",2012,2246,52.6,1332,331,1001,51325,2.24375624376,0.147373107747
"Garfield County, Washington",2015,2230,49.8,1239,286,953,45855,2.33997901364,0.128251121076
"Garland County, Arkansas",2009,96285,44.2,47052,8372,38680,36454,2.48927094105,0.0869501999273
"Garland County, Arkansas",2012,96249,44.2,50384,10593,39791,38680,2.41886356211,0.11005828632
"Garland County, Arkansas",2015,96954,44.1,50518,10228,40290,38733,2.40640357409,0.105493326732
"Garrard County, Kentucky",2009,16829,39.2,6721,949,5772,37112,2.91562716563,0.0563907540555
"Garrard County, Kentucky",2012,16892,41.7,7412,1173,6239,44115,2.70748517391,0.0694411555766
"Garrard County, Kentucky",2015,16976,41.8,7473,879,6594,44243,2.57446163179,0.0517789820924
"Garrett County, Maryland",2009,29631,41.4,18817,6011,12806,43802,2.31383726378,0.202861867639
"Garrett County, Maryland",2012,30079,42.9,18850,6496,12354,45354,2.43475797313,0.215964626484
"Garrett County, Maryland",2015,29813,44.5,19022,7159,11863,45432,2.5131079828,0.240130144568
"Garvin County, Oklahoma",2009,27027,39.7,12954,2768,10186,35972,2.65334773218,0.102416102416
"Garvin County, Oklahoma",2012,27471,39.7,12830,2562,10268,38356,2.67539929879,0.0932619853664
"Garvin County, Oklahoma",2015,27455,39.5,12815,2284,10531,40524,2.60706485614,0.0831906756511
"Garza County, Texas",2009,4743,33.8,1491,289,1202,31200,3.9459234609,0.0609318996416
"Garza County, Texas",2012,6295,38.4,2156,497,1659,41750,3.79445449066,0.0789515488483
"Garza County, Texas",2015,6410,39.4,2040,508,1532,48508,4.18407310705,0.0792511700468
"Gasconade County, Missouri",2009,15327,43.3,8148,1623,6525,40196,2.34896551724,0.105891563907
"Gasconade County, Missouri",2012,15160,45.1,8186,1876,6310,41304,2.40253565769,0.123746701847
"Gasconade County, Missouri",2015,14948,45.6,8164,1918,6246,42826,2.39321165546,0.128311479797
"Gaston County, North Carolina",2009,202149,37.8,87339,10127,77212,42110,2.61810340362,0.050096710842
"Gaston County, North Carolina",2012,206291,38.8,88675,9441,79234,43220,2.60356665068,0.0457654478382
"Gaston County, North Carolina",2015,209807,39.8,89702,10536,79166,42429,2.65021600182,0.0502175809196
"Gates County, North Carolina",2009,11555,41.6,4644,643,4001,47217,2.888027993,0.0556469061013
"Gates County, North Carolina",2012,12069,42.4,5177,723,4454,45136,2.70969914683,0.059905543127
"Gates County, North Carolina",2015,11724,43.2,5225,823,4402,49258,2.6633348478,0.070197884681
"Geary County, Kansas",2009,29951,28.2,12618,2161,10457,43890,2.86420579516,0.0721511802611
"Geary County, Kansas",2012,34110,27.4,14538,2358,12180,47879,2.80049261084,0.0691292875989
"Geary County, Kansas",2015,36787,26.2,15009,2286,12723,43992,2.8913778197,0.0621415173839
"Geauga County, Ohio",2009,98143,41.9,35458,1889,33569,67596,2.92362000655,0.0192474246762
"Geauga County, Ohio",2012,93485,43.3,36497,1873,34624,66127,2.70000577634,0.0200352997807
"Geauga County, Ohio",2015,93874,44.2,36683,1909,34774,72430,2.69954563755,0.0203357692226
"Gem County, Idaho",2009,16355,41.2,6720,422,6298,41847,2.59685614481,0.0258025068786
"Gem County, Idaho",2012,16768,42.2,7077,621,6456,41976,2.59727385378,0.0370348282443
"Gem County, Idaho",2015,16731,44.7,7103,792,6311,40828,2.65108540643,0.0473372781065
"Genesee County, Michigan",2009,432720,37.3,197144,24037,173107,44376,2.49972560324,0.0555486226659
"Genesee County, Michigan",2012,425337,38.4,192240,25854,166386,42730,2.55632685442,0.0607847424513
"Genesee County, Michigan",2015,415874,39.6,191178,25910,165268,42327,2.51636130406,0.0623025243223
"Genesee County, New York",2009,58208,41.1,24571,1363,23208,48197,2.50810065495,0.0234160252886
"Genesee County, New York",2012,59992,41.6,25537,1575,23962,51734,2.50363074869,0.0262535004667
"Genesee County, New York",2015,59458,42.7,25636,1698,23938,50880,2.48383323586,0.0285579736957
"Geneva County, Alabama",2009,25800,42.1,12481,2071,10410,31055,2.47838616715,0.0802713178295
"Geneva County, Alabama",2012,26769,42.2,12670,1685,10985,33618,2.43686845699,0.0629459449363
"Geneva County, Alabama",2015,26815,42.2,12658,1904,10754,36024,2.49349079412,0.0710050344956
"Gentry County, Missouri",2009,6249,44,3275,612,2663,35539,2.34660157717,0.0979356697072
"Gentry County, Missouri",2012,6773,42.1,3212,461,2751,38465,2.46201381316,0.0680643732467
"Gentry County, Missouri",2015,6785,41.4,3205,457,2748,41912,2.46906841339,0.067354458364
"George County, Mississippi",2009,21926,33.5,8000,936,7064,46849,3.10390713477,0.0426890449694
"George County, Mississippi",2012,22579,36.3,9273,1242,8031,46263,2.81148051301,0.0550068647859
"George County, Mississippi",2015,23104,36.4,9355,1884,7471,44258,3.09249096506,0.0815443213296
"Georgetown County, South Carolina",2009,60235,43.1,33046,10954,22092,42283,2.72655259823,0.181854403586
"Georgetown County, South Carolina",2012,60285,45.6,33681,11320,22361,42472,2.6959885515,0.187774736667
"Georgetown County, South Carolina",2015,60572,47.5,33930,10364,23566,42835,2.57031316303,0.171102159414
"Gibson County, Indiana",2009,32834,39.8,15159,1852,13307,45426,2.46742316074,0.0564049460925
"Gibson County, Indiana",2012,33437,40.2,14657,1609,13048,48524,2.56261496015,0.0481203457248
"Gibson County, Indiana",2015,33668,40,14696,1594,13102,48303,2.56968401771,0.0473446596174
"Gibson County, Tennessee",2009,48586,40.3,22472,2040,20432,34050,2.37793657009,0.0419874037789
"Gibson County, Tennessee",2012,49594,40.1,22060,2681,19379,36981,2.55916197946,0.054058958745
"Gibson County, Tennessee",2015,49572,40.4,22286,2837,19449,38457,2.54881999075,0.0572298878399
"Gila County, Arizona",2009,51850,46.5,30573,11494,19079,36930,2.71764767545,0.221677917068
"Gila County, Arizona",2012,53436,47.8,32644,12399,20245,38504,2.63946653495,0.232034583427
"Gila County, Arizona",2015,53165,48.6,32952,12043,20909,39751,2.5426849682,0.226521207561
"Gilchrist County, Florida",2009,16771,38.3,6539,1070,5469,41048,3.0665569574,0.0638006081927
"Gilchrist County, Florida",2012,16880,39.7,7250,1287,5963,36521,2.83078987087,0.0762440758294
"Gilchrist County, Florida",2015,16992,42,7253,1066,6187,40623,2.7464037498,0.0627354048964
"Giles County, Tennessee",2009,29075,41.4,13797,2098,11699,39228,2.48525515001,0.0721582115219
"Giles County, Tennessee",2012,29439,42.2,13849,2177,11672,38014,2.52218985607,0.0739495227419
"Giles County, Tennessee",2015,28949,42.9,13831,2534,11297,41093,2.5625387271,0.087533248126
"Giles County, Virginia",2009,17193,41.7,8162,1223,6939,39963,2.47773454388,0.0711336008841
"Giles County, Virginia",2012,17149,43,8301,1175,7126,45231,2.40653943306,0.0685171147006
"Giles County, Virginia",2015,16907,43.9,8327,1097,7230,46390,2.33845089903,0.0648843674218
"Gillespie County, Texas",2009,23488,49,10850,1487,9363,52403,2.50859767169,0.0633089237057
"Gillespie County, Texas",2012,24777,49.8,12662,1968,10694,55017,2.31690667664,0.07942850224
"Gillespie County, Texas",2015,25398,50.6,12868,2291,10577,54859,2.40124799092,0.0902039530672
"Gilliam County, Oregon",2009,1623,48,1065,249,816,42115,1.98897058824,0.153419593346
"Gilliam County, Oregon",2012,1904,50.2,1173,279,894,45833,2.12975391499,0.146533613445
"Gilliam County, Oregon",2015,1883,48.2,1073,240,833,44293,2.26050420168,0.127456186936
"Gilmer County, Georgia",2009,28381,39.5,16219,4128,12091,34325,2.34728310313,0.145449420387
"Gilmer County, Georgia",2012,28232,42.9,16547,5277,11270,37257,2.50505767524,0.186915556815
"Gilmer County, Georgia",2015,28673,45.1,16629,5644,10985,40228,2.61019572144,0.196840232972
"Gilmer County, West Virginia",2009,6889,39.2,3167,960,2207,24544,3.12143180788,0.139352591087
"Gilmer County, West Virginia",2012,8623,38.8,3461,922,2539,35524,3.39621898385,0.106923344544
"Gilmer County, West Virginia",2015,8644,38.4,3459,715,2744,37536,3.15014577259,0.0827163350301
"Gilpin County, Colorado",2009,5177,43.1,3399,1017,2382,55455,2.17338371117,0.196445818041
"Gilpin County, Colorado",2012,5358,44.5,3441,983,2458,62286,2.17982099268,0.183463979097
"Gilpin County, Colorado",2015,5605,44.7,3648,1072,2576,65670,2.17585403727,0.191257805531
"Glacier County, Montana",2009,13411,30.9,5257,957,4300,41009,3.1188372093,0.0713593318917
"Glacier County, Montana",2012,13422,31.4,5342,1097,4245,36872,3.16183745583,0.0817314856206
"Glacier County, Montana",2015,13672,31.3,5328,1106,4222,29640,3.23827569872,0.0808952603862
"Glades County, Florida",2009,11070,42.2,6124,2419,3705,39260,2.98785425101,0.218518518519
"Glades County, Florida",2012,12952,43.4,6915,3170,3745,35219,3.45847797063,0.244749845584
"Glades County, Florida",2015,13272,45.3,6865,2945,3920,34877,3.38571428571,0.221895720313
"Gladwin County, Michigan",2009,26273,46.2,18288,6545,11743,37289,2.23733287916,0.249115061089
"Gladwin County, Michigan",2012,25736,47.5,17717,6606,11111,38571,2.31626316263,0.25668324526
"Gladwin County, Michigan",2015,25501,48.9,17642,6682,10960,38021,2.32673357664,0.262028940042
"Glascock County, Georgia",2009,2736,38.5,1230,194,1036,34036,2.64092664093,0.0709064327485
"Glascock County, Georgia",2012,3082,39.4,1494,312,1182,32346,2.60744500846,0.101232965607
"Glascock County, Georgia",2015,3087,40,1506,385,1121,40759,2.75379125781,0.124716553288
"Glasscock County, Texas",2009,1408,38.4,679,199,480,54000,2.93333333333,0.141335227273
"Glasscock County, Texas",2012,1255,39.8,638,207,431,76563,2.91183294664,0.164940239044
"Glasscock County, Texas",2015,1180,38.8,557,126,431,67303,2.73781902552,0.106779661017
"Glenn County, California",2009,27891,34.5,10677,1119,9558,40973,2.91807909605,0.0401204689685
"Glenn County, California",2012,28078,36.5,10781,1241,9540,42641,2.94318658281,0.0441983047226
"Glenn County, California",2015,28029,37.2,10893,1396,9497,39349,2.95135305886,0.0498055585287
"Gloucester County, New Jersey",2009,284552,37.8,106284,5604,100680,71883,2.82630115217,0.0196941156625
"Gloucester County, New Jersey",2012,288187,38.7,109884,5793,104091,74915,2.76860631563,0.0201015312974
"Gloucester County, New Jersey",2015,290298,39.6,111445,7177,104268,76727,2.78415237657,0.0247228709809
"Gloucester County, Virginia",2009,38229,41.5,16229,1640,14589,56830,2.6203989307,0.0428993695885
"Gloucester County, Virginia",2012,36821,41.9,15900,2026,13874,60752,2.65395704195,0.0550229488607
"Gloucester County, Virginia",2015,37001,43.6,16066,1786,14280,61121,2.59110644258,0.0482689657036
"Glynn County, Georgia",2009,74507,38.7,37964,8822,29142,48785,2.5566879418,0.118404982082
"Glynn County, Georgia",2012,79628,40,40673,9536,31137,49986,2.55734335357,0.119756869443
"Glynn County, Georgia",2015,81743,40.5,41471,9160,32311,45918,2.52988146452,0.112058524889
"Gogebic County, Michigan",2009,16193,45.4,11075,3725,7350,32692,2.2031292517,0.230037670598
"Gogebic County, Michigan",2012,16297,46.8,10807,3573,7234,34397,2.2528338402,0.219242805424
"Gogebic County, Michigan",2015,15824,48.3,10749,4008,6741,35686,2.34742619789,0.253286147624
"Golden Valley County, Montana",2009,873,46.4,469,109,360,36029,2.425,0.124856815578
"Golden Valley County, Montana",2012,769,50.2,481,157,324,38289,2.37345679012,0.204161248375
"Golden Valley County, Montana",2015,756,53.1,456,136,320,40938,2.3625,0.179894179894
"Golden Valley County, North Dakota",2009,1533,44.5,987,239,748,29226,2.04946524064,0.155903457273
"Golden Valley County, North Dakota",2012,1646,43,955,218,737,35742,2.23337856174,0.132442284326
"Golden Valley County, North Dakota",2015,1822,41,978,175,803,40179,2.26899128269,0.096048298573
"Goliad County, Texas",2009,7006,43.5,3595,733,2862,50486,2.44793850454,0.104624607479
"Goliad County, Texas",2012,7223,44.6,3711,655,3056,50635,2.36354712042,0.0906825418801
"Goliad County, Texas",2015,7410,45.8,3719,838,2881,51226,2.57202360292,0.113090418354
"Gonzales County, Texas",2009,19510,36,8481,1368,7113,37103,2.74286517644,0.0701178882624
"Gonzales County, Texas",2012,19773,36.9,8788,1984,6804,39115,2.90608465608,0.100338845901
"Gonzales County, Texas",2015,20172,38.1,8790,2313,6477,42983,3.11440481704,0.114663890541
"Goochland County, Virginia",2009,20429,42.8,6698,646,6052,75581,3.37557832122,0.0316217142298
"Goochland County, Virginia",2012,21496,45.3,8600,691,7909,82683,2.71791629789,0.0321455154447
"Goochland County, Virginia",2015,21721,47.2,8807,659,8148,79330,2.66580756014,0.0303393029787
"Goodhue County, Minnesota",2009,45605,40.7,19943,1410,18533,55632,2.46074569687,0.030917662537
"Goodhue County, Minnesota",2012,46144,41.9,20320,1630,18690,55603,2.46891385768,0.0353242024965
"Goodhue County, Minnesota",2015,46377,43,20351,1558,18793,57062,2.46778055659,0.0335942385234
"Gooding County, Idaho",2009,14320,36.7,5996,595,5401,37732,2.6513608591,0.0415502793296
"Gooding County, Idaho",2012,15327,35,6078,542,5536,37910,2.76860549133,0.035362432309
"Gooding County, Idaho",2015,15233,36.3,6059,732,5327,39930,2.85958325512,0.0480535679118
"Gordon County, Georgia",2009,51760,34.8,20804,2151,18653,40283,2.77488875784,0.041557187017
"Gordon County, Georgia",2012,55192,36,22206,3012,19194,40661,2.87548192143,0.0545731265401
"Gordon County, Georgia",2015,55889,37,22220,2681,19539,41612,2.8603818005,0.0479700835585
"Goshen County, Wyoming",2009,12137,43.9,5997,851,5146,39665,2.35853089778,0.0701161736838
"Goshen County, Wyoming",2012,13277,42.8,5952,675,5277,43401,2.51601288611,0.0508397981472
"Goshen County, Wyoming",2015,13544,42.9,5952,568,5384,42689,2.51560178306,0.0419373892499
"Gosper County, Nebraska",2009,1932,46.4,1233,435,798,43487,2.42105263158,0.225155279503
"Gosper County, Nebraska",2012,2020,45.4,1242,458,784,44241,2.57653061224,0.226732673267
"Gosper County, Nebraska",2015,1976,46.7,1251,462,789,54375,2.50443599493,0.233805668016
"Gove County, Kansas",2009,2599,48.5,1382,231,1151,38701,2.25803649001,0.0888803385918
"Gove County, Kansas",2012,2771,48.2,1399,222,1177,44426,2.35429056924,0.0801154817755
"Gove County, Kansas",2015,2735,47.4,1383,193,1190,46364,2.29831932773,0.0705667276051
"Grady County, Georgia",2009,24801,36.4,10633,1187,9446,34025,2.62555579081,0.0478609733478
"Grady County, Georgia",2012,25068,38.2,10737,1169,9568,32206,2.61998327759,0.0466331578108
"Grady County, Georgia",2015,25243,39.1,10717,1447,9270,34187,2.72308522114,0.0573228221685
"Grady County, Oklahoma",2009,50434,37.1,20589,2368,18221,44415,2.76790516437,0.0469524527105
"Grady County, Oklahoma",2012,52451,38.2,22135,2463,19672,48963,2.66627694185,0.0469581132867
"Grady County, Oklahoma",2015,53612,38.5,22437,2848,19589,52279,2.73684210526,0.0531224352757
"Grafton County, New Hampshire",2009,85626,39.6,47056,14743,32313,52691,2.64989323183,0.172179011048
"Grafton County, New Hampshire",2012,88985,41.2,50998,16182,34816,53386,2.55586511949,0.181850873743
"Grafton County, New Hampshire",2015,89341,41.9,51590,16555,35035,55762,2.55004995005,0.185301261459
"Graham County, Arizona",2009,34780,32,12463,1419,11044,40889,3.14922129663,0.0407993099482
"Graham County, Arizona",2012,37115,31.8,13003,2059,10944,44421,3.39135599415,0.0554762225515
"Graham County, Arizona",2015,37407,32,13128,2169,10959,45964,3.41335888311,0.0579837998236
"Graham County, Kansas",2009,2566,46.6,1598,311,1287,40677,1.99378399378,0.121200311769
"Graham County, Kansas",2012,2617,49.5,1489,315,1174,43929,2.22913117547,0.120366832251
"Graham County, Kansas",2015,2593,49.8,1479,278,1201,43826,2.15903413822,0.107211723872
"Graham County, North Carolina",2009,7964,42.1,5578,1869,3709,27786,2.14720949043,0.234681064792
"Graham County, North Carolina",2012,8766,42.7,5917,2474,3443,32137,2.54603543421,0.282226785307
"Graham County, North Carolina",2015,8700,44.6,5930,2663,3267,34805,2.66299357208,0.306091954023
"Grainger County, Tennessee",2009,22549,40.3,10307,1824,8483,32602,2.65813980903,0.0808905051222
"Grainger County, Tennessee",2012,22613,42.1,10844,1845,8999,33185,2.51283475942,0.0815902357051
"Grainger County, Tennessee",2015,22736,43.6,10857,1905,8952,35391,2.53976764969,0.083787825475
"Grand County, Colorado",2009,13550,39.9,14536,9284,5252,58981,2.57996953542,0.685166051661
"Grand County, Colorado",2012,14608,41.1,16044,10703,5341,64416,2.73506833926,0.732680722892
"Grand County, Colorado",2015,14411,42.5,16209,10959,5250,63628,2.74495238095,0.760460759142
"Grand County, Utah",2009,9407,39.3,4547,900,3647,37206,2.57938031259,0.0956734346763
"Grand County, Utah",2012,9183,40,4850,1160,3690,42208,2.48861788618,0.126320374605
"Grand County, Utah",2015,9388,39.1,4995,1206,3789,41312,2.47769860121,0.128461866212
"Grand Forks County, North Dakota",2009,66573,26.6,29304,2487,26817,42360,2.48249244882,0.0373574872696
"Grand Forks County, North Dakota",2012,66890,29.5,29435,2351,27084,46392,2.46972382218,0.0351472566901
"Grand Forks County, North Dakota",2015,68979,29.4,30678,2157,28521,48676,2.418533712,0.0312703866394
"Grand Isle County, Vermont",2009,7575,44.5,4947,1819,3128,56202,2.42167519182,0.240132013201
"Grand Isle County, Vermont",2012,7032,45.8,5048,1918,3130,60433,2.24664536741,0.272753128555
"Grand Isle County, Vermont",2015,6952,47.1,5096,2131,2965,62608,2.34468802698,0.306530494822
"Grand Traverse County, Michigan",2009,85076,40.5,40325,6132,34193,50774,2.48811160179,0.0720767313931
"Grand Traverse County, Michigan",2012,87483,40.8,41598,7236,34362,51641,2.54592282172,0.0827132128528
"Grand Traverse County, Michigan",2015,89907,41.7,42126,7044,35082,52950,2.56276723106,0.0783476258801
"Granite County, Montana",2009,2880,47.7,2082,964,1118,35247,2.57602862254,0.334722222222
"Granite County, Montana",2012,3083,51.8,2778,1291,1487,40511,2.07330195024,0.418747972754
"Granite County, Montana",2015,3168,53.7,2809,1388,1421,48512,2.22941590429,0.438131313131
"Grant County, Arkansas",2009,17544,38.7,7527,969,6558,51238,2.67520585544,0.0552325581395
"Grant County, Arkansas",2012,17852,39.4,7756,1059,6697,49063,2.66567119606,0.0593210844723
"Grant County, Arkansas",2015,18054,39.6,7820,961,6859,46171,2.63216212276,0.053229201285
"Grant County, Indiana",2009,69203,39.1,31731,4042,27689,38797,2.49929574921,0.0584078724911
"Grant County, Indiana",2012,69886,39.8,30497,3529,26968,39751,2.59144170869,0.0504965229087
"Grant County, Indiana",2015,68896,40,30331,3854,26477,40294,2.60210748952,0.055939386902
"Grant County, Kansas",2009,7409,33.6,3091,316,2775,55951,2.66990990991,0.0426508300715
"Grant County, Kansas",2012,7817,32.6,2953,133,2820,53800,2.7719858156,0.0170141998209
"Grant County, Kansas",2015,7816,32.8,2934,227,2707,55432,2.88732914666,0.029042988741
"Grant County, Kentucky",2009,25088,34.3,10501,1428,9073,42405,2.76512730078,0.0569196428571
"Grant County, Kentucky",2012,24683,35.3,9963,1289,8674,46011,2.84563062024,0.052222177207
"Grant County, Kentucky",2015,24670,36.7,9956,1631,8325,44824,2.96336336336,0.0661126874747
"Grant County, Minnesota",2009,5965,46.2,3193,606,2587,39975,2.30575956707,0.101592623638
"Grant County, Minnesota",2012,6016,46.4,3311,675,2636,47333,2.28224582701,0.112200797872
"Grant County, Minnesota",2015,5961,46.3,3298,768,2530,50174,2.35612648221,0.128837443382
"Grant County, Nebraska",2009,608,46.2,405,125,280,37000,2.17142857143,0.205592105263
"Grant County, Nebraska",2012,608,47.3,363,120,243,40982,2.50205761317,0.197368421053
"Grant County, Nebraska",2015,769,48.5,418,119,299,44750,2.57190635452,0.154746423927
"Grant County, New Mexico",2009,29723,44.6,14318,2296,12022,35896,2.47238396273,0.0772465767251
"Grant County, New Mexico",2012,29602,45.8,14663,2356,12307,37525,2.405297798,0.0795892169448
"Grant County, New Mexico",2015,29119,46.5,14644,2612,12032,38311,2.42012965426,0.0897008825853
"Grant County, North Dakota",2009,2525,48.1,1722,553,1169,41875,2.15996578272,0.21900990099
"Grant County, North Dakota",2012,2380,49.7,1641,543,1098,40968,2.16757741348,0.228151260504
"Grant County, North Dakota",2015,2362,53.6,1716,580,1136,44559,2.07922535211,0.245554614733
"Grant County, Oklahoma",2009,4483,45.5,2674,724,1950,43640,2.29897435897,0.161498996208
"Grant County, Oklahoma",2012,4536,45.1,2506,572,1934,43405,2.34539813857,0.126102292769
"Grant County, Oklahoma",2015,4517,44.2,2465,497,1968,50250,2.29522357724,0.110028780164
"Grant County, Oregon",2009,6928,48.6,4247,929,3318,35283,2.08800482218,0.134093533487
"Grant County, Oregon",2012,7366,50,4327,951,3376,34337,2.18187203791,0.129106706489
"Grant County, Oregon",2015,7276,51.1,4320,1171,3149,38046,2.31057478565,0.160940076965
"Grant County, South Dakota",2009,7165,45.4,3592,273,3319,40293,2.15878276589,0.0381018841591
"Grant County, South Dakota",2012,7324,45,3522,362,3160,46273,2.31772151899,0.0494265428727
"Grant County, South Dakota",2015,7227,44.8,3543,334,3209,51272,2.25210345902,0.0462155804622
"Grant County, Washington",2009,83612,31.8,31932,3969,27963,42149,2.99009405286,0.0474692627852
"Grant County, Washington",2012,88885,32.1,34879,4812,30067,45531,2.95623108391,0.0541373685099
"Grant County, Washington",2015,92070,32.2,35391,5033,30358,48714,3.03280848541,0.0546649288585
"Grant County, West Virginia",2009,11789,43.6,6670,1461,5209,34259,2.26319831062,0.123929086437
"Grant County, West Virginia",2012,11929,44,6389,1716,4673,40250,2.5527498395,0.143851119121
"Grant County, West Virginia",2015,11815,45.6,6444,2269,4175,39088,2.82994011976,0.192044011849
"Grant County, Wisconsin",2009,48969,38,21211,2166,19045,43111,2.57122604358,0.0442320651841
"Grant County, Wisconsin",2012,51055,36.5,21568,2191,19377,46138,2.63482479228,0.0429145039663
"Grant County, Wisconsin",2015,51489,36.1,21728,2281,19447,49067,2.64765773641,0.0443007244266
"Grant Parish, Louisiana",2009,19785,37.4,9107,1364,7743,39328,2.55521115847,0.0689411170078
"Grant Parish, Louisiana",2012,22049,37.4,8912,1538,7374,38739,2.99010035259,0.0697537303279
"Grant Parish, Louisiana",2015,22362,37.6,8982,1785,7197,39914,3.10712796999,0.0798229138717
"Granville County, North Carolina",2009,55670,37.5,21605,2199,19406,48186,2.86870040194,0.0395006287049
"Granville County, North Carolina",2012,59666,39.9,22789,3001,19788,49893,3.01526177481,0.0502966513592
"Granville County, North Carolina",2015,58109,41.4,23136,2913,20223,50225,2.8734114622,0.0501299282383
"Gratiot County, Michigan",2009,42230,37.3,15978,1571,14407,41868,2.9312139932,0.0372010419133
"Gratiot County, Michigan",2012,42340,38.5,16326,1605,14721,40224,2.87616330412,0.0379074161549
"Gratiot County, Michigan",2015,41878,38.9,16258,1542,14716,41912,2.84574612666,0.0368212426572
"Graves County, Kentucky",2009,37516,39.9,16924,2117,14807,35107,2.53366650908,0.0564292568504
"Graves County, Kentucky",2012,37200,40,16761,2062,14699,36698,2.5307844071,0.0554301075269
"Graves County, Kentucky",2015,37502,40.3,16753,2363,14390,39530,2.60611535789,0.0630099728015
"Gray County, Kansas",2009,5885,34.7,2316,302,2014,48654,2.92204568024,0.0513169073917
"Gray County, Kansas",2012,5982,35.2,2349,289,2060,55000,2.90388349515,0.0483116014711
"Gray County, Kansas",2015,6065,36.1,2388,238,2150,61000,2.82093023256,0.0392415498763
"Gray County, Texas",2009,21791,39,10599,2222,8377,36788,2.60128924436,0.101968702675
"Gray County, Texas",2012,22731,38.4,10166,1701,8465,44455,2.68529238039,0.0748317275967
"Gray County, Texas",2015,22983,37,10115,1865,8250,43288,2.78581818182,0.0811469346909
"Grays Harbor County, Washington",2009,71117,40.4,34384,6375,28009,41618,2.53907672534,0.0896410141035
"Grays Harbor County, Washington",2012,72272,42,35114,7209,27905,42440,2.58993012005,0.0997481735665
"Grays Harbor County, Washington",2015,71419,42.7,35262,8043,27219,43538,2.62386568206,0.11261709069
"Grayson County, Kentucky",2009,25320,38.9,13111,3463,9648,33091,2.62437810945,0.136769352291
"Grayson County, Kentucky",2012,25772,39.2,13518,3573,9945,33290,2.59145299145,0.138638832842
"Grayson County, Kentucky",2015,26001,39.7,13526,3686,9840,35030,2.64237804878,0.141763778316
"Grayson County, Texas",2009,117913,38.4,51722,7028,44694,45171,2.63822884504,0.0596032668154
"Grayson County, Texas",2012,120641,39.4,53762,7162,46600,46587,2.58886266094,0.0593662187813
"Grayson County, Texas",2015,122780,40.2,54244,7029,47215,47952,2.60044477391,0.0572487375794
"Grayson County, Virginia",2009,16056,45.7,9738,2238,7500,31707,2.1408,0.139387144993
"Grayson County, Virginia",2012,15535,47,9183,2376,6807,31931,2.28220949023,0.152944962987
"Grayson County, Virginia",2015,15573,47.6,9166,2371,6795,29942,2.29183222958,0.152250690297
"Greeley County, Kansas",2009,1183,47.7,680,143,537,47156,2.20297951583,0.120879120879
"Greeley County, Kansas",2012,1234,49.2,629,136,493,52212,2.50304259635,0.110210696921
"Greeley County, Kansas",2015,1224,49.4,588,101,487,47750,2.51334702259,0.0825163398693
"Greeley County, Nebraska",2009,2344,43.3,1081,180,901,38355,2.60155382908,0.0767918088737
"Greeley County, Nebraska",2012,2515,46.1,1290,268,1022,44219,2.46086105675,0.106560636183
"Greeley County, Nebraska",2015,2476,46,1293,298,995,42904,2.48844221106,0.120355411955
"Green County, Kentucky",2009,11513,43,5498,894,4604,38333,2.5006516073,0.0776513506471
"Green County, Kentucky",2012,11309,43.4,5325,845,4480,33573,2.52433035714,0.0747192501547
"Green County, Kentucky",2015,11149,44.2,5286,809,4477,34982,2.4902836721,0.0725625616647
"Green County, Wisconsin",2009,35631,40.9,15568,1189,14379,52082,2.47798873357,0.0333698184165
"Green County, Wisconsin",2012,36800,41.3,15857,1331,14526,55380,2.53338840699,0.0361684782609
"Green County, Wisconsin",2015,37044,42.2,15837,1018,14819,56219,2.49976381672,0.0274808336033
"Green Lake County, Wisconsin",2009,18646,44.1,10379,2305,8074,48230,2.30938815952,0.123619006757
"Green Lake County, Wisconsin",2012,19064,44.4,10585,2660,7925,48772,2.40555205047,0.139530004196
"Green Lake County, Wisconsin",2015,18966,45.2,10620,2681,7939,46780,2.38896586472,0.141358219973
"Greenbrier County, West Virginia",2009,34610,43.8,18629,3126,15503,32635,2.23247113462,0.0903207165559
"Greenbrier County, West Virginia",2012,35572,44.8,18984,3587,15397,36539,2.31032019225,0.100837737546
"Greenbrier County, West Virginia",2015,35666,45.3,19095,3756,15339,39746,2.32518417107,0.105310379633
"Greene County, Alabama",2009,9112,41.2,5292,1600,3692,22352,2.46803900325,0.17559262511
"Greene County, Alabama",2012,9067,41.4,5017,1760,3257,23777,2.78385016887,0.194110510643
"Greene County, Alabama",2015,8697,42.4,4994,1793,3201,20541,2.71696344892,0.206163044728
"Greene County, Arkansas",2009,40190,37.2,17800,1408,16392,38012,2.45180575891,0.0350335904454
"Greene County, Arkansas",2012,42224,37.8,17954,1497,16457,38481,2.56571671629,0.0354537703676
"Greene County, Arkansas",2015,43382,38.3,18327,1645,16682,41286,2.60052751469,0.037918952561
"Greene County, Georgia",2009,15629,43.6,8168,2225,5943,38973,2.62981659095,0.14236355493
"Greene County, Georgia",2012,15988,46.4,8674,2165,6509,40728,2.45629128898,0.135414060545
"Greene County, Georgia",2015,16331,47.6,8938,2231,6707,42408,2.43491874161,0.136611352642
"Greene County, Illinois",2009,13765,41,6540,791,5749,39846,2.3943294486,0.0574645840901
"Greene County, Illinois",2012,13828,41.3,6388,572,5816,42556,2.37757909216,0.0413653456754
"Greene County, Illinois",2015,13502,42.6,6362,904,5458,42565,2.47379992671,0.0669530439935
"Greene County, Indiana",2009,32715,41.4,15873,2210,13663,40252,2.39442289395,0.0675531101941
"Greene County, Indiana",2012,33032,41.5,15216,2304,12912,43850,2.55824039653,0.0697505449261
"Greene County, Indiana",2015,32815,42.3,15102,2304,12798,45397,2.56407251133,0.0702117933872
"Greene County, Iowa",2009,9489,44.7,4675,364,4311,42354,2.20111343076,0.038360206555
"Greene County, Iowa",2012,9304,45.1,4548,460,4088,45816,2.2759295499,0.0494411006019
"Greene County, Iowa",2015,9174,45.1,4539,612,3927,46898,2.33613445378,0.0667102681491
"Greene County, Mississippi",2009,13699,36,5190,905,4285,38252,3.19696616103,0.0660632162932
"Greene County, Mississippi",2012,14352,36.3,5122,991,4131,38836,3.47421931736,0.0690496098105
"Greene County, Mississippi",2015,14129,36.9,5125,945,4180,40176,3.38014354067,0.0668837143464
"Greene County, Missouri",2009,262887,35.2,120608,9345,111263,40271,2.36275311649,0.0355475926919
"Greene County, Missouri",2012,275671,35.6,125468,10524,114944,41458,2.39830700167,0.0381759416116
"Greene County, Missouri",2015,283206,35.6,128166,10434,117732,41227,2.40551421873,0.0368424397788
"Greene County, New York",2009,49071,41.4,28202,9991,18211,46213,2.69458019878,0.203602942675
"Greene County, New York",2012,49122,44,29159,10748,18411,47539,2.6680788659,0.218802166036
"Greene County, New York",2015,48312,45.2,29276,11642,17634,50278,2.73970738346,0.240975327041
"Greene County, North Carolina",2009,20402,35.6,7625,1022,6603,38657,3.08980766318,0.0500931281247
"Greene County, North Carolina",2012,21386,38.1,8163,1027,7136,40833,2.99691704036,0.0480220705134
"Greene County, North Carolina",2015,21328,39,8152,930,7222,35777,2.95319855996,0.0436046511628
"Greene County, Ohio",2009,158389,36.7,67083,5258,61825,57011,2.56189243833,0.0331967497743
"Greene County, Ohio",2012,161936,37,68237,5556,62681,57992,2.58349420079,0.0343098508053
"Greene County, Ohio",2015,164192,37.7,68953,4771,64182,60113,2.55822504752,0.0290574449425
"Greene County, Pennsylvania",2009,39509,40,17266,2736,14530,38078,2.71913282863,0.0692500442937
"Greene County, Pennsylvania",2012,38614,41.3,16511,2392,14119,42837,2.73489623911,0.0619464442948
"Greene County, Pennsylvania",2015,37938,41.9,16443,2049,14394,46661,2.63568153397,0.054009172861
"Greene County, Tennessee",2009,65698,40.9,30743,3377,27366,35995,2.4007162172,0.0514018691589
"Greene County, Tennessee",2012,68755,42.6,31970,3079,28891,35613,2.37980686027,0.0447821976584
"Greene County, Tennessee",2015,68576,43.7,32104,4043,28061,35196,2.44381882328,0.0589564862343
"Greene County, Virginia",2009,17890,37.7,7326,585,6741,54153,2.65390891559,0.0326998323086
"Greene County, Virginia",2012,18453,39.5,7585,701,6884,58804,2.6805636258,0.0379884029697
"Greene County, Virginia",2015,18938,40.1,7905,794,7111,61550,2.66319786247,0.0419262857746
"Greenlee County, Arizona",2009,7723,36.5,3812,902,2910,45476,2.65395189003,0.116793991972
"Greenlee County, Arizona",2012,8592,33.7,4345,974,3371,49692,2.54879857609,0.113361266294
"Greenlee County, Arizona",2015,9023,33,4399,1180,3219,51628,2.80304442373,0.130776903469
"Greensville County, Virginia",2009,11916,39.6,4126,590,3536,40917,3.36990950226,0.049513259483
"Greensville County, Virginia",2012,12127,42.1,4098,788,3310,38423,3.66374622356,0.0649789725406
"Greensville County, Virginia",2015,11760,42.9,4122,636,3486,38012,3.3734939759,0.0540816326531
"Greenup County, Kentucky",2009,37517,41.5,16470,1745,14725,40110,2.54784380306,0.046512247781
"Greenup County, Kentucky",2012,36922,42,16352,1931,14421,43808,2.56029401567,0.0522994420671
"Greenup County, Kentucky",2015,36477,42.9,16315,2115,14200,45370,2.5688028169,0.0579817419196
"Greenville County, South Carolina",2009,430273,36.7,186109,19767,166342,46671,2.5866768465,0.0459406005025
"Greenville County, South Carolina",2012,452931,37.2,195348,21124,174224,48438,2.5997049775,0.0466384504483
"Greenville County, South Carolina",2015,474903,37.7,199369,19507,179862,50540,2.64037428695,0.0410757565229
"Greenwood County, Kansas",2009,6912,45.3,4352,1180,3172,36424,2.1790668348,0.170717592593
"Greenwood County, Kansas",2012,6654,46.5,4078,1171,2907,39145,2.28895768834,0.175984370304
"Greenwood County, Kansas",2015,6393,48,4052,1228,2824,38838,2.2638101983,0.192085093071
"Greenwood County, South Carolina",2009,68631,37.6,30005,4346,25659,39801,2.67473401146,0.063324153808
"Greenwood County, South Carolina",2012,69531,38.3,31000,4712,26288,37911,2.64497108947,0.0677683335491
"Greenwood County, South Carolina",2015,69771,38.9,31103,4394,26709,37060,2.61226552847,0.0629774548165
"Greer County, Oklahoma",2009,5800,39,2521,509,2012,34844,2.88270377734,0.0877586206897
"Greer County, Oklahoma",2012,6185,42.1,2736,568,2168,40827,2.8528597786,0.0918350848828
"Greer County, Oklahoma",2015,6117,41.3,2736,550,2186,40125,2.79826166514,0.0899133562204
"Gregg County, Texas",2009,116901,35.1,48574,4013,44561,42499,2.62339265277,0.034328192231
"Gregg County, Texas",2012,121451,35.4,49663,4580,45083,45233,2.69394228423,0.0377106816741
"Gregg County, Texas",2015,123178,35.4,50785,5167,45618,47639,2.70020605901,0.0419474256767
"Gregory County, South Dakota",2009,4083,48.8,2468,519,1949,32808,2.09492047204,0.12711241734
"Gregory County, South Dakota",2012,4251,48.4,2502,547,1955,36447,2.17442455243,0.12867560574
"Gregory County, South Dakota",2015,4226,47.5,2503,533,1970,37540,2.14517766497,0.126123994321
"Grenada County, Mississippi",2009,23002,37.4,10455,1164,9291,31909,2.4757292003,0.0506042952787
"Grenada County, Mississippi",2012,21886,39.3,10170,1687,8483,35912,2.5799834964,0.0770812391483
"Grenada County, Mississippi",2015,21591,40.4,10169,2740,7429,31779,2.90631309732,0.126904728822
"Griggs County, North Dakota",2009,2310,51.6,1570,404,1166,38952,1.98113207547,0.174891774892
"Griggs County, North Dakota",2012,2393,52,1478,354,1124,44792,2.12900355872,0.147931466778
"Griggs County, North Dakota",2015,2329,51.8,1408,373,1035,48355,2.25024154589,0.160154572778
"Grimes County, Texas",2009,25621,39,10006,2373,7633,39403,3.35660945893,0.0926193357012
"Grimes County, Texas",2012,26564,39.1,10869,2153,8716,43810,3.04772831574,0.0810495407318
"Grimes County, Texas",2015,26961,40.7,10947,1942,9005,46195,2.99400333148,0.0720299692148
"Grundy County, Illinois",2009,46513,36,18179,1500,16679,64455,2.7887163499,0.0322490486531
"Grundy County, Illinois",2012,49870,36.4,19919,1932,17987,63840,2.77255795853,0.0387407258873
"Grundy County, Illinois",2015,50277,37.2,20249,1757,18492,65887,2.7188513952,0.0349463969608
"Grundy County, Iowa",2009,12166,42.8,5657,460,5197,53663,2.34096594189,0.0378102909748
"Grundy County, Iowa",2012,12431,42.5,5528,466,5062,56264,2.45574871592,0.0374869278417
"Grundy County, Iowa",2015,12407,42.2,5538,355,5183,56750,2.39378738183,0.0286128798259
"Grundy County, Missouri",2009,10088,42.7,5282,912,4370,35032,2.30846681922,0.0904044409199
"Grundy County, Missouri",2012,10256,41.8,5035,854,4181,37533,2.45300167424,0.0832683307332
"Grundy County, Missouri",2015,10256,41,5003,946,4057,37656,2.52797633719,0.0922386895476
"Grundy County, Tennessee",2009,14262,39.1,6614,1159,5455,26239,2.61448212649,0.0812648997336
"Grundy County, Tennessee",2012,13751,41.8,6387,1091,5296,26644,2.59648791541,0.0793396843866
"Grundy County, Tennessee",2015,13524,42.6,6376,1155,5221,27373,2.59030837004,0.0854037267081
"Guadalupe County, New Mexico",2009,4365,37.4,2069,653,1416,29085,3.08262711864,0.14959908362
"Guadalupe County, New Mexico",2012,4655,40.1,2214,840,1374,27242,3.38791848617,0.18045112782
"Guadalupe County, New Mexico",2015,4526,41.6,2261,1069,1192,30772,3.79697986577,0.236190897039
"Guadalupe County, Texas",2009,112267,36.6,41362,3628,37734,59375,2.97522128584,0.0323158185397
"Guadalupe County, Texas",2012,131945,36.5,50025,4614,45411,63889,2.90557353945,0.0349691159195
"Guadalupe County, Texas",2015,143460,36.6,53101,4161,48940,62420,2.93134450347,0.0290046005855
"Guayama Municipio, Puerto Rico",2009,45248,33.7,17482,3180,14302,17223,3.16375332121,0.0702793493635
"Guayama Municipio, Puerto Rico",2012,45250,34.8,18043,3671,14372,17496,3.1484831617,0.0811270718232
"Guayama Municipio, Puerto Rico",2015,43700,36.4,18742,3563,15179,15860,2.87897753475,0.081533180778
"Guayanilla Municipio, Puerto Rico",2009,23686,34.3,7917,1256,6661,13843,3.55592253415,0.0530271046188
"Guayanilla Municipio, Puerto Rico",2012,21493,35.8,8246,1659,6587,14679,3.2629421588,0.0771879216489
"Guayanilla Municipio, Puerto Rico",2015,20442,38.3,8479,1859,6620,15067,3.08791540785,0.0909402211134
"Guaynabo Municipio, Puerto Rico",2009,102742,38,37853,4008,33845,33622,3.03566257941,0.0390103365712
"Guaynabo Municipio, Puerto Rico",2012,97639,39.7,38799,4399,34400,34638,2.83834302326,0.0450537182888
"Guaynabo Municipio, Puerto Rico",2015,93899,41.3,40251,5288,34963,34719,2.68566770586,0.0563158287096
"Guernsey County, Ohio",2009,40332,40,19624,2904,16720,37193,2.41220095694,0.072002380244
"Guernsey County, Ohio",2012,40056,40.8,19185,3377,15808,39293,2.53390688259,0.0843069702417
"Guernsey County, Ohio",2015,39626,42.2,19091,3533,15558,40930,2.54698547371,0.0891586332206
"Guilford County, North Carolina",2009,464041,36,209392,23015,186377,46100,2.48979756086,0.0495969106178
"Guilford County, North Carolina",2012,489576,36.4,217936,24046,193890,46223,2.52501934086,0.0491159697371
"Guilford County, North Carolina",2015,506763,36.9,222057,22517,199540,45651,2.53965620928,0.0444329992521
"Gulf County, Florida",2009,15714,42.3,8716,3518,5198,38574,3.02308580223,0.22387679776
"Gulf County, Florida",2012,15796,43.8,9089,3721,5368,39535,2.94262295082,0.235565966067
"Gulf County, Florida",2015,15785,43.3,9157,3808,5349,41788,2.95101888203,0.241241685144
"Gunnison County, Colorado",2009,14924,30.4,10723,4946,5777,44577,2.58334775835,0.331412489949
"Gunnison County, Colorado",2012,15385,34.3,11394,4947,6447,50091,2.3863812626,0.321546961326
"Gunnison County, Colorado",2015,15651,34.3,11542,5255,6287,48071,2.4894226181,0.335761293208
"Gurabo Municipio, Puerto Rico",2009,42927,34.2,14510,2015,12495,27915,3.43553421369,0.0469401542153
"Gurabo Municipio, Puerto Rico",2012,45540,35.8,15880,2348,13532,27817,3.36535619273,0.0515590689504
"Gurabo Municipio, Puerto Rico",2015,46765,36.7,17512,2206,15306,29317,3.05533777604,0.0471720303646
"Guthrie County, Iowa",2009,11032,44.4,5787,1023,4764,48574,2.31570109152,0.0927302393038
"Guthrie County, Iowa",2012,10915,44.9,5746,978,4768,49114,2.28921979866,0.0896014658727
"Guthrie County, Iowa",2015,10740,45.9,5741,1227,4514,51013,2.37926451041,0.114245810056
"Guánica Municipio, Puerto Rico",2009,22773,34.7,8623,2136,6487,12107,3.5105595807,0.0937952838888
"Guánica Municipio, Puerto Rico",2012,19363,36.7,9021,3216,5805,13567,3.33557278208,0.166089965398
"Guánica Municipio, Puerto Rico",2015,18207,39.6,9305,3860,5445,13682,3.34380165289,0.212006371176
"Gwinnett County, Georgia",2009,766912,33.1,279851,25336,254515,65136,3.01322908277,0.0330363848786
"Gwinnett County, Georgia",2012,810624,33.8,291547,26955,264592,61944,3.06367539457,0.033252161298
"Gwinnett County, Georgia",2015,859234,34.5,296368,22351,274017,60289,3.13569596047,0.026012704339
"Haakon County, South Dakota",2009,1841,50.1,901,233,668,46667,2.75598802395,0.126561651276
"Haakon County, South Dakota",2012,1852,48,1014,232,782,48571,2.36828644501,0.125269978402
"Haakon County, South Dakota",2015,2083,48.3,1033,178,855,41518,2.43625730994,0.0854536725876
"Habersham County, Georgia",2009,41790,35.9,17559,2434,15125,40412,2.76297520661,0.0582435989471
"Habersham County, Georgia",2012,43038,38.6,18118,3228,14890,41894,2.89039623909,0.0750034852921
"Habersham County, Georgia",2015,43527,38.8,18124,3260,14864,40907,2.92835037675,0.0748960415374
"Haines Borough, Alaska",2009,2424,47.6,1608,421,1187,44284,2.04212299916,0.173679867987
"Haines Borough, Alaska",2012,2500,42.9,1590,451,1139,50208,2.19490781387,0.1804
"Haines Borough, Alaska",2015,2560,45.5,1590,414,1176,58750,2.1768707483,0.16171875
"Hale County, Alabama",2009,17994,36.5,8265,2002,6263,29841,2.87306402682,0.111259308658
"Hale County, Alabama",2012,15750,40.4,7682,1717,5965,29409,2.64040234702,0.109015873016
"Hale County, Alabama",2015,15256,40.2,7641,1714,5927,32714,2.5739834655,0.112349239643
"Hale County, Texas",2009,35535,32.6,13840,1842,11998,34820,2.96174362394,0.0518362178134
"Hale County, Texas",2012,36153,32.4,13555,1846,11709,40521,3.08762490392,0.0510607695074
"Hale County, Texas",2015,35504,32.5,13507,1994,11513,43375,3.08381829237,0.0561626858945
"Halifax County, North Carolina",2009,55118,40.6,26170,4575,21595,29681,2.55235008104,0.083003737436
"Halifax County, North Carolina",2012,54693,41.9,25812,4250,21562,31614,2.53654577497,0.0777064706635
"Halifax County, North Carolina",2015,53407,42.1,25719,4251,21468,32245,2.48774920812,0.0795963076001
"Halifax County, Virginia",2009,35460,43.9,17561,2905,14656,34318,2.41948689956,0.0819232938522
"Halifax County, Virginia",2012,36140,44.6,18006,3321,14685,35191,2.46101464079,0.0918926397344
"Halifax County, Virginia",2015,35506,45.3,18057,3757,14300,35240,2.48293706294,0.105813102011
"Hall County, Georgia",2009,177685,33,62658,6386,56272,51222,3.1576094683,0.0359400061907
"Hall County, Georgia",2012,180831,34.5,68511,7517,60994,52174,2.96473423615,0.0415691999712
"Hall County, Georgia",2015,187916,35.6,69302,7310,61992,51202,3.03129436056,0.0389003597352
"Hall County, Nebraska",2009,55669,35.5,22698,1396,21302,46215,2.6133226927,0.0250767931883
"Hall County, Nebraska",2012,58681,35.6,23542,1436,22106,48044,2.65452818239,0.0244712939452
"Hall County, Nebraska",2015,60792,35.8,23982,1549,22433,49252,2.70993625462,0.0254803263587
"Hall County, Texas",2009,3455,41.5,1995,581,1414,29032,2.44342291372,0.168162083936
"Hall County, Texas",2012,3337,43.5,1943,673,1270,32097,2.62755905512,0.201678154031
"Hall County, Texas",2015,3203,44.7,1934,779,1155,30950,2.77316017316,0.243209491102
"Hamblen County, Tennessee",2009,61698,38.1,26452,1916,24536,39507,2.51459080535,0.0310544912315
"Hamblen County, Tennessee",2012,62528,39.1,26921,2629,24292,39316,2.574016137,0.0420451637666
"Hamblen County, Tennessee",2015,62999,39.9,27009,2539,24470,37617,2.57454025337,0.0403022270195
"Hamilton County, Florida",2009,14228,36.6,5241,1068,4173,35632,3.409537503,0.0750632555524
"Hamilton County, Florida",2012,14728,38.4,5743,1270,4473,36875,3.29264475743,0.0862303096143
"Hamilton County, Florida",2015,14395,40.5,5733,1045,4688,35048,3.07060580205,0.0725946509205
"Hamilton County, Illinois",2009,8186,41.9,4095,608,3487,34014,2.34757671351,0.0742731492793
"Hamilton County, Illinois",2012,8430,43.3,4098,597,3501,37904,2.40788346187,0.0708185053381
"Hamilton County, Illinois",2015,8322,43.2,4068,595,3473,44159,2.39619925137,0.0714972362413
"Hamilton County, Indiana",2009,261328,35.4,98402,6565,91837,82088,2.84556333504,0.0251216861569
"Hamilton County, Indiana",2012,276098,35.7,107086,5883,101203,84821,2.7281602324,0.0213076516309
"Hamilton County, Indiana",2015,296635,36.1,113759,5506,108253,86222,2.74020119535,0.0185615318489
"Hamilton County, Iowa",2009,15555,41.2,7307,626,6681,48084,2.32824427481,0.0402442944391
"Hamilton County, Iowa",2012,15614,42.1,7217,790,6427,45691,2.42943830714,0.050595619316
"Hamilton County, Iowa",2015,15297,42.4,7184,800,6384,49813,2.39614661654,0.052297836177
"Hamilton County, Kansas",2009,2583,33.6,1300,169,1131,34478,2.28381962865,0.0654277971351
"Hamilton County, Kansas",2012,2656,36.7,1303,198,1105,43125,2.4036199095,0.0745481927711
"Hamilton County, Kansas",2015,2586,38,1195,197,998,45114,2.59118236473,0.0761794276875
"Hamilton County, Nebraska",2009,9302,41.4,3993,424,3569,49618,2.60633230597,0.0455815953558
"Hamilton County, Nebraska",2012,9096,42.9,3974,566,3408,56809,2.66901408451,0.0622251539138
"Hamilton County, Nebraska",2015,9100,42.9,4028,379,3649,59311,2.4938339271,0.0416483516484
"Hamilton County, New York",2009,5011,49.9,8283,5877,2406,45242,2.08270989194,1.17281979645
"Hamilton County, New York",2012,4835,51,8684,6550,2134,51595,2.26569821931,1.35470527404
"Hamilton County, New York",2015,4760,51.9,8757,7381,1376,48243,3.45930232558,1.5506302521
"Hamilton County, Ohio",2009,851867,36.8,383925,50152,333773,48363,2.55223460256,0.0588730400403
"Hamilton County, Ohio",2012,801350,37.1,377624,51601,326023,49104,2.45795542032,0.0643925875086
"Hamilton County, Ohio",2015,804194,37,377126,45488,331638,49013,2.42491511829,0.0565634660293
"Hamilton County, Tennessee",2009,330941,39,148424,15213,133211,45557,2.48433687909,0.0459689189312
"Hamilton County, Tennessee",2012,337023,39.1,151185,16448,134737,46544,2.50133964687,0.0488037908392
"Hamilton County, Tennessee",2015,348121,39.3,153730,17411,136319,48248,2.55372325208,0.0500142191939
"Hamilton County, Texas",2009,8051,44.7,4581,1491,3090,37796,2.60550161812,0.185194385791
"Hamilton County, Texas",2012,8448,46.6,4558,1477,3081,39709,2.74196689387,0.174834280303
"Hamilton County, Texas",2015,8266,48.6,4562,1396,3166,42432,2.61086544536,0.168884587467
"Hamlin County, South Dakota",2009,5620,37.8,2812,666,2146,43227,2.61882572227,0.118505338078
"Hamlin County, South Dakota",2012,5875,37.4,2769,720,2049,50473,2.8672523182,0.122553191489
"Hamlin County, South Dakota",2015,5982,36.1,2802,624,2178,58602,2.74655647383,0.104312938816
"Hampden County, Massachusetts",2009,468171,38.1,190651,13742,176909,47617,2.646394474,0.029352522903
"Hampden County, Massachusetts",2012,464072,38.8,191984,14228,177756,49729,2.61072481379,0.0306590356669
"Hampden County, Massachusetts",2015,468041,38.6,192100,15200,176900,50461,2.64579423403,0.0324757873776
"Hampshire County, Massachusetts",2009,155160,36.8,61514,3527,57987,57293,2.67577215583,0.0227313740655
"Hampshire County, Massachusetts",2012,158850,36.2,62568,3636,58932,61264,2.69547953574,0.0228895184136
"Hampshire County, Massachusetts",2015,160759,35.9,62860,4229,58631,61368,2.74187716396,0.0263064587364
"Hampshire County, West Virginia",2009,22400,41,12473,3622,8851,34571,2.53078748164,0.161696428571
"Hampshire County, West Virginia",2012,23791,42.7,13647,3084,10563,28573,2.25229574931,0.129628851246
"Hampshire County, West Virginia",2015,23542,44.6,13761,3567,10194,27995,2.30939768491,0.151516438705
"Hampton County, South Carolina",2009,20997,36.8,8808,1697,7111,34285,2.95274926171,0.0808210696766
"Hampton County, South Carolina",2012,20987,38.9,9108,1820,7288,35713,2.87966520307,0.0867203506933
"Hampton County, South Carolina",2015,20473,39.7,9058,1528,7530,31410,2.71885790173,0.0746348849704
"Hampton city, Virginia",2009,145903,34,59746,5185,54561,48122,2.67412620736,0.0355373090341
"Hampton city, Virginia",2012,137471,35.5,59601,7054,52547,51584,2.61615315813,0.0513126404842
"Hampton city, Virginia",2015,137081,35.4,60168,7228,52940,49190,2.58936531923,0.0527279491687
"Hancock County, Georgia",2009,9449,38.2,4707,2023,2684,26786,3.52049180328,0.214096729813
"Hancock County, Georgia",2012,9422,42.1,5307,2447,2860,22716,3.29440559441,0.259711313946
"Hancock County, Georgia",2015,8881,43.9,5289,2474,2815,24925,3.15488454707,0.278572232857
"Hancock County, Illinois",2009,18720,43.6,9235,1211,8024,42732,2.33300099701,0.0646901709402
"Hancock County, Illinois",2012,19063,44.7,9264,1211,8053,42494,2.36719235068,0.0635262025914
"Hancock County, Illinois",2015,18738,46.2,9227,1365,7862,47699,2.38336301196,0.072846621838
"Hancock County, Indiana",2009,65777,39,27283,1960,25323,60878,2.59752004107,0.0297976496344
"Hancock County, Indiana",2012,69778,39,28125,2182,25943,62702,2.68966580581,0.031270601049
"Hancock County, Indiana",2015,71328,39.8,28685,2345,26340,66606,2.70797266515,0.0328762898161
"Hancock County, Iowa",2009,11339,43.8,5321,569,4752,48634,2.38615319865,0.050180791957
"Hancock County, Iowa",2012,11320,44.7,5333,602,4731,48695,2.39272880998,0.0531802120141
"Hancock County, Iowa",2015,11092,44,5288,615,4673,52981,2.37363578001,0.0554453660296
"Hancock County, Kentucky",2009,8601,38.3,3713,481,3232,44891,2.66120049505,0.0559237297989
"Hancock County, Kentucky",2012,8588,40,3728,473,3255,48867,2.63840245776,0.0550768514206
"Hancock County, Kentucky",2015,8669,41.6,3711,446,3265,50476,2.65513016845,0.0514476871611
"Hancock County, Maine",2009,53299,44.4,36882,14733,22149,48899,2.4063840354,0.276421696467
"Hancock County, Maine",2012,54470,46.3,40064,16189,23875,48635,2.28146596859,0.297209473104
"Hancock County, Maine",2015,54658,47.4,40413,16042,24371,47030,2.2427475278,0.293497749643
"Hancock County, Mississippi",2009,41135,41.3,19426,3614,15812,44025,2.60150518593,0.087857056035
"Hancock County, Mississippi",2012,44044,40.5,21639,3927,17712,43727,2.48667570009,0.0891608391608
"Hancock County, Mississippi",2015,45627,41.8,23196,4605,18591,43355,2.45425205745,0.100927082648
"Hancock County, Ohio",2009,74058,37.5,33576,1927,31649,48369,2.33997914626,0.0260201463718
"Hancock County, Ohio",2012,75043,38.4,33171,2829,30342,49350,2.4732384154,0.0376983862585
"Hancock County, Ohio",2015,75428,39.2,33270,2187,31083,50895,2.42666409291,0.0289945378374
"Hancock County, Tennessee",2009,6633,40.7,3413,606,2807,23413,2.36302101888,0.0913613749435
"Hancock County, Tennessee",2012,6759,42.3,3614,725,2889,22205,2.33956386293,0.107264388223
"Hancock County, Tennessee",2015,6642,44.2,3606,852,2754,26898,2.41176470588,0.128274616079
"Hancock County, West Virginia",2009,30215,44.4,14848,1419,13429,39280,2.24998138357,0.0469634287605
"Hancock County, West Virginia",2012,30594,45.1,14549,1560,12989,37465,2.35537762722,0.0509903902726
"Hancock County, West Virginia",2015,30201,45.6,14454,1560,12894,39959,2.34225221033,0.0516539187444
"Hand County, South Dakota",2009,3268,48.7,1736,355,1381,45202,2.36640115858,0.108629130967
"Hand County, South Dakota",2012,3394,49.3,1803,328,1475,45399,2.30101694915,0.0966411314084
"Hand County, South Dakota",2015,3375,48.8,1831,321,1510,47163,2.23509933775,0.0951111111111
"Hanover County, Virginia",2009,98602,39.8,37407,1553,35854,76926,2.75009761812,0.015750187623
"Hanover County, Virginia",2012,99964,41.2,38441,1997,36444,76719,2.74294808473,0.019977191789
"Hanover County, Virginia",2015,101340,41.9,39391,1928,37463,78645,2.70506900141,0.0190250641405
"Hansford County, Texas",2009,5246,37.3,2332,459,1873,46799,2.80085424453,0.0874952344644
"Hansford County, Texas",2012,5556,36.5,2338,420,1918,49626,2.89676746611,0.0755939524838
"Hansford County, Texas",2015,5559,36.4,2333,361,1972,44219,2.81896551724,0.0649397373628
"Hanson County, South Dakota",2009,3585,39.5,1364,71,1293,45938,2.77262180974,0.0198047419805
"Hanson County, South Dakota",2012,3366,35.6,1184,133,1051,53860,3.2026641294,0.0395127748069
"Hanson County, South Dakota",2015,3386,35.5,1175,119,1056,60741,3.20643939394,0.0351447135263
"Haralson County, Georgia",2009,28559,37,12042,1518,10524,38290,2.71370201444,0.0531531216079
"Haralson County, Georgia",2012,28627,39.2,12282,1571,10711,39227,2.67267295304,0.0548782617808
"Haralson County, Georgia",2015,28565,40.3,12254,1521,10733,41910,2.66141805646,0.0532469805706
"Hardee County, Florida",2009,28684,32.8,10518,2100,8418,38865,3.40746020432,0.0732115465068
"Hardee County, Florida",2012,27347,33.1,9742,2248,7494,36115,3.64918601548,0.0822028010385
"Hardee County, Florida",2015,27468,34.8,9642,2024,7618,35457,3.60567077973,0.0736857434105
"Hardeman County, Tennessee",2009,27759,38.3,11399,1859,9540,32483,2.90974842767,0.0669692712273
"Hardeman County, Tennessee",2012,27193,39.7,10889,2043,8846,31963,3.074044766,0.0751296289486
"Hardeman County, Tennessee",2015,26253,39.8,10865,2128,8737,31801,3.00480714204,0.0810574029635
"Hardeman County, Texas",2009,4112,42.2,2233,649,1584,36385,2.59595959596,0.1578307393
"Hardeman County, Texas",2012,4124,42.3,2410,670,1740,35332,2.37011494253,0.162463627546
"Hardeman County, Texas",2015,3992,42.3,2395,761,1634,37174,2.44308445532,0.190631262525
"Hardin County, Illinois",2009,4470,44.2,2594,665,1929,32083,2.31726283048,0.148769574944
"Hardin County, Illinois",2012,4315,45.9,2413,510,1903,35632,2.26747241198,0.11819235226
"Hardin County, Illinois",2015,4228,46.6,2290,613,1677,38838,2.52116875373,0.144985808893
"Hardin County, Iowa",2009,17486,43.2,8430,890,7540,42397,2.31909814324,0.0508978611461
"Hardin County, Iowa",2012,17479,43.6,8236,1135,7101,47902,2.46148429799,0.0649350649351
"Hardin County, Iowa",2015,17393,44.7,8180,1207,6973,51019,2.49433529327,0.0693957339159
"Hardin County, Kentucky",2009,98113,35.6,43620,5471,38149,46098,2.57183674539,0.0557622333432
"Hardin County, Kentucky",2012,104513,35.5,43764,4856,38908,49257,2.68615708852,0.0464631194206
"Hardin County, Kentucky",2015,107529,35.7,45308,4932,40376,50765,2.66319100456,0.0458666964261
"Hardin County, Ohio",2009,31739,34.2,13184,1243,11941,41423,2.65798509338,0.0391631746432
"Hardin County, Ohio",2012,31986,34.8,13131,1309,11822,40732,2.70563356454,0.0409241543175
"Hardin County, Ohio",2015,31736,35.4,13108,1568,11540,42703,2.75008665511,0.0494076128056
"Hardin County, Tennessee",2009,26093,42,13547,2955,10592,30558,2.46346299094,0.113248764036
"Hardin County, Tennessee",2012,25987,42.9,13923,3737,10186,33044,2.55124680935,0.143802670566
"Hardin County, Tennessee",2015,25900,44.8,13975,4104,9871,35290,2.62384763448,0.158455598456
"Hardin County, Texas",2009,51804,37.7,20990,2269,18721,52515,2.76715987394,0.0437997065864
"Hardin County, Texas",2012,54497,38.4,22586,2118,20468,54275,2.66254641391,0.0388645246527
"Hardin County, Texas",2015,55375,38.9,23244,2445,20799,52614,2.66238761479,0.0441534988713
"Harding County, New Mexico",2009,655,53.9,573,266,307,31042,2.1335504886,0.406106870229
"Harding County, New Mexico",2012,612,53.8,467,224,243,31146,2.51851851852,0.366013071895
"Harding County, New Mexico",2015,565,56.9,512,323,189,33393,2.98941798942,0.571681415929
"Harding County, South Dakota",2009,1205,44.1,714,220,494,36912,2.43927125506,0.182572614108
"Harding County, South Dakota",2012,1367,40.6,711,181,530,48036,2.57924528302,0.132406730066
"Harding County, South Dakota",2015,1328,37.6,682,175,507,52396,2.61932938856,0.131777108434
"Hardy County, West Virginia",2009,13488,40.9,7952,3157,4795,34625,2.81293013556,0.234059905101
"Hardy County, West Virginia",2012,13912,42.1,8078,3314,4764,34184,2.92023509656,0.238211615871
"Hardy County, West Virginia",2015,13936,44.5,8122,2966,5156,40303,2.7028704422,0.212830080367
"Harford County, Maryland",2009,240297,38.3,95248,5106,90142,75872,2.66576068869,0.0212487047279
"Harford County, Maryland",2012,245396,39.5,95832,5752,90080,80441,2.72420071048,0.0234396648682
"Harford County, Maryland",2015,248966,40.1,97572,5845,91727,80465,2.71420628604,0.0234771012909
"Harlan County, Kentucky",2009,30999,40,15693,3238,12455,27101,2.48887996788,0.104454982419
"Harlan County, Kentucky",2012,29210,40.6,13603,2545,11058,26758,2.64152649665,0.0871276959945
"Harlan County, Kentucky",2015,28400,41,13486,2080,11406,25814,2.48991758723,0.0732394366197
"Harlan County, Nebraska",2009,3350,47.9,2377,840,1537,39565,2.17957059206,0.250746268657
"Harlan County, Nebraska",2012,3419,49.9,2405,880,1525,44801,2.24196721311,0.257385200351
"Harlan County, Nebraska",2015,3458,49.5,2390,835,1555,46766,2.22379421222,0.241469057259
"Harmon County, Oklahoma",2009,2876,41.7,1683,592,1091,31531,2.6361136572,0.205841446453
"Harmon County, Oklahoma",2012,2888,41.2,1545,438,1107,28194,2.60885275519,0.151662049861
"Harmon County, Oklahoma",2015,2866,41.1,1540,366,1174,31250,2.44122657581,0.127704117237
"Harnett County, North Carolina",2009,108885,33.5,45320,5964,39356,42369,2.76666836061,0.0547733847637
"Harnett County, North Carolina",2012,115559,33.5,46926,6396,40530,44242,2.85119664446,0.0553483501934
"Harnett County, North Carolina",2015,124320,33.6,48676,6004,42672,46353,2.91338582677,0.0482947232947
"Harney County, Oregon",2009,6777,46.6,3627,467,3160,38784,2.14462025316,0.0689095469972
"Harney County, Oregon",2012,7359,46.1,3815,629,3186,39674,2.30979284369,0.0854735697785
"Harney County, Oregon",2015,7229,46.2,3811,773,3038,37580,2.37952600395,0.106930419145
"Harper County, Kansas",2009,5794,44.8,3215,541,2674,38529,2.16679132386,0.093372454263
"Harper County, Kansas",2012,5998,43.3,3119,440,2679,38340,2.23889511012,0.0733577859286
"Harper County, Kansas",2015,5861,43,3148,715,2433,43973,2.40896013152,0.121992833987
"Harper County, Oklahoma",2009,3340,44.6,1868,360,1508,41750,2.21485411141,0.107784431138
"Harper County, Oklahoma",2012,3672,40.5,1907,397,1510,46437,2.43178807947,0.10811546841
"Harper County, Oklahoma",2015,3766,39,1896,452,1444,48359,2.608033241,0.120021242698
"Harris County, Georgia",2009,28884,40.5,12675,2021,10654,63368,2.71109442463,0.0699695333056
"Harris County, Georgia",2012,31870,42.3,13382,2074,11308,68816,2.81835868412,0.0650768748039
"Harris County, Georgia",2015,32776,43.1,13604,2034,11570,63824,2.83284356093,0.0620576031242
"Harris County, Texas",2009,3909790,31.8,1534652,176339,1358313,50569,2.87841609408,0.0451019108443
"Harris County, Texas",2012,4101752,32.2,1600395,187500,1412895,53160,2.90308338553,0.0457121737248
"Harris County, Texas",2015,4356362,32.8,1660235,160707,1499528,54457,2.90515548893,0.0368901849754
"Harrison County, Indiana",2009,36973,38.8,15036,1603,13433,50544,2.75240080399,0.0433559624591
"Harrison County, Indiana",2012,39102,40.7,16450,2082,14368,52184,2.72146436526,0.0532453582937
"Harrison County, Indiana",2015,39230,41.7,16636,2032,14604,52128,2.68625034237,0.0517970940607
"Harrison County, Iowa",2009,15410,41.4,6963,578,6385,48187,2.41346906813,0.0375081116158
"Harrison County, Iowa",2012,14838,42.7,6724,729,5995,53939,2.47506255213,0.0491306105944
"Harrison County, Iowa",2015,14467,43.8,6727,754,5973,53567,2.4220659635,0.0521186147785
"Harrison County, Kentucky",2009,18531,40.2,8154,841,7313,39928,2.53398058252,0.0453834115806
"Harrison County, Kentucky",2012,18781,41.6,8204,961,7243,36393,2.59298633163,0.0511687343592
"Harrison County, Kentucky",2015,18648,41.9,8218,1098,7120,35681,2.6191011236,0.0588803088803
"Harrison County, Mississippi",2009,180901,35.1,80601,12920,67681,44570,2.67284762341,0.0714202796004
"Harrison County, Mississippi",2012,188110,35.4,85048,13630,71418,43593,2.63392982161,0.0724576045931
"Harrison County, Mississippi",2015,196268,35.4,88821,12939,75882,41722,2.58648954956,0.0659251635519
"Harrison County, Missouri",2009,8750,43.4,4458,830,3628,33598,2.41179713341,0.0948571428571
"Harrison County, Missouri",2012,8901,42.6,4416,796,3620,36909,2.45883977901,0.08942815414
"Harrison County, Missouri",2015,8722,42.4,4388,814,3574,39301,2.4404029099,0.0933272185279
"Harrison County, Ohio",2009,15430,43.7,7779,1527,6252,35493,2.46801023672,0.098963058976
"Harrison County, Ohio",2012,15818,44.2,8154,1830,6324,37088,2.50126502214,0.115690984954
"Harrison County, Ohio",2015,15633,45.9,8115,1844,6271,43173,2.49290384309,0.117955606729
"Harrison County, Texas",2009,63528,37.1,27392,4489,22903,41966,2.77378509366,0.0706617554464
"Harrison County, Texas",2012,65958,37,27714,4567,23147,46718,2.84952693654,0.069241032172
"Harrison County, Texas",2015,66417,37.5,27954,4408,23546,45974,2.82073388261,0.0663685502206
"Harrison County, West Virginia",2009,68363,40.2,32046,3836,28210,39395,2.42336051046,0.0561122244489
"Harrison County, West Virginia",2012,68959,41.7,31489,3728,27761,41799,2.48402435071,0.0540611087748
"Harrison County, West Virginia",2015,68998,42,31519,4017,27502,43987,2.50883572104,0.0582190788139
"Harrisonburg city, Virginia",2009,43983,22.4,15658,1299,14359,33587,3.0630963159,0.0295341381898
"Harrisonburg city, Virginia",2012,49043,22.7,17313,1979,15334,36853,3.19831746446,0.0403523438615
"Harrisonburg city, Virginia",2015,51388,23.5,17942,1533,16409,38750,3.13169602048,0.029831867362
"Hart County, Georgia",2009,24088,41.7,12060,2957,9103,38132,2.64616060639,0.122758219861
"Hart County, Georgia",2012,25277,42.8,12941,2992,9949,35647,2.5406573525,0.118368477272
"Hart County, Georgia",2015,25498,43.2,12963,3008,9955,37653,2.56132596685,0.117970036866
"Hart County, Kentucky",2009,18288,39,8377,1316,7061,29743,2.59000141623,0.0719597550306
"Hart County, Kentucky",2012,18278,40.6,8556,1599,6957,32445,2.62728187437,0.0874822190612
"Hart County, Kentucky",2015,18441,40.9,8710,1416,7294,34774,2.52824239101,0.076785423784
"Hartford County, Connecticut",2009,874409,39.2,363334,23818,339516,62829,2.57545741585,0.0272389694068
"Hartford County, Connecticut",2012,893504,39.9,373676,24518,349158,64752,2.55902485408,0.0274402800659
"Hartford County, Connecticut",2015,896943,40.1,374453,28091,346362,66395,2.58961144698,0.0313186010705
"Hartley County, Texas",2009,5089,40,1641,182,1459,57083,3.48800548321,0.0357634112792
"Hartley County, Texas",2012,6015,39.2,1952,235,1717,63407,3.5032032615,0.0390689941812
"Hartley County, Texas",2015,6121,39.3,1976,207,1769,63004,3.46014697569,0.0338180035942
"Harvey County, Kansas",2009,33699,38.5,14170,954,13216,47344,2.54986380145,0.0283094453841
"Harvey County, Kansas",2012,34572,39.7,14517,1313,13204,49075,2.61829748561,0.0379787110957
"Harvey County, Kansas",2015,34835,38.6,14602,1021,13581,51327,2.56498048745,0.0293096024114
"Haskell County, Kansas",2009,4043,33,1691,308,1383,52649,2.92335502531,0.076181053673
"Haskell County, Kansas",2012,4222,34.3,1666,243,1423,52688,2.96697118763,0.0575556608243
"Haskell County, Kansas",2015,4130,36.1,1660,265,1395,56484,2.9605734767,0.0641646489104
"Haskell County, Oklahoma",2009,12154,38.7,5854,1280,4574,34274,2.65719282903,0.105315122593
"Haskell County, Oklahoma",2012,12761,39.6,6007,1304,4703,37771,2.71337444185,0.102186349032
"Haskell County, Oklahoma",2015,12850,40,6046,1143,4903,35252,2.62084438099,0.0889494163424
"Haskell County, Texas",2009,5185,46.8,3577,1081,2496,32139,2.07732371795,0.208486017358
"Haskell County, Texas",2012,5891,43.5,3457,977,2480,40247,2.37540322581,0.165846206077
"Haskell County, Texas",2015,5853,43.4,3434,1149,2285,39850,2.56148796499,0.196309584828
"Hatillo Municipio, Puerto Rico",2009,43059,34.9,14356,2004,12352,14698,3.48599417098,0.0465407928656
"Hatillo Municipio, Puerto Rico",2012,41945,37.1,15703,2594,13109,18669,3.19971012282,0.0618428894982
"Hatillo Municipio, Puerto Rico",2015,41578,39.4,16821,2484,14337,18687,2.90004882472,0.0597431333878
"Hawaii County, Hawaii",2009,172370,39.4,76893,13684,63209,55645,2.72698508124,0.0793873643906
"Hawaii County, Hawaii",2012,185399,40.6,82411,17855,64556,52098,2.87190965983,0.0963058053172
"Hawaii County, Hawaii",2015,191482,41.1,84656,19608,65048,52108,2.94370311155,0.102401270093
"Hawkins County, Tennessee",2009,56957,41,26131,3354,22777,34310,2.5006366071,0.0588865284337
"Hawkins County, Tennessee",2012,56725,42.3,26818,3351,23467,36419,2.41722418716,0.0590744821507
"Hawkins County, Tennessee",2015,56595,43.4,26834,3667,23167,36927,2.44291449044,0.0647937096917
"Hayes County, Nebraska",2009,1044,46.1,573,71,502,39427,2.0796812749,0.0680076628352
"Hayes County, Nebraska",2012,1037,45.5,506,81,425,47150,2.44,0.0781099324976
"Hayes County, Nebraska",2015,1084,48,543,61,482,44500,2.2489626556,0.0562730627306
"Hays County, Texas",2009,141371,28.1,49064,4036,45028,52409,3.13962423381,0.028548995197
"Hays County, Texas",2012,158464,30.4,59870,5327,54543,57834,2.90530407202,0.0336164680937
"Hays County, Texas",2015,177562,30.9,67463,6103,61360,58583,2.89377444589,0.034371092914
"Haywood County, North Carolina",2009,56535,44.6,31888,7013,24875,39676,2.2727638191,0.1240470505
"Haywood County, North Carolina",2012,58915,45.7,34800,8331,26469,42089,2.22581132646,0.141407111941
"Haywood County, North Carolina",2015,59170,46.8,35086,8975,26111,42257,2.26609474934,0.151681595403
"Haywood County, Tennessee",2009,19155,37.6,8522,905,7617,30821,2.51476959433,0.0472461498303
"Haywood County, Tennessee",2012,18673,39.9,8317,1213,7104,32827,2.62851914414,0.0649601028223
"Haywood County, Tennessee",2015,18248,39.9,8371,1363,7008,34182,2.60388127854,0.0746931170539
"Heard County, Georgia",2009,11423,37.2,4905,827,4078,40640,2.80112800392,0.0723977939245
"Heard County, Georgia",2012,11756,39.4,5137,795,4342,39947,2.7075080608,0.0676250425315
"Heard County, Georgia",2015,11617,40.1,5114,778,4336,41525,2.67919741697,0.0669708186279
"Hemphill County, Texas",2009,3363,43.5,1769,247,1522,60435,2.20959264126,0.0734463276836
"Hemphill County, Texas",2012,3863,36.3,1726,321,1405,53295,2.74946619217,0.0830960393477
"Hemphill County, Texas",2015,4115,34.4,1725,259,1466,62813,2.80695770805,0.0629404617254
"Hempstead County, Arkansas",2009,23094,36.2,10687,1738,8949,35518,2.58062353336,0.0752576426778
"Hempstead County, Arkansas",2012,22548,38.6,10425,1850,8575,31193,2.62950437318,0.0820471882207
"Hempstead County, Arkansas",2015,22336,39.1,10424,2601,7823,32122,2.85517065065,0.116448782235
"Henderson County, Illinois",2009,7550,45.2,4268,684,3584,39536,2.10658482143,0.0905960264901
"Henderson County, Illinois",2012,7275,47.6,3852,633,3219,49612,2.26001863933,0.0870103092784
"Henderson County, Illinois",2015,7042,49.1,3811,717,3094,47672,2.27601809955,0.101817665436
"Henderson County, Kentucky",2009,45274,39,20717,1820,18897,41315,2.39583002593,0.0401996731016
"Henderson County, Kentucky",2012,46254,39.4,20302,1637,18665,42266,2.47811411733,0.0353915337052
"Henderson County, Kentucky",2015,46396,40.1,20421,1679,18742,41036,2.47550955074,0.0361884645228
"Henderson County, North Carolina",2009,100333,44.6,49722,7400,42322,44899,2.37070554322,0.0737543978551
"Henderson County, North Carolina",2012,106577,45.3,54510,9513,44997,46503,2.36853568016,0.0892594086904
"Henderson County, North Carolina",2015,109719,46.3,55199,9120,46079,46448,2.38110636082,0.0831214283761
"Henderson County, Tennessee",2009,26687,38.8,12153,1519,10634,39294,2.50959187512,0.0569190991869
"Henderson County, Tennessee",2012,27835,39.5,12768,1665,11103,37784,2.50698009547,0.0598167774385
"Henderson County, Tennessee",2015,28013,40.7,12814,2005,10809,38745,2.59163659913,0.0715739121122
"Henderson County, Texas",2009,78775,41.6,38435,8041,30394,38632,2.59179443311,0.102075531577
"Henderson County, Texas",2012,78558,42.7,39543,9232,30311,41100,2.59173237439,0.117518266758
"Henderson County, Texas",2015,79016,43.4,39867,10087,29780,41607,2.65332437878,0.127657689582
"Hendricks County, Indiana",2009,133949,36.5,54162,3528,50634,65246,2.64543587313,0.0263383825187
"Hendricks County, Indiana",2012,145880,36.8,55625,3503,52122,68283,2.7988181574,0.0240128873046
"Hendricks County, Indiana",2015,153435,37.4,57616,2964,54652,70163,2.80749103418,0.0193176263564
"Hendry County, Florida",2009,39244,30.6,13310,2537,10773,37354,3.64281073053,0.0646468249924
"Hendry County, Florida",2012,38669,32.6,14480,3560,10920,35736,3.54111721612,0.0920634099666
"Hendry County, Florida",2015,38363,33.8,14408,3063,11345,36771,3.38148964301,0.0798425566301
"Hennepin County, Minnesota",2009,1136224,35.8,501738,31968,469770,61387,2.41868148243,0.0281352972653
"Hennepin County, Minnesota",2012,1158039,35.9,510246,31683,478563,63559,2.4198256029,0.0273591822037
"Hennepin County, Minnesota",2015,1197776,36.1,518332,28136,490196,65834,2.44346343095,0.0234902018407
"Henrico County, Virginia",2009,289171,37,125439,8121,117318,59807,2.46484767896,0.0280837290046
"Henrico County, Virginia",2012,307576,37.5,132613,9221,123392,61300,2.49267375519,0.0299795822821
"Henrico County, Virginia",2015,318864,37.9,134346,9757,124589,61934,2.5593270674,0.0305992523458
"Henry County, Alabama",2009,16580,41.6,8388,2076,6312,35792,2.62674271229,0.125211097708
"Henry County, Alabama",2012,17275,42.9,8878,1973,6905,40680,2.5018102824,0.114211287988
"Henry County, Alabama",2015,17252,43,8960,2066,6894,41997,2.50246591239,0.119754231393
"Henry County, Georgia",2009,182952,33.7,70180,7524,62656,65002,2.91994382022,0.0411255411255
"Henry County, Georgia",2012,203185,35.5,76357,7631,68726,62377,2.95645025172,0.0375569062677
"Henry County, Georgia",2015,211512,36.3,77281,7000,70281,60424,3.00951893115,0.0330950489807
"Henry County, Illinois",2009,49523,42.1,21739,1444,20295,48618,2.4401576743,0.0291581689316
"Henry County, Illinois",2012,50378,41.9,22135,1625,20510,52284,2.45626523647,0.0322561435547
"Henry County, Illinois",2015,49883,42.2,22112,1942,20170,53480,2.47312840853,0.0389310987711
"Henry County, Indiana",2009,47481,40.4,21473,2245,19228,41816,2.46936758893,0.047282070723
"Henry County, Indiana",2012,49381,41.8,21290,2549,18741,40197,2.63491809402,0.0516190437618
"Henry County, Indiana",2015,49146,42.2,21171,3161,18010,41855,2.72881732371,0.0643185610223
"Henry County, Iowa",2009,20078,39.3,8554,526,8028,42136,2.50099651221,0.026197828469
"Henry County, Iowa",2012,20242,39.8,8297,723,7574,43843,2.67256403486,0.0357178144452
"Henry County, Iowa",2015,20080,40.7,8251,628,7623,49321,2.63413354322,0.0312749003984
"Henry County, Kentucky",2009,15842,40.2,7008,743,6265,43491,2.52865123703,0.0469006438581
"Henry County, Kentucky",2012,15428,40.6,6674,656,6018,43083,2.56364240611,0.0425200933368
"Henry County, Kentucky",2015,15455,41.3,6649,657,5992,46495,2.57927236315,0.0425105143966
"Henry County, Missouri",2009,22294,43,10701,1247,9454,36250,2.35815527819,0.0559343321073
"Henry County, Missouri",2012,22234,43.9,10899,1351,9548,39551,2.32865521575,0.0607627957183
"Henry County, Missouri",2015,22034,44.1,10897,1379,9518,42181,2.3149821391,0.0625850957611
"Henry County, Ohio",2009,28976,38.5,12222,875,11347,49417,2.55362650921,0.0301974047488
"Henry County, Ohio",2012,28246,39.6,11963,812,11151,49423,2.53304636355,0.0287474332649
"Henry County, Ohio",2015,28015,41.2,11933,975,10958,53835,2.55657966782,0.0348027842227
"Henry County, Tennessee",2009,31567,43.3,16713,3169,13544,36408,2.33069994093,0.100389647417
"Henry County, Tennessee",2012,32271,44.1,17042,3728,13314,36593,2.42383956737,0.115521675808
"Henry County, Tennessee",2015,32269,44.9,17007,3536,13471,38234,2.39544206072,0.109578852769
"Henry County, Virginia",2009,55480,42.1,26669,3432,23237,34437,2.38757154538,0.0618601297765
"Henry County, Virginia",2012,53971,44.5,26282,3548,22734,34373,2.3740212897,0.0657390079858
"Henry County, Virginia",2015,52580,46,26144,3729,22415,35293,2.34575061343,0.0709205020921
"Herkimer County, New York",2009,62439,41.3,32632,7119,25513,42048,2.44734057147,0.114015278912
"Herkimer County, New York",2012,64475,42.3,33333,6558,26775,44288,2.40802987862,0.101713842575
"Herkimer County, New York",2015,64034,42.9,33345,7215,26130,46229,2.45059318791,0.112674516663
"Hernando County, Florida",2009,166338,47,78816,11376,67440,42457,2.46645907473,0.0683908667893
"Hernando County, Florida",2012,172784,47.8,84377,13760,70617,41098,2.446776272,0.0796370034262
"Hernando County, Florida",2015,174809,48.7,84630,14178,70452,40945,2.48124964515,0.081105663896
"Hertford County, North Carolina",2009,23281,38.8,10034,1462,8572,30958,2.71593560429,0.0627979897771
"Hertford County, North Carolina",2012,24525,40.9,10591,1732,8859,33412,2.76837114799,0.070621814475
"Hertford County, North Carolina",2015,24368,41.7,10564,1913,8651,33008,2.8167841868,0.0785045961917
"Hettinger County, North Dakota",2009,2407,51.3,1485,288,1197,39018,2.01086048454,0.119651017865
"Hettinger County, North Dakota",2012,2502,50.9,1402,296,1106,45000,2.26220614828,0.118305355715
"Hettinger County, North Dakota",2015,2621,48.4,1422,331,1091,52169,2.40238313474,0.126287676459
"Hickman County, Kentucky",2009,4923,43.2,2543,425,2118,30932,2.32436260623,0.086329473898
"Hickman County, Kentucky",2012,4869,44.7,2343,363,1980,36125,2.45909090909,0.0745532963648
"Hickman County, Kentucky",2015,4720,47.7,2335,362,1973,41218,2.39229599595,0.0766949152542
"Hickman County, Tennessee",2009,23670,38.2,9367,1120,8247,37880,2.8701345944,0.0473172792564
"Hickman County, Tennessee",2012,24481,40.4,10260,1490,8770,42330,2.79144811859,0.0608635268167
"Hickman County, Tennessee",2015,24283,40.7,10281,1512,8769,36334,2.76918690843,0.0622657826463
"Hickory County, Missouri",2009,9022,51.2,6519,2399,4120,28685,2.18980582524,0.265905564176
"Hickory County, Missouri",2012,9554,52.7,6803,2544,4259,29400,2.24324958911,0.26627590538
"Hickory County, Missouri",2015,9335,53.5,6754,2649,4105,32122,2.27405602923,0.283770755222
"Hidalgo County, New Mexico",2009,5001,39.1,2680,804,1876,39020,2.6657782516,0.160767846431
"Hidalgo County, New Mexico",2012,4903,40.2,2406,582,1824,37531,2.68804824561,0.118702834999
"Hidalgo County, New Mexico",2015,4643,41.8,2383,555,1828,34444,2.53993435449,0.119534783545
"Hidalgo County, Texas",2009,702697,27.4,246498,37899,208599,30076,3.36864989765,0.0539336299998
"Hidalgo County, Texas",2012,774820,28.3,249609,35213,214396,33218,3.61396667848,0.0454466843912
"Hidalgo County, Texas",2015,819217,28.8,258126,34105,224021,34782,3.65687591788,0.0416312161491
"Highland County, Ohio",2009,42384,37.4,18376,2515,15861,40138,2.67221486665,0.0593384295961
"Highland County, Ohio",2012,43454,39,19308,2339,16969,39641,2.56078731805,0.0538270354858
"Highland County, Ohio",2015,43170,40.1,19256,2560,16696,39858,2.58564925731,0.0593004401205
"Highland County, Virginia",2009,2399,50.8,2017,870,1147,43537,2.09154315606,0.362651104627
"Highland County, Virginia",2012,2317,56.5,1866,814,1052,50136,2.20247148289,0.351316357359
"Highland County, Virginia",2015,2244,59,1918,847,1071,43914,2.09523809524,0.377450980392
"Highlands County, Florida",2009,97738,49.7,54374,13881,40493,33902,2.41370113353,0.142022550083
"Highlands County, Florida",2012,98734,51.4,55363,15506,39857,35350,2.47720601149,0.157048230599
"Highlands County, Florida",2015,98328,52.1,55066,14669,40397,35093,2.43404213184,0.149184362542
"Hill County, Montana",2009,16434,34.8,7464,1281,6183,44833,2.65793304221,0.0779481562614
"Hill County, Montana",2012,16157,35.2,7262,1132,6130,42875,2.63572593801,0.0700625116049
"Hill County, Montana",2015,16523,34.3,7232,1140,6092,44633,2.71224556796,0.0689947346124
"Hill County, Texas",2009,35279,38.6,15205,2759,12446,38159,2.83456532219,0.0782051645455
"Hill County, Texas",2012,35079,41.2,16098,2595,13503,39405,2.59786714064,0.0739758830069
"Hill County, Texas",2015,34923,42.4,16134,3232,12902,41382,2.70678964502,0.0925464593534
"Hillsborough County, Florida",2009,1167116,35.3,512684,56920,455764,49594,2.56079023354,0.048769788093
"Hillsborough County, Florida",2012,1238365,36.1,536002,69237,466765,49450,2.65308024381,0.0559100103766
"Hillsborough County, Florida",2015,1302884,36.6,549024,62946,486078,50579,2.68040108789,0.0483128198673
"Hillsborough County, New Hampshire",2009,402576,37.8,161578,11276,150302,68513,2.67844739258,0.0280096180597
"Hillsborough County, New Hampshire",2012,401101,39.2,165960,12213,153747,70472,2.60883789602,0.0304486899808
"Hillsborough County, New Hampshire",2015,403972,40.1,167207,11999,155208,71244,2.60277820731,0.0297025536423
"Hillsdale County, Michigan",2009,46300,38.9,21817,3937,17880,42829,2.58948545861,0.0850323974082
"Hillsdale County, Michigan",2012,46617,40.8,21748,4191,17557,42668,2.65518026998,0.0899028251496
"Hillsdale County, Michigan",2015,46178,42,21667,3857,17810,41961,2.59281302639,0.0835246221144
"Hinds County, Mississippi",2009,248782,32.4,105916,14694,91222,38541,2.72721492622,0.0590637586321
"Hinds County, Mississippi",2012,246335,33,103589,15392,88197,38152,2.7930088325,0.0624840156697
"Hinds County, Mississippi",2015,245874,33.6,104012,15250,88762,37324,2.77003672743,0.0620236381236
"Hinsdale County, Colorado",2009,554,34.2,1530,1335,195,53750,2.84102564103,2.40974729242
"Hinsdale County, Colorado",2012,790,56.5,1525,1153,372,54844,2.12365591398,1.45949367089
"Hinsdale County, Colorado",2015,874,55.2,1433,1036,397,57083,2.20151133501,1.18535469108
"Hitchcock County, Nebraska",2009,2858,47.9,1681,434,1247,36307,2.29190056135,0.151854443667
"Hitchcock County, Nebraska",2012,2898,49.1,1756,400,1356,40000,2.13716814159,0.138026224983
"Hitchcock County, Nebraska",2015,2879,48.2,1753,411,1342,39231,2.14530551416,0.142757902049
"Hocking County, Ohio",2009,28857,39.8,12564,1626,10938,40618,2.63823368075,0.0563468135981
"Hocking County, Ohio",2012,29372,41.9,13372,1810,11562,40556,2.54039093582,0.0616233147215
"Hocking County, Ohio",2015,28914,42.6,13351,1964,11387,42170,2.5392113814,0.0679255723871
"Hockley County, Texas",2009,22359,33.9,9407,1170,8237,45384,2.71445914775,0.0523279216423
"Hockley County, Texas",2012,22988,32.9,9297,1319,7978,51054,2.88142391577,0.0573777623108
"Hockley County, Texas",2015,23322,32.8,9290,1201,8089,50665,2.88317468167,0.0514964411285
"Hodgeman County, Kansas",2009,1960,46.4,1064,194,870,41078,2.25287356322,0.0989795918367
"Hodgeman County, Kansas",2012,1949,47.9,1035,225,810,44318,2.40617283951,0.115443817342
"Hodgeman County, Kansas",2015,1939,47.8,1034,223,811,54856,2.39087546239,0.115007735946
"Hoke County, North Carolina",2009,42410,30.8,15897,2404,13493,41595,3.14311124287,0.0566847441641
"Hoke County, North Carolina",2012,47368,30.8,18261,2880,15381,46900,3.07964371627,0.0608005404492
"Hoke County, North Carolina",2015,51075,31.4,19529,2539,16990,41542,3.00618010594,0.0497112090064
"Holmes County, Florida",2009,19065,40.2,8409,1570,6839,33868,2.78768825852,0.0823498557566
"Holmes County, Florida",2012,19971,42.1,8612,1865,6747,34928,2.95998221432,0.0933854088428
"Holmes County, Florida",2015,19635,42.1,8598,1770,6828,35020,2.87565905097,0.0901451489687
"Holmes County, Mississippi",2009,20481,30.2,8905,1823,7082,21821,2.89197966676,0.0890093257165
"Holmes County, Mississippi",2012,19207,32.2,8433,1829,6604,22335,2.90838885524,0.0952256989639
"Holmes County, Mississippi",2015,18772,33.5,8419,1999,6420,20732,2.92398753894,0.106488386959
"Holmes County, Ohio",2009,41452,29.2,12694,1253,11441,45171,3.62310986802,0.0302277332819
"Holmes County, Ohio",2012,42501,29.7,13612,1429,12183,44091,3.48854961832,0.0336227382885
"Holmes County, Ohio",2015,43436,30.4,13607,922,12685,51996,3.42420181317,0.0212266322866
"Holt County, Missouri",2009,4937,44.8,2960,673,2287,39019,2.15872321819,0.136317601782
"Holt County, Missouri",2012,4840,46.1,2807,574,2233,42706,2.16748768473,0.118595041322
"Holt County, Missouri",2015,4615,47.4,2779,649,2130,42500,2.16666666667,0.140628385699
"Holt County, Nebraska",2009,10258,45.5,5353,969,4384,37625,2.33987226277,0.094462858257
"Holt County, Nebraska",2012,10418,45.9,5229,915,4314,47768,2.41492814094,0.087828757919
"Holt County, Nebraska",2015,10398,45.5,5210,690,4520,46728,2.30044247788,0.066358915176
"Honolulu County, Hawaii",2009,902564,36.9,334469,30675,303794,67066,2.97097375195,0.0339865095439
"Honolulu County, Hawaii",2012,955215,37.7,337389,28899,308490,72292,3.09642127784,0.0302539218919
"Honolulu County, Hawaii",2015,984178,36.9,341239,31637,309602,74460,3.17884897384,0.0321456078067
"Hood County, Texas",2009,49360,44.1,20660,3167,17493,52870,2.82170010861,0.0641612641815
"Hood County, Texas",2012,51161,46.2,24715,4084,20631,54902,2.4798119335,0.0798264302887
"Hood County, Texas",2015,53171,46.9,25350,4418,20932,56100,2.54017771833,0.0830904064246
"Hood River County, Oregon",2009,21316,37.1,8779,889,7890,49795,2.70164765526,0.0417057609308
"Hood River County, Oregon",2012,22207,37.8,9280,1253,8027,56355,2.76653793447,0.0564236502004
"Hood River County, Oregon",2015,22749,39.4,9458,1269,8189,55827,2.77799487117,0.0557826717658
"Hooker County, Nebraska",2009,661,51.5,412,87,325,35547,2.03384615385,0.131618759455
"Hooker County, Nebraska",2012,689,47.8,427,133,294,38750,2.34353741497,0.193033381713
"Hooker County, Nebraska",2015,681,57.9,440,128,312,37317,2.18269230769,0.187958883994
"Hoonah-Angoon Census Area, Alaska",2009,2042,43.3,1785,809,976,43208,2.09221311475,0.396180215475
"Hoonah-Angoon Census Area, Alaska",2012,2153,48.3,1797,798,999,48942,2.15515515516,0.370645610776
"Hoonah-Angoon Census Area, Alaska",2015,2128,47.8,1661,769,892,52419,2.38565022422,0.361372180451
"Hopewell city, Virginia",2009,22933,35,10202,1180,9022,38892,2.54189758368,0.0514542362534
"Hopewell city, Virginia",2012,22501,35.9,10116,1430,8686,37029,2.59049044439,0.0635527309897
"Hopewell city, Virginia",2015,22279,36.9,10223,1517,8706,39064,2.55903974271,0.0680910274249
"Hopkins County, Kentucky",2009,46234,40.6,21672,2929,18743,39096,2.46673424745,0.0633516459748
"Hopkins County, Kentucky",2012,46891,40.3,21236,2680,18556,40501,2.52699935331,0.0571538248278
"Hopkins County, Kentucky",2015,46518,40.8,21257,2635,18622,42346,2.49801310278,0.0566447396707
"Hopkins County, Texas",2009,33864,38.1,14707,2021,12686,39966,2.66939933785,0.0596798960548
"Hopkins County, Texas",2012,35088,39.1,15014,1752,13262,42257,2.64575478812,0.0499316005472
"Hopkins County, Texas",2015,35645,39.2,15142,1869,13273,44396,2.68552700972,0.0524337214196
"Hormigueros Municipio, Puerto Rico",2009,17524,40,7113,967,6146,19644,2.85128538887,0.0551814654189
"Hormigueros Municipio, Puerto Rico",2012,17217,42,7216,882,6334,20428,2.7181875592,0.0512284370099
"Hormigueros Municipio, Puerto Rico",2015,16845,44,7559,1141,6418,20598,2.6246494235,0.0677352330068
"Horry County, South Carolina",2009,248601,41,164597,57864,106733,42642,2.32918591251,0.232758516659
"Horry County, South Carolina",2012,270943,41.4,185438,72026,113412,42183,2.38901527175,0.265834511318
"Horry County, South Carolina",2015,290730,43,191102,72364,118738,43299,2.44850005895,0.248904481822
"Hot Spring County, Arkansas",2009,31621,39,13950,2290,11660,36095,2.71192109777,0.0724202270643
"Hot Spring County, Arkansas",2012,33011,39.6,14309,2038,12271,39652,2.69016380083,0.0617369967587
"Hot Spring County, Arkansas",2015,33316,40.9,14293,2157,12136,40000,2.74522083059,0.0647436667067
"Hot Springs County, Wyoming",2009,4523,49,2632,386,2246,45714,2.01380231523,0.085341587442
"Hot Springs County, Wyoming",2012,4791,49,2593,421,2172,41786,2.20580110497,0.0878730953872
"Hot Springs County, Wyoming",2015,4809,49.6,2571,389,2182,45278,2.20394133822,0.0808899979206
"Houghton County, Michigan",2009,35214,33.8,18476,4467,14009,31824,2.51366978371,0.126852956211
"Houghton County, Michigan",2012,36519,33.1,18618,4488,14130,34453,2.58450106157,0.122894931406
"Houghton County, Michigan",2015,36660,32.8,18603,4838,13765,37776,2.66327642572,0.131969448991
"Houston County, Alabama",2009,97091,38.2,43362,6381,36981,41096,2.62542927449,0.065721848575
"Houston County, Alabama",2012,101459,38.3,45310,6578,38732,41828,2.6195135805,0.0648340709055
"Houston County, Alabama",2015,103534,39,46097,6900,39197,41571,2.64137561548,0.0666447736975
"Houston County, Georgia",2009,130910,34.1,56712,6590,50122,54037,2.61182714177,0.0503399281949
"Houston County, Georgia",2012,140699,34.4,58429,6701,51728,56265,2.71997757501,0.0476264934363
"Houston County, Georgia",2015,147570,34.8,59989,6218,53771,53270,2.74441613509,0.0421359354882
"Houston County, Minnesota",2009,19463,42.8,8645,752,7893,51945,2.46585582161,0.0386374145815
"Houston County, Minnesota",2012,19001,44,8599,788,7811,53453,2.43259505825,0.0414715014999
"Houston County, Minnesota",2015,18812,45,8625,739,7886,53809,2.38549327923,0.0392834361046
"Houston County, Tennessee",2009,8041,41.7,4110,842,3268,31858,2.46052631579,0.104713344111
"Houston County, Tennessee",2012,8375,41.3,4184,658,3526,34595,2.37521270562,0.0785671641791
"Houston County, Tennessee",2015,8290,43.2,4173,926,3247,39401,2.55312596243,0.111700844391
"Houston County, Texas",2009,22612,41.3,11148,3096,8052,31911,2.80824639841,0.13691845038
"Houston County, Texas",2012,23512,44,11512,3629,7883,32859,2.98262082963,0.15434671657
"Houston County, Texas",2015,22949,44.5,11543,3497,8046,32698,2.85222470793,0.15238136738
"Howard County, Arkansas",2009,14253,39.2,6581,1118,5463,33180,2.60900604064,0.0784396267452
"Howard County, Arkansas",2012,13790,37.1,6268,1076,5192,35236,2.65600924499,0.0780275562001
"Howard County, Arkansas",2015,13555,38.6,6233,1184,5049,34229,2.68469003763,0.0873478421247
"Howard County, Indiana",2009,83685,39.1,39397,5063,34334,46901,2.4373798567,0.0605006871004
"Howard County, Indiana",2012,82914,40.7,38686,4518,34168,44452,2.42665652072,0.0544901946595
"Howard County, Indiana",2015,82765,41.5,38649,4236,34413,44226,2.40505041699,0.0511810547937
"Howard County, Iowa",2009,9488,43,4444,395,4049,44684,2.34329464065,0.04163153457
"Howard County, Iowa",2012,9568,42.4,4367,351,4016,45300,2.38247011952,0.0366847826087
"Howard County, Iowa",2015,9494,42.2,4366,499,3867,49869,2.45513317817,0.0525595112703
"Howard County, Maryland",2009,274328,37.5,103900,4906,98994,101003,2.77115784795,0.0178837012627
"Howard County, Maryland",2012,288676,38.3,109425,4520,104905,107821,2.75178494829,0.015657692361
"Howard County, Maryland",2015,304115,38.8,113490,4935,108555,110238,2.80148311916,0.0162274139717
"Howard County, Missouri",2009,9859,38.2,4462,713,3749,39870,2.62976793812,0.0723197078811
"Howard County, Missouri",2012,10160,39.7,4571,745,3826,42104,2.65551489807,0.0733267716535
"Howard County, Missouri",2015,10182,38.8,4541,812,3729,44820,2.73049074819,0.0797485759183
"Howard County, Nebraska",2009,6459,41.5,2998,262,2736,44104,2.36074561404,0.0405635547298
"Howard County, Nebraska",2012,6294,43.2,2960,331,2629,48293,2.39406618486,0.052589768033
"Howard County, Nebraska",2015,6347,43.3,2994,434,2560,50030,2.479296875,0.0683787616197
"Howard County, Texas",2009,32324,36.8,13799,2299,11500,36931,2.8107826087,0.0711236233139
"Howard County, Texas",2012,34927,37.5,13148,2069,11079,43393,3.15254084304,0.0592378389212
"Howard County, Texas",2015,36105,36.9,13116,1910,11206,49575,3.22193467785,0.0529012602133
"Howell County, Missouri",2009,38561,39.6,17381,2412,14969,32145,2.57605718485,0.0625502450663
"Howell County, Missouri",2012,40330,39.6,17994,2388,15606,34148,2.58426246316,0.0592115050831
"Howell County, Missouri",2015,40326,40.6,18054,1791,16263,32784,2.47961630695,0.0444130337747
"Hubbard County, Minnesota",2009,18675,45.8,13069,5216,7853,43999,2.37807207437,0.279303882195
"Hubbard County, Minnesota",2012,20372,47.1,14529,5950,8579,45623,2.37463573843,0.292067543687
"Hubbard County, Minnesota",2015,20574,48,14628,5841,8787,47486,2.34141345169,0.283902012248
"Hudson County, New Jersey",2009,593615,34.4,254164,23715,230449,53475,2.57590616579,0.0399501360309
"Hudson County, New Jersey",2012,636194,34.2,269862,26706,243156,58722,2.61640263864,0.0419777615004
"Hudson County, New Jersey",2015,662619,34.7,274423,24839,249584,59741,2.65489374319,0.0374860968369
"Hudspeth County, Texas",2009,3169,39,1538,483,1055,28292,3.00379146919,0.152414010729
"Hudspeth County, Texas",2012,3407,36.1,1533,436,1097,22083,3.10574293528,0.127971822718
"Hudspeth County, Texas",2015,3330,39.6,1533,565,968,26384,3.44008264463,0.16966966967
"Huerfano County, Colorado",2009,7713,45.7,5050,1656,3394,31136,2.27253977608,0.214702450408
"Huerfano County, Colorado",2012,6730,51.5,5074,1940,3134,32754,2.14741544352,0.288261515602
"Huerfano County, Colorado",2015,6502,53.5,5116,2092,3024,31715,2.15013227513,0.321747154722
"Hughes County, Oklahoma",2009,13684,40.7,6395,1101,5294,30856,2.58481299584,0.0804589301374
"Hughes County, Oklahoma",2012,13762,39.9,6185,1169,5016,34656,2.74362041467,0.0849440488301
"Hughes County, Oklahoma",2015,13785,40.2,6241,1787,4454,35563,3.09497081275,0.129633659775
"Hughes County, South Dakota",2009,16856,39.8,7466,559,6907,51444,2.44042275952,0.0331632653061
"Hughes County, South Dakota",2012,17064,40.6,7630,582,7048,59117,2.4211123723,0.0341068917018
"Hughes County, South Dakota",2015,17466,39.4,7758,641,7117,59177,2.45412392862,0.036699874041
"Humacao Municipio, Puerto Rico",2009,60682,36,23921,5149,18772,17773,3.23258043895,0.0848521802182
"Humacao Municipio, Puerto Rico",2012,58333,38.3,25192,6769,18423,19918,3.16631384682,0.11604066309
"Humacao Municipio, Puerto Rico",2015,56384,39.7,26730,8167,18563,19342,3.03744006895,0.144846055619
"Humboldt County, California",2009,129003,36.5,58962,6442,52520,39124,2.45626428027,0.0499368231747
"Humboldt County, California",2012,134317,37.5,61452,8145,53307,40830,2.51968784587,0.0606401274597
"Humboldt County, California",2015,135034,37.4,62156,9120,53036,42197,2.54608190663,0.0675385458477
"Humboldt County, Iowa",2009,9645,44.4,4739,412,4327,46420,2.22902703952,0.0427164333852
"Humboldt County, Iowa",2012,9818,44.4,4693,421,4272,48710,2.29822097378,0.0428804237116
"Humboldt County, Iowa",2015,9674,43.7,4671,481,4190,47252,2.30883054893,0.0497209013852
"Humboldt County, Nevada",2009,17630,36.7,7337,957,6380,55084,2.76332288401,0.0542824730573
"Humboldt County, Nevada",2012,16511,36.6,7119,863,6256,57874,2.63922634271,0.0522681848465
"Humboldt County, Nevada",2015,17067,35.3,7193,1044,6149,65212,2.77557326395,0.0611706802602
"Humphreys County, Mississippi",2009,9985,32.5,4232,505,3727,22259,2.67909847062,0.0505758637957
"Humphreys County, Mississippi",2012,9399,35.1,3869,710,3159,24783,2.97530864198,0.0755399510586
"Humphreys County, Mississippi",2015,8984,35.3,3835,778,3057,23216,2.93882891724,0.0865983971505
"Humphreys County, Tennessee",2009,18151,40.9,9000,1358,7642,41957,2.37516356975,0.0748168145006
"Humphreys County, Tennessee",2012,18428,40.7,8884,1361,7523,41943,2.44955469892,0.0738550032559
"Humphreys County, Tennessee",2015,18240,42.2,8888,1764,7124,41949,2.56035934868,0.0967105263158
"Hunt County, Texas",2009,82204,36.3,34667,5394,29273,42894,2.80818501691,0.0656172449029
"Hunt County, Texas",2012,85955,37.6,36581,5899,30682,45170,2.80147969494,0.0686289337444
"Hunt County, Texas",2015,88052,38,36836,6004,30832,45197,2.85586403736,0.0681869804207
"Hunterdon County, New Jersey",2009,129517,41.9,48686,1900,46786,102500,2.76828538452,0.0146698888949
"Hunterdon County, New Jersey",2012,127996,43.4,49587,2165,47422,105880,2.69908481296,0.016914591081
"Hunterdon County, New Jersey",2015,126250,45,49816,2917,46899,105444,2.69195505235,0.023104950495
"Huntingdon County, Pennsylvania",2009,45479,40.7,22068,5380,16688,41078,2.72525167785,0.11829635656
"Huntingdon County, Pennsylvania",2012,45931,41.5,22356,5474,16882,44455,2.72070844687,0.119178768152
"Huntingdon County, Pennsylvania",2015,45906,42.5,22411,5186,17225,44396,2.66507982583,0.112969982137
"Huntington County, Indiana",2009,37890,38.7,16142,1654,14488,45490,2.61526780784,0.0436526788071
"Huntington County, Indiana",2012,37144,39.3,15807,1583,14224,46538,2.61136107987,0.0426179194486
"Huntington County, Indiana",2015,36863,39.8,15864,1384,14480,46945,2.54578729282,0.0375444212354
"Huron County, Michigan",2009,33155,45.6,21349,6718,14631,39317,2.26607887362,0.202624038607
"Huron County, Michigan",2012,33001,46.8,21204,7192,14012,40349,2.35519554667,0.217932789915
"Huron County, Michigan",2015,32290,48,21171,7366,13805,42161,2.33900760594,0.228120161041
"Huron County, Ohio",2009,59997,37.2,24810,1701,23109,46898,2.59626119694,0.0283514175709
"Huron County, Ohio",2012,59628,37.6,25166,2493,22673,48335,2.62991223041,0.0418092171463
"Huron County, Ohio",2015,58937,38.8,25134,2607,22527,48745,2.616282683,0.0442336732443
"Hutchinson County, South Dakota",2009,7289,46.2,3575,452,3123,39066,2.3339737432,0.0620112498285
"Hutchinson County, South Dakota",2012,7283,46.9,3365,435,2930,44153,2.48566552901,0.0597281340107
"Hutchinson County, South Dakota",2015,7226,45.6,3353,411,2942,45075,2.45615227736,0.0568779407694
"Hutchinson County, Texas",2009,21681,37.7,10972,2221,8751,41703,2.47754542338,0.102439924358
"Hutchinson County, Texas",2012,21992,37.2,10628,2310,8318,46677,2.6439047848,0.105038195708
"Hutchinson County, Texas",2015,21858,37.3,10585,2288,8297,49353,2.63444618537,0.104675633635
"Hyde County, North Carolina",2009,5256,40.7,3101,1295,1806,40488,2.91029900332,0.246385083714
"Hyde County, North Carolina",2012,5810,40,3241,1259,1982,43608,2.93138244198,0.21669535284
"Hyde County, North Carolina",2015,5693,43,3406,1356,2050,42897,2.77707317073,0.238187247497
"Hyde County, South Dakota",2009,1481,44.9,782,156,626,36379,2.36581469649,0.105334233626
"Hyde County, South Dakota",2012,1437,42.6,729,163,566,46694,2.53886925795,0.113430758525
"Hyde County, South Dakota",2015,1413,47.4,686,141,545,51776,2.59266055046,0.0997876857749
"Iberia Parish, Louisiana",2009,74602,34.6,29663,3436,26227,40803,2.84447325275,0.0460577464411
"Iberia Parish, Louisiana",2012,73527,35.6,29726,3269,26457,44611,2.77911327815,0.0444598582834
"Iberia Parish, Louisiana",2015,73938,35.8,30002,3657,26345,45261,2.80652875308,0.0494603586789
"Iberville Parish, Louisiana",2009,32677,36.3,12709,1279,11430,40774,2.85888013998,0.039140679989
"Iberville Parish, Louisiana",2012,33386,38.1,12720,1738,10982,44037,3.04006556183,0.052057748757
"Iberville Parish, Louisiana",2015,33229,38.4,12914,1723,11191,45117,2.96926101331,0.0518522976918
"Ida County, Iowa",2009,6971,44.6,3543,365,3178,43171,2.19351793581,0.0523597762158
"Ida County, Iowa",2012,7113,44.8,3434,262,3172,43690,2.24243379571,0.0368339659778
"Ida County, Iowa",2015,7071,45.1,3410,309,3101,46993,2.28023218317,0.0436996181587
"Idaho County, Idaho",2009,15286,47,7760,1559,6201,34456,2.46508627641,0.101988747874
"Idaho County, Idaho",2012,16215,48.3,8680,2033,6647,37067,2.43944636678,0.125377736664
"Idaho County, Idaho",2015,16312,48.9,8680,2097,6583,38191,2.47789761507,0.128555664541
"Imperial County, California",2009,160034,30.8,52889,6484,46405,37595,3.44863700032,0.0405163902671
"Imperial County, California",2012,173487,31.8,55896,7968,47928,41255,3.61974211317,0.0459285133756
"Imperial County, California",2015,178206,32.2,56709,10257,46452,41079,3.83634719711,0.0575569846133
"Independence County, Arkansas",2009,34462,39.3,15588,1157,14431,34798,2.38805349595,0.0335732110731
"Independence County, Arkansas",2012,36572,38,16158,1325,14833,34374,2.46558349626,0.0362299026578
"Independence County, Arkansas",2015,36952,38.7,16248,2010,14238,36265,2.59530832982,0.054394890669
"Indian River County, Florida",2009,131811,47.2,75669,16196,59473,46550,2.21631664789,0.122872901351
"Indian River County, Florida",2012,138203,48.9,76433,18105,58328,45274,2.36941091757,0.131002944943
"Indian River County, Florida",2015,142866,50.7,77059,19234,57825,45798,2.4706614786,0.134629652962
"Indiana County, Pennsylvania",2009,87629,38.4,38540,3908,34632,38546,2.53028990529,0.0445971082632
"Indiana County, Pennsylvania",2012,88648,38.2,38240,3757,34483,43408,2.57077400458,0.0423811027886
"Indiana County, Pennsylvania",2015,87895,38.9,38457,4396,34061,45195,2.58051730718,0.0500142215143
"Ingham County, Michigan",2009,278804,30.4,120880,12722,108158,45606,2.57774736959,0.0456306222292
"Ingham County, Michigan",2012,281323,31.3,121359,12914,108445,45567,2.59415371847,0.0459045296687
"Ingham County, Michigan",2015,283491,31.5,121722,11304,110418,45679,2.56743465739,0.0398742817232
"Inyo County, California",2009,17438,44.5,9131,1330,7801,44952,2.23535444174,0.0762702144741
"Inyo County, California",2012,18474,45.7,9449,1539,7910,45000,2.33552465234,0.0833062682689
"Inyo County, California",2015,18373,45.7,9502,1545,7957,45955,2.30903606887,0.0840907853916
"Ionia County, Michigan",2009,63685,35.3,24083,2138,21945,46712,2.90202779676,0.033571484651
"Ionia County, Michigan",2012,64149,36.5,24722,2274,22448,47580,2.85767106201,0.0354487209465
"Ionia County, Michigan",2015,64064,37.9,24634,2542,22092,49124,2.89987325729,0.0396790709291
"Iosco County, Michigan",2009,26257,49,21229,9485,11744,36628,2.23577997275,0.361237003466
"Iosco County, Michigan",2012,25880,51.1,20469,9591,10878,35396,2.37911380769,0.370595054096
"Iosco County, Michigan",2015,25401,52,20391,9048,11343,37317,2.23935466808,0.356206448565
"Iowa County, Iowa",2009,15840,41.6,6825,434,6391,55496,2.47848537005,0.027398989899
"Iowa County, Iowa",2012,16320,42.3,7224,507,6717,57318,2.42965609647,0.0310661764706
"Iowa County, Iowa",2015,16344,42.4,7255,436,6819,59375,2.39683238011,0.0266764561919
"Iowa County, Wisconsin",2009,23513,40.4,10600,1007,9593,54298,2.45105806317,0.042827372092
"Iowa County, Wisconsin",2012,23712,41.4,10717,1105,9612,55900,2.46691635456,0.046600877193
"Iowa County, Wisconsin",2015,23769,42.9,10764,1075,9689,55188,2.4531943441,0.0452269763137
"Iredell County, North Carolina",2009,150346,38.1,66821,9171,57650,48234,2.60790980052,0.0609992949596
"Iredell County, North Carolina",2012,159614,39,68908,9315,59593,50058,2.67840182572,0.058359542396
"Iredell County, North Carolina",2015,165066,39.9,69904,9011,60893,52306,2.71075493078,0.0545902850981
"Irion County, Texas",2009,1678,41.1,914,259,655,43536,2.56183206107,0.154350417163
"Irion County, Texas",2012,1596,39.3,814,227,587,48646,2.71890971039,0.142230576441
"Irion County, Texas",2015,1644,44.9,873,215,658,58500,2.49848024316,0.130778588808
"Iron County, Michigan",2009,11923,48.9,9055,3616,5439,34083,2.19213090642,0.303279375996
"Iron County, Michigan",2012,11837,51.6,9204,3928,5276,35551,2.24355572403,0.33184083805
"Iron County, Michigan",2015,11507,53.3,9256,3864,5392,33663,2.13408753709,0.335795602677
"Iron County, Missouri",2009,10083,40.3,5088,931,4157,29904,2.42554726967,0.0923336308638
"Iron County, Missouri",2012,10563,42.8,5310,1102,4208,33333,2.51021863118,0.104326422418
"Iron County, Missouri",2015,10322,43.1,5293,1247,4046,36239,2.55116164113,0.120809920558
"Iron County, Utah",2009,42752,24.4,17758,3454,14304,41707,2.98881431767,0.0807915419162
"Iron County, Utah",2012,45984,26.6,19595,4098,15497,42296,2.96728399045,0.089117954071
"Iron County, Utah",2015,47139,28.1,19984,4889,15095,43855,3.12282212653,0.103714546342
"Iron County, Wisconsin",2009,6267,48.7,5901,2803,3098,34401,2.02291801162,0.447263443434
"Iron County, Wisconsin",2012,5978,51,5892,2889,3003,37112,1.99067599068,0.483271997324
"Iron County, Wisconsin",2015,5907,52.4,6009,3099,2910,42543,2.02989690722,0.524631792788
"Iroquois County, Illinois",2009,30017,42.7,13621,1719,11902,46762,2.52201310704,0.0572675483892
"Iroquois County, Illinois",2012,29689,43.2,13460,1525,11935,47908,2.48755760369,0.0513658257267
"Iroquois County, Illinois",2015,29053,44.1,13409,1580,11829,47834,2.45608250909,0.0543833683269
"Irwin County, Georgia",2009,10138,37.5,4215,782,3433,37328,2.95310224294,0.0771355296903
"Irwin County, Georgia",2012,9646,37.2,4046,861,3185,38770,3.02857142857,0.089259796807
"Irwin County, Georgia",2015,9408,39,4024,762,3262,34156,2.88412017167,0.0809948979592
"Isabela Municipio, Puerto Rico",2009,47716,36.6,17077,3256,13821,12903,3.45242746545,0.0682370693269
"Isabela Municipio, Puerto Rico",2012,45567,38,18766,3853,14913,14570,3.05552202776,0.0845568064608
"Isabela Municipio, Puerto Rico",2015,44438,40,20400,5097,15303,15707,2.90387505718,0.114699131374
"Isabella County, Michigan",2009,66652,24.1,28703,3853,24850,36726,2.68217303823,0.0578077176979
"Isabella County, Michigan",2012,70186,25.3,28393,3641,24752,35927,2.83556884292,0.0518764425954
"Isabella County, Michigan",2015,70669,26.3,28482,3821,24661,39377,2.86561777706,0.0540689694208
"Isanti County, Minnesota",2009,38589,36.3,15546,1215,14331,57496,2.69269415951,0.0314856565342
"Isanti County, Minnesota",2012,38004,37.9,15369,1601,13768,58775,2.76031377106,0.0421271445111
"Isanti County, Minnesota",2015,38296,39.5,15408,1349,14059,59865,2.72394907177,0.0352256110299
"Island County, Washington",2009,80723,42.7,36712,5620,31092,56138,2.59626270423,0.0696208020019
"Island County, Washington",2012,78707,43.6,40084,6894,33190,59500,2.37140705032,0.0875906844372
"Island County, Washington",2015,79329,44,40594,7469,33125,58815,2.39483773585,0.0941522015908
"Isle of Wight County, Virginia",2009,34705,41.5,14434,679,13755,62573,2.52308251545,0.0195649041925
"Isle of Wight County, Virginia",2012,35240,43.7,14709,1124,13585,64491,2.59403754141,0.0318955732123
"Isle of Wight County, Virginia",2015,35740,44.5,15001,1232,13769,65741,2.59568596122,0.0344711807499
"Issaquena County, Mississippi",2009,2130,32.2,902,164,738,20250,2.88617886179,0.0769953051643
"Issaquena County, Mississippi",2012,1556,40.2,605,117,488,24474,3.18852459016,0.0751928020566
"Issaquena County, Mississippi",2015,1291,44.3,545,109,436,23491,2.96100917431,0.0844306738962
"Itasca County, Minnesota",2009,44364,44.4,27018,7620,19398,43396,2.28703990102,0.171760887206
"Itasca County, Minnesota",2012,45052,45.2,27037,8069,18968,46180,2.37515816111,0.17910414632
"Itasca County, Minnesota",2015,45354,45.9,27144,8179,18965,47761,2.39145794885,0.180336905234
"Itawamba County, Mississippi",2009,23006,38.6,10367,1252,9115,37660,2.52397147559,0.0544205859341
"Itawamba County, Mississippi",2012,23362,39.1,10138,1241,8897,36235,2.6258289311,0.0531204520161
"Itawamba County, Mississippi",2015,23451,39.3,10155,1320,8835,35004,2.65432937182,0.0562875783549
"Izard County, Arkansas",2009,13086,45.5,6936,1221,5715,32269,2.28976377953,0.093305823017
"Izard County, Arkansas",2012,13614,47.3,7216,1439,5777,31011,2.35658646356,0.105700014691
"Izard County, Arkansas",2015,13480,48.1,7209,1660,5549,32630,2.42926653451,0.123145400593
"Jack County, Texas",2009,8691,39.6,3757,765,2992,43409,2.9047459893,0.0880220918191
"Jack County, Texas",2012,9027,39.4,4069,1059,3010,43902,2.99900332226,0.117314722499
"Jack County, Texas",2015,8946,40.5,4101,1070,3031,50324,2.95150115473,0.119606528057
"Jackson County, Alabama",2009,52898,40.6,25218,3866,21352,35073,2.47742600225,0.0730840485463
"Jackson County, Alabama",2012,53279,41.4,24798,3601,21197,37059,2.51351606359,0.0675876048725
"Jackson County, Alabama",2015,52860,42.2,24758,4327,20431,37745,2.58724487299,0.0818577374196
"Jackson County, Arkansas",2009,17038,38.6,8169,1307,6862,28680,2.48294957738,0.0767108815589
"Jackson County, Arkansas",2012,17885,40.9,7624,1168,6456,31692,2.77029120198,0.065306122449
"Jackson County, Arkansas",2015,17597,41,7585,1246,6339,31261,2.77598990377,0.0708075240098
"Jackson County, Colorado",2009,1305,50.1,1095,471,624,32788,2.09134615385,0.36091954023
"Jackson County, Colorado",2012,1397,46.5,1158,539,619,45298,2.25686591276,0.385826771654
"Jackson County, Colorado",2015,1335,50.8,1262,646,616,46014,2.16720779221,0.483895131086
"Jackson County, Florida",2009,49618,38.7,20715,3404,17311,36442,2.86627000173,0.068604135596
"Jackson County, Florida",2012,49589,40.4,20980,4625,16355,38917,3.03203913176,0.0932666518784
"Jackson County, Florida",2015,48900,41,20880,4571,16309,35098,2.99834447238,0.0934764826176
"Jackson County, Georgia",2009,58644,35.8,23341,2531,20810,48114,2.81806823642,0.0431587204147
"Jackson County, Georgia",2012,60268,36.8,23749,2499,21250,53393,2.83614117647,0.041464790602
"Jackson County, Georgia",2015,61420,38.3,23756,2708,21048,53379,2.91809198024,0.0440898730055
"Jackson County, Illinois",2009,58526,26.2,28440,4078,24362,29493,2.40234791889,0.0696784335167
"Jackson County, Illinois",2012,59992,29.1,28542,5046,23496,32819,2.55328566565,0.0841112148286
"Jackson County, Illinois",2015,59534,30.1,28641,5251,23390,33871,2.54527575887,0.088201699869
"Jackson County, Indiana",2009,42131,37.2,18399,1256,17143,42525,2.45762118649,0.029811777551
"Jackson County, Indiana",2012,42414,38.5,18224,1488,16736,45883,2.53429732314,0.0350827556939
"Jackson County, Indiana",2015,43471,38.3,18432,1818,16614,47000,2.6165282292,0.0418209841043
"Jackson County, Iowa",2009,19892,42.7,9362,976,8386,43946,2.37204865252,0.049064950734
"Jackson County, Iowa",2012,19807,43.9,9400,986,8414,44854,2.35405276919,0.0497803806735
"Jackson County, Iowa",2015,19572,44.5,9429,996,8433,49028,2.32088224831,0.050889025138
"Jackson County, Kansas",2009,13346,40.3,5475,491,4984,51650,2.67776886035,0.036790049453
"Jackson County, Kansas",2012,13401,41.3,5761,376,5385,54710,2.48857938719,0.0280576076412
"Jackson County, Kansas",2015,13400,40.8,5764,483,5281,54077,2.53739822003,0.0360447761194
"Jackson County, Kentucky",2009,13399,37.4,6382,828,5554,26360,2.41249549874,0.0617956563923
"Jackson County, Kentucky",2012,13475,39,6513,774,5739,22213,2.34797002962,0.057439703154
"Jackson County, Kentucky",2015,13357,39.8,6520,974,5546,29826,2.40840245222,0.0729205659954
"Jackson County, Michigan",2009,161621,38.6,67880,7478,60402,47406,2.67575576968,0.0462687398296
"Jackson County, Michigan",2012,160257,39.5,69321,9372,59949,46572,2.6732222389,0.0584810647897
"Jackson County, Michigan",2015,159759,40.5,69121,8530,60591,46326,2.63667871466,0.0533929230904
"Jackson County, Minnesota",2009,10881,44.3,5192,531,4661,41797,2.33447757992,0.0488006617039
"Jackson County, Minnesota",2012,10273,44.4,4986,466,4520,49886,2.27278761062,0.0453616275674
"Jackson County, Minnesota",2015,10211,43.4,5005,651,4354,50574,2.34519981626,0.063754774263
"Jackson County, Mississippi",2009,131713,36.6,56430,8098,48332,47767,2.72517172888,0.0614821619734
"Jackson County, Mississippi",2012,139430,37,59811,9631,50180,49750,2.77859705062,0.0690740873557
"Jackson County, Mississippi",2015,140676,37.8,60889,10647,50242,48406,2.79996815413,0.0756845517359
"Jackson County, Missouri",2009,689651,36.1,308376,38861,269515,46516,2.55885943268,0.0563487909102
"Jackson County, Missouri",2012,672784,36.2,312247,41602,270645,47023,2.4858541632,0.0618355965659
"Jackson County, Missouri",2015,680905,36.5,314002,39517,274485,46869,2.48066378855,0.0580359962109
"Jackson County, North Carolina",2009,36447,37.1,23570,8246,15324,37672,2.37842599843,0.226246330288
"Jackson County, North Carolina",2012,39985,36.6,25848,10309,15539,36403,2.57320290881,0.257821683131
"Jackson County, North Carolina",2015,40812,36.8,26322,10366,15956,38015,2.55778390574,0.253993923356
"Jackson County, Ohio",2009,33342,38.8,14703,1507,13196,34128,2.52667474992,0.0451982484554
"Jackson County, Ohio",2012,33134,39.1,14572,1161,13411,36903,2.47065841473,0.0350395364278
"Jackson County, Ohio",2015,32854,39.5,14557,1576,12981,39460,2.53092982051,0.0479698058075
"Jackson County, Oklahoma",2009,25831,33.5,12543,2077,10466,40077,2.46808713931,0.0804072625915
"Jackson County, Oklahoma",2012,26275,34.3,12094,1616,10478,41563,2.50763504486,0.0615033301618
"Jackson County, Oklahoma",2015,26056,34.1,12145,1925,10220,41560,2.54951076321,0.073879336813
"Jackson County, Oregon",2009,198036,41.5,87221,5840,81381,44640,2.43344269547,0.0294895877517
"Jackson County, Oregon",2012,203613,42,90814,7444,83370,43664,2.44228139619,0.0365595516986
"Jackson County, Oregon",2015,208363,42.8,91782,8295,83487,44028,2.49575382994,0.0398103310089
"Jackson County, South Dakota",2009,2720,28.3,1192,261,931,32981,2.92158968851,0.0959558823529
"Jackson County, South Dakota",2012,3067,33.8,1201,169,1032,43967,2.97189922481,0.0551027062276
"Jackson County, South Dakota",2015,3237,30.5,1234,202,1032,45074,3.13662790698,0.0624034599938
"Jackson County, Tennessee",2009,10896,43.4,5436,989,4447,30844,2.45019114009,0.0907672540382
"Jackson County, Tennessee",2012,11526,44.5,5824,1294,4530,33363,2.54437086093,0.112267916016
"Jackson County, Tennessee",2015,11496,45.8,5820,1289,4531,31534,2.53718825866,0.112125956855
"Jackson County, Texas",2009,14121,39.5,6692,1571,5121,48509,2.75746924429,0.11125274414
"Jackson County, Texas",2012,14075,39,6588,1397,5191,47591,2.7114236178,0.0992539964476
"Jackson County, Texas",2015,14486,39,6591,1482,5109,54926,2.83538853005,0.102305674444
"Jackson County, West Virginia",2009,28140,41.2,12725,1474,11251,42662,2.50111101235,0.052380952381
"Jackson County, West Virginia",2012,29206,41.5,13269,1870,11399,41087,2.56215457496,0.0640279394645
"Jackson County, West Virginia",2015,29256,42.6,13259,2141,11118,41314,2.63140852671,0.0731815695926
"Jackson County, Wisconsin",2009,19775,39.8,8935,1190,7745,45484,2.55326016785,0.0601769911504
"Jackson County, Wisconsin",2012,20436,41.6,9693,1526,8167,43098,2.50226521366,0.0746721471912
"Jackson County, Wisconsin",2015,20543,42.2,9755,1795,7960,47851,2.58077889447,0.0873776955654
"Jackson Parish, Louisiana",2009,15111,40.7,7678,1740,5938,37536,2.54479622769,0.115147905499
"Jackson Parish, Louisiana",2012,16210,39.1,7670,1594,6076,38757,2.66787360105,0.0983343615052
"Jackson Parish, Louisiana",2015,16109,39.6,7729,1691,6038,38029,2.66793640278,0.104972375691
"James City County, Virginia",2009,60864,43.6,27638,2505,25133,71988,2.42167668006,0.0411573343849
"James City County, Virginia",2012,66939,44.9,29881,3302,26579,76767,2.51849204259,0.0493284931057
"James City County, Virginia",2015,70673,45.4,31392,3392,28000,75710,2.52403571429,0.0479956984987
"Jasper County, Georgia",2009,13588,36.7,6087,999,5088,42242,2.67059748428,0.0735207536061
"Jasper County, Georgia",2012,13786,37.7,6159,1058,5101,43768,2.7026073319,0.0767445234296
"Jasper County, Georgia",2015,13593,39.9,6215,1053,5162,42368,2.63328167377,0.0774663429706
"Jasper County, Illinois",2009,9645,42.4,4466,382,4084,45252,2.36165523996,0.0396060134785
"Jasper County, Illinois",2012,9707,42.7,4348,393,3955,48703,2.45436156764,0.0404862470382
"Jasper County, Illinois",2015,9635,42.9,4326,545,3781,54209,2.54826765406,0.0565646081993
"Jasper County, Indiana",2009,32197,37.7,12934,856,12078,53369,2.66575591985,0.0265863279188
"Jasper County, Indiana",2012,33369,38.3,13165,1048,12117,57801,2.75389948007,0.0314063951572
"Jasper County, Indiana",2015,33448,38.8,13302,1306,11996,55374,2.78826275425,0.039045682851
"Jasper County, Iowa",2009,36606,41.1,16225,1104,15121,47432,2.42087163547,0.0301589903295
"Jasper County, Iowa",2012,36823,41.7,16179,1364,14815,48746,2.48552143098,0.0370420661
"Jasper County, Iowa",2015,36726,42.2,16158,1721,14437,55033,2.54388030754,0.046860534771
"Jasper County, Mississippi",2009,17944,37.6,8085,1537,6548,29628,2.7403787416,0.0856553722693
"Jasper County, Mississippi",2012,17033,41.2,8206,1315,6891,30998,2.4717747787,0.0772030763811
"Jasper County, Mississippi",2015,16588,41.6,8220,1347,6873,31578,2.4135021097,0.0812032794791
"Jasper County, Missouri",2009,114756,34.4,49135,5510,43625,37294,2.63051002865,0.0480149186099
"Jasper County, Missouri",2012,116493,35.1,50618,5613,45005,39908,2.58844572825,0.0481831526358
"Jasper County, Missouri",2015,117184,35.5,51108,5589,45519,41811,2.57439750434,0.0476942244675
"Jasper County, South Carolina",2009,22250,35,8997,1744,7253,36288,3.06769612574,0.0783820224719
"Jasper County, South Carolina",2012,24792,35.5,10213,2134,8079,36504,3.06869662087,0.0860761535979
"Jasper County, South Carolina",2015,26549,36.5,10729,1634,9095,37141,2.91907641561,0.0615465742589
"Jasper County, Texas",2009,34431,39.5,16930,3369,13561,37020,2.53897205221,0.0978478696523
"Jasper County, Texas",2012,35703,40.3,16789,3067,13722,40603,2.60188019239,0.0859031453939
"Jasper County, Texas",2015,35768,40.6,16868,4558,12310,40820,2.90560519903,0.127432341758
"Jay County, Indiana",2009,21270,39,9392,1003,8389,38026,2.53546310645,0.0471556182417
"Jay County, Indiana",2012,21353,39.1,9224,1036,8188,40926,2.60784074255,0.0485177726783
"Jay County, Indiana",2015,21255,39.5,9202,1085,8117,41021,2.61857829247,0.0510468125147
"Jayuya Municipio, Puerto Rico",2009,18263,32,5437,662,4775,15830,3.82471204188,0.0362481520013
"Jayuya Municipio, Puerto Rico",2012,16600,33.7,5802,983,4819,17137,3.44469807014,0.0592168674699
"Jayuya Municipio, Puerto Rico",2015,15890,35.2,6249,1432,4817,16033,3.29873365165,0.0901195720579
"Jeff Davis County, Georgia",2009,13312,35.8,5705,787,4918,29932,2.70679137861,0.0591195913462
"Jeff Davis County, Georgia",2012,14972,35.7,6434,725,5709,35203,2.6225258364,0.0484237242853
"Jeff Davis County, Georgia",2015,14990,36.1,6421,1017,5404,36385,2.77387120651,0.0678452301534
"Jeff Davis County, Texas",2009,2192,48.5,1617,634,983,39550,2.22990844354,0.289233576642
"Jeff Davis County, Texas",2012,2319,50.2,1524,645,879,49375,2.63822525597,0.278137128072
"Jeff Davis County, Texas",2015,2232,53.1,1611,588,1023,50165,2.18181818182,0.263440860215
"Jefferson County, Alabama",2009,662212,36.8,307684,40009,267675,44718,2.47394041281,0.0604172077824
"Jefferson County, Alabama",2012,658464,37,301202,41947,259255,45415,2.53983144009,0.0637043179278
"Jefferson County, Alabama",2015,659026,37.4,303755,42826,260929,45610,2.52569089676,0.0649837790922
"Jefferson County, Arkansas",2009,79698,36.3,35755,5587,30168,35265,2.64180588703,0.0701021355617
"Jefferson County, Arkansas",2012,76836,37.2,33173,4966,28207,37561,2.72400467969,0.0646311624759
"Jefferson County, Arkansas",2015,73548,38.5,33161,5042,28119,36747,2.61559799424,0.0685538695818
"Jefferson County, Colorado",2009,529025,39.5,227196,11604,215592,65891,2.45382481725,0.0219346911772
"Jefferson County, Colorado",2012,536095,40.2,230125,11120,219005,68748,2.44786648707,0.0207425922644
"Jefferson County, Colorado",2015,552344,40.4,232477,9585,222892,70164,2.47807906968,0.0173533160494
"Jefferson County, Florida",2009,13933,43.3,5806,1067,4739,44011,2.94007174509,0.0765807794445
"Jefferson County, Florida",2012,14564,43.6,6588,1144,5444,41163,2.675238795,0.0785498489426
"Jefferson County, Florida",2015,14198,45.3,6602,1191,5411,43355,2.62391424875,0.083885054233
"Jefferson County, Georgia",2009,16480,37.4,7446,987,6459,29036,2.55147855705,0.059890776699
"Jefferson County, Georgia",2012,16817,38.1,7295,1115,6180,27612,2.721197411,0.0663019563537
"Jefferson County, Georgia",2015,16374,38.4,7258,1201,6057,26557,2.70331847449,0.073347990717
"Jefferson County, Idaho",2009,22892,29.8,7820,498,7322,50181,3.12646817809,0.0217543246549
"Jefferson County, Idaho",2012,25940,30.2,8681,590,8091,52980,3.20603139291,0.0227447956823
"Jefferson County, Idaho",2015,26792,31.1,8829,727,8102,51171,3.30683781782,0.0271349656614
"Jefferson County, Illinois",2009,40063,40.1,17622,1832,15790,40343,2.53723875871,0.045727978434
"Jefferson County, Illinois",2012,38908,40.5,16969,1791,15178,42272,2.56344709448,0.0460316644392
"Jefferson County, Illinois",2015,38578,40.7,16873,1596,15277,43247,2.52523401191,0.0413707294313
"Jefferson County, Indiana",2009,32628,39,14263,1642,12621,40704,2.58521511766,0.0503248743411
"Jefferson County, Indiana",2012,32501,40.5,14314,1677,12637,43395,2.57189206299,0.0515984123565
"Jefferson County, Indiana",2015,32453,40.7,14315,1621,12694,45718,2.55656215535,0.0499491572428
"Jefferson County, Iowa",2009,15496,44.6,7644,798,6846,39383,2.26351153959,0.0514971605576
"Jefferson County, Iowa",2012,16791,44,7595,751,6844,48411,2.45338983051,0.0447263414925
"Jefferson County, Iowa",2015,17318,42.5,7557,644,6913,42899,2.50513525242,0.037186742118
"Jefferson County, Kansas",2009,18380,42.1,8204,658,7546,56593,2.43572753777,0.0357997823721
"Jefferson County, Kansas",2012,19036,42.9,8156,701,7455,58434,2.55345405768,0.0368249632276
"Jefferson County, Kansas",2015,18898,43.5,8210,668,7542,57236,2.50570140546,0.0353476558366
"Jefferson County, Kentucky",2009,711317,37.3,328118,32984,295134,45440,2.41014928812,0.046370324342
"Jefferson County, Kentucky",2012,741285,37.8,337349,33434,303915,46701,2.43911949065,0.0451027607465
"Jefferson County, Kentucky",2015,755809,37.9,340132,33217,306915,48695,2.46260039425,0.0439489341884
"Jefferson County, Mississippi",2009,8971,38.2,4058,896,3162,21964,2.83712839975,0.0998773826775
"Jefferson County, Mississippi",2012,7743,38.6,3688,1110,2578,20281,3.00349107836,0.143355288648
"Jefferson County, Mississippi",2015,7586,34.8,3677,1132,2545,20743,2.98074656189,0.149222251516
"Jefferson County, Missouri",2009,215386,36.9,86350,6207,80143,56815,2.68752105611,0.028818029027
"Jefferson County, Missouri",2012,218628,37.7,87706,6547,81159,55743,2.69382323587,0.0299458440822
"Jefferson County, Missouri",2015,221577,38.6,88584,6594,81990,55348,2.70248810831,0.0297594064366
"Jefferson County, Montana",2009,11105,44.1,4201,544,3657,56294,3.03664205633,0.0489869428186
"Jefferson County, Montana",2012,11360,46.8,5018,469,4549,60459,2.49725214333,0.0412852112676
"Jefferson County, Montana",2015,11502,47.7,5047,574,4473,60842,2.57142857143,0.0499043644584
"Jefferson County, Nebraska",2009,7502,46.3,3989,650,3339,38797,2.2467804732,0.0866435617169
"Jefferson County, Nebraska",2012,7572,47,3920,644,3276,43407,2.31135531136,0.0850501848917
"Jefferson County, Nebraska",2015,7433,45.5,3902,543,3359,43008,2.21286097053,0.0730526032558
"Jefferson County, New York",2009,117595,33.6,57257,13319,43938,43447,2.676384906,0.113261618266
"Jefferson County, New York",2012,117011,32.3,57866,12704,45162,46549,2.59091714273,0.108570989052
"Jefferson County, New York",2015,118947,31.8,58536,14230,44306,49505,2.68467024782,0.119633113908
"Jefferson County, Ohio",2009,68762,43.8,33477,3996,29481,37097,2.33241748923,0.0581134929176
"Jefferson County, Ohio",2012,69343,43.9,32807,4199,28608,40115,2.42390240492,0.060554057367
"Jefferson County, Ohio",2015,68053,44.3,32604,4646,27958,41942,2.4341154589,0.0682703187222
"Jefferson County, Oklahoma",2009,6288,40.8,3444,861,2583,32783,2.4343786295,0.136927480916
"Jefferson County, Oklahoma",2012,6445,41.6,3380,888,2492,35682,2.58627608347,0.137781225756
"Jefferson County, Oklahoma",2015,6333,42.4,3403,932,2471,33449,2.56292998786,0.147165640297
"Jefferson County, Oregon",2009,20097,36.3,9663,1934,7729,40256,2.60020701255,0.0962332686471
"Jefferson County, Oregon",2012,21746,40.1,9807,1802,8005,43330,2.7165521549,0.0828658144026
"Jefferson County, Oregon",2015,22061,39.9,9789,2097,7692,46366,2.86804472179,0.0950546212774
"Jefferson County, Pennsylvania",2009,44965,42.5,22951,4355,18596,36917,2.4179931168,0.0968531079729
"Jefferson County, Pennsylvania",2012,45051,43,22437,4124,18313,40719,2.46005569814,0.0915406983197
"Jefferson County, Pennsylvania",2015,44756,43.6,22392,3913,18479,42903,2.42199253206,0.0874296183752
"Jefferson County, Tennessee",2009,50116,39.1,22257,3092,19165,37951,2.61497521524,0.0616968632772
"Jefferson County, Tennessee",2012,51541,40.5,23453,3880,19573,38800,2.63327032136,0.0752798742748
"Jefferson County, Tennessee",2015,52490,42.3,23592,3913,19679,42417,2.66731033081,0.0745475328634
"Jefferson County, Texas",2009,242676,35.6,105291,12469,92822,41420,2.61442330482,0.0513812655557
"Jefferson County, Texas",2012,251627,36,104623,11869,92754,43750,2.71284257283,0.0471690239919
"Jefferson County, Texas",2015,252872,35.9,106857,13362,93495,43540,2.7046580031,0.0528409630169
"Jefferson County, Washington",2009,29223,52,16072,2857,13215,46183,2.2113507378,0.097765458714
"Jefferson County, Washington",2012,29802,53.8,17691,3510,14181,46870,2.10154431986,0.117777330381
"Jefferson County, Washington",2015,30083,55.6,17914,4492,13422,49279,2.24132022053,0.149320214074
"Jefferson County, West Virginia",2009,50791,38.3,21677,2186,19491,63612,2.60586937561,0.0430391211041
"Jefferson County, West Virginia",2012,53545,39.2,22086,2262,19824,64314,2.70101896691,0.0422448407881
"Jefferson County, West Virginia",2015,55214,39.7,22408,2077,20331,66677,2.71575426688,0.037617270982
"Jefferson County, Wisconsin",2009,79868,38,33895,2970,30925,55379,2.58263540825,0.0371863574899
"Jefferson County, Wisconsin",2012,83751,38.1,35079,3154,31925,54705,2.62336726703,0.0376592518298
"Jefferson County, Wisconsin",2015,84345,39.1,35264,2851,32413,56877,2.60219664949,0.0338016479934
"Jefferson Davis County, Mississippi",2009,12721,38.6,6182,1088,5094,24679,2.49725166863,0.085527867306
"Jefferson Davis County, Mississippi",2012,12364,41.4,5891,1040,4851,27201,2.54875283447,0.0841151730831
"Jefferson Davis County, Mississippi",2015,11941,43.1,5872,853,5019,26279,2.37915919506,0.07143455322
"Jefferson Davis Parish, Louisiana",2009,31061,35.7,13472,1563,11909,39756,2.60819548241,0.0503203374006
"Jefferson Davis Parish, Louisiana",2012,31529,38,13354,1480,11874,41777,2.65529728819,0.0469409115418
"Jefferson Davis Parish, Louisiana",2015,31434,38.4,13519,1867,11652,39063,2.69773429454,0.0593942864414
"Jefferson Parish, Louisiana",2009,440134,38.3,183312,23202,160110,48213,2.74894759853,0.0527157638356
"Jefferson Parish, Louisiana",2012,432706,38.5,188653,22173,166480,48522,2.59914704469,0.0512426451216
"Jefferson Parish, Louisiana",2015,435092,38.7,189163,21059,168104,47947,2.58823109504,0.048401257665
"Jenkins County, Georgia",2009,8532,40.7,4251,1154,3097,26652,2.75492412012,0.135255508673
"Jenkins County, Georgia",2012,8477,38.6,4482,1328,3154,27039,2.68769816107,0.15665919547
"Jenkins County, Georgia",2015,8922,40.7,4727,1232,3495,24604,2.55278969957,0.138085631024
"Jennings County, Indiana",2009,28052,37.9,12759,1100,11659,43490,2.40603825371,0.0392128903465
"Jennings County, Indiana",2012,28373,37.9,12112,1407,10705,45273,2.65044371789,0.0495893983717
"Jennings County, Indiana",2015,28113,39.4,12062,1455,10607,44736,2.65041953427,0.051755415644
"Jerauld County, South Dakota",2009,1994,49.3,1219,325,894,39531,2.23042505593,0.162988966901
"Jerauld County, South Dakota",2012,2047,49.3,1162,267,895,45587,2.28715083799,0.130434782609
"Jerauld County, South Dakota",2015,2031,47.5,1038,175,863,53125,2.35341830823,0.0861644510094
"Jerome County, Idaho",2009,20142,33.1,7354,663,6691,40322,3.01031235989,0.0329162943104
"Jerome County, Idaho",2012,22140,31.4,8066,514,7552,40309,2.93167372881,0.0232158988257
"Jerome County, Idaho",2015,22653,32.1,8196,572,7624,41630,2.9712749213,0.0252505186951
"Jersey County, Illinois",2009,22412,39.3,9761,1119,8642,51553,2.59338116177,0.0499286096734
"Jersey County, Illinois",2012,22939,41.3,9855,1119,8736,53692,2.62580128205,0.0487815510702
"Jersey County, Illinois",2015,22625,42.3,9979,1149,8830,53271,2.56228765572,0.0507845303867
"Jessamine County, Kentucky",2009,45551,34.6,18364,1334,17030,48577,2.6747504404,0.0292858554148
"Jessamine County, Kentucky",2012,48591,35.6,19381,1421,17960,48299,2.70551224944,0.0292440987014
"Jessamine County, Kentucky",2015,50328,37.4,19796,1484,18312,50558,2.74836173001,0.0294865681132
"Jewell County, Kansas",2009,3175,50.6,2120,546,1574,37500,2.01715374841,0.171968503937
"Jewell County, Kansas",2012,3085,51.7,2046,598,1448,38462,2.13052486188,0.193841166937
"Jewell County, Kansas",2015,3038,52.1,2028,595,1433,40553,2.12002791347,0.195852534562
"Jim Hogg County, Texas",2009,4973,32,2349,754,1595,33635,3.11786833856,0.151618741202
"Jim Hogg County, Texas",2012,5257,38.3,2519,735,1784,36919,2.94674887892,0.139813581891
"Jim Hogg County, Texas",2015,5239,36.7,2519,831,1688,35521,3.10367298578,0.158618056881
"Jim Wells County, Texas",2009,40876,33.3,15480,2055,13425,32816,3.04476722533,0.0502739994129
"Jim Wells County, Texas",2012,41014,34.5,16124,2609,13515,40723,3.03470218276,0.0636124250256
"Jim Wells County, Texas",2015,41461,34.6,16206,2377,13829,42986,2.99811989298,0.0573309857456
"Jo Daviess County, Illinois",2009,22160,46.3,13127,3044,10083,52514,2.19775860359,0.137364620939
"Jo Daviess County, Illinois",2012,22663,47.2,13560,3829,9731,52164,2.32894872058,0.16895380135
"Jo Daviess County, Illinois",2015,22397,48.2,13578,4036,9542,53221,2.34720184448,0.18020270572
"Johnson County, Arkansas",2009,24576,36.6,10561,1650,8911,30953,2.75793962518,0.067138671875
"Johnson County, Arkansas",2012,25554,37.6,11265,1495,9770,32198,2.61555783009,0.0585035610863
"Johnson County, Arkansas",2015,25930,38.1,11334,1223,10111,34139,2.56453367619,0.04716544543
"Johnson County, Georgia",2009,9202,38.3,3698,607,3091,25789,2.97703008735,0.0659639208868
"Johnson County, Georgia",2012,9981,40.2,4092,752,3340,34521,2.98832335329,0.0753431519888
"Johnson County, Georgia",2015,9794,39.6,4088,789,3299,34438,2.9687784177,0.0805595262406
"Johnson County, Illinois",2009,13653,38.3,5312,983,4329,45934,3.15384615385,0.0719988280964
"Johnson County, Illinois",2012,12653,42,5573,1294,4279,42027,2.9569992989,0.102268236782
"Johnson County, Illinois",2015,12829,43.2,5573,1166,4407,42287,2.91105060132,0.090887832255
"Johnson County, Indiana",2009,136081,36.4,54997,4363,50634,59973,2.68754196785,0.03206178673
"Johnson County, Indiana",2012,140033,37.1,56735,4783,51952,62888,2.69543039729,0.0341562346018
"Johnson County, Indiana",2015,145645,37.3,58189,4919,53270,62147,2.73409048245,0.0337739022967
"Johnson County, Iowa",2009,125810,27.5,54615,3882,50733,49413,2.47984546548,0.030856052778
"Johnson County, Iowa",2012,131627,29.3,56045,3219,52826,53993,2.49170862833,0.0244554688628
"Johnson County, Iowa",2015,139436,29.8,57997,2571,55426,55700,2.51571464656,0.0184385667977
"Johnson County, Kansas",2009,525108,35.7,213415,11504,201911,73487,2.6006904032,0.0219078741897
"Johnson County, Kansas",2012,546046,36.4,226268,11598,214670,75139,2.54365304887,0.0212399687938
"Johnson County, Kansas",2015,566814,36.8,231029,11294,219735,76113,2.57953443921,0.0199254076293
"Johnson County, Kentucky",2009,23837,37.4,10563,1571,8992,32403,2.65091192171,0.06590594454
"Johnson County, Kentucky",2012,23339,39.7,10607,1278,9329,34466,2.50176867831,0.0547581301684
"Johnson County, Kentucky",2015,23350,40.9,10555,1520,9035,35570,2.58439402324,0.065096359743
"Johnson County, Missouri",2009,51997,28.4,20608,2101,18507,43656,2.80958556222,0.0404061772795
"Johnson County, Missouri",2012,52964,29.7,21529,1764,19765,47960,2.67968631419,0.0333056415679
"Johnson County, Missouri",2015,54155,29.7,21710,1739,19971,49792,2.71168193881,0.0321115317145
"Johnson County, Nebraska",2009,5103,42.2,2166,185,1981,43631,2.57597173145,0.0362531844013
"Johnson County, Nebraska",2012,5188,43.7,2184,241,1943,42689,2.67009778693,0.0464533538936
"Johnson County, Nebraska",2015,5167,42.3,2150,264,1886,45429,2.73966065748,0.0510934778401
"Johnson County, Tennessee",2009,18019,42.5,8552,1262,7290,29771,2.47174211248,0.0700371829735
"Johnson County, Tennessee",2012,18199,43.5,8931,1698,7233,30063,2.51610673303,0.0933018297709
"Johnson County, Tennessee",2015,18017,44.5,8924,1915,7009,30763,2.57055214724,0.106288505301
"Johnson County, Texas",2009,150077,35.8,53017,4628,48389,53444,3.10146934221,0.0308375034149
"Johnson County, Texas",2012,151174,36.2,56723,4947,51776,57016,2.9197697775,0.0327238810907
"Johnson County, Texas",2015,155450,36.7,58451,4766,53685,58135,2.89559467263,0.0306593760051
"Johnson County, Wyoming",2009,8084,44.1,3755,504,3251,42849,2.48661950169,0.0623453735774
"Johnson County, Wyoming",2012,8564,44.9,4511,757,3754,57175,2.28129994672,0.0883932741709
"Johnson County, Wyoming",2015,8600,44.6,4532,883,3649,54065,2.35681008495,0.102674418605
"Johnston County, North Carolina",2009,156888,35.5,62191,5936,56255,49897,2.78887210026,0.0378359084187
"Johnston County, North Carolina",2012,169122,36.6,67535,6991,60544,50132,2.79337341438,0.0413370229775
"Johnston County, North Carolina",2015,178396,37.4,69430,7480,61950,50512,2.879677159,0.0419291912375
"Johnston County, Oklahoma",2009,10396,39.3,5032,939,4093,32848,2.53994624969,0.0903232012312
"Johnston County, Oklahoma",2012,10938,39.4,5123,902,4221,36209,2.59132906894,0.0824648016091
"Johnston County, Oklahoma",2015,11022,40.6,5136,972,4164,38776,2.6469740634,0.08818726184
"Jones County, Georgia",2009,27256,39,11099,1234,9865,49337,2.76289913837,0.0452744349868
"Jones County, Georgia",2012,28638,39.1,11644,1113,10531,53085,2.71939986706,0.0388644458412
"Jones County, Georgia",2015,28738,39.4,11600,1274,10326,51857,2.78307185745,0.0443315470805
"Jones County, Iowa",2009,20365,42.1,8424,783,7641,47017,2.66522706452,0.038448318193
"Jones County, Iowa",2012,20686,42.7,8875,766,8109,53562,2.55099272413,0.037029875278
"Jones County, Iowa",2015,20560,43.2,8902,731,8171,55060,2.51621588545,0.0355544747082
"Jones County, Mississippi",2009,66877,36.1,28019,2557,25462,34269,2.62654151284,0.0382343705609
"Jones County, Mississippi",2012,67868,36.8,28400,3743,24657,38233,2.7524840816,0.0551511758119
"Jones County, Mississippi",2015,68276,36.6,28564,4003,24561,37143,2.77985424046,0.058629679536
"Jones County, North Carolina",2009,10028,42.4,4813,794,4019,33563,2.49514804678,0.0791783007579
"Jones County, North Carolina",2012,10144,44.4,4843,745,4098,36460,2.47535383114,0.0734424290221
"Jones County, North Carolina",2015,10166,45.2,4863,727,4136,34005,2.4579303675,0.0715128860909
"Jones County, South Dakota",2009,1033,38.2,587,126,461,43750,2.24078091106,0.121974830591
"Jones County, South Dakota",2012,1084,40.2,566,130,436,44531,2.48623853211,0.119926199262
"Jones County, South Dakota",2015,781,51.6,544,118,426,35972,1.83333333333,0.151088348271
"Jones County, Texas",2009,19223,36.8,7519,1363,6156,40947,3.1226445744,0.0709046454768
"Jones County, Texas",2012,20137,39.5,7410,1844,5566,38896,3.61785842616,0.0915727268213
"Jones County, Texas",2015,19978,39.2,7330,1841,5489,43897,3.63964292221,0.0921513665032
"Josephine County, Oregon",2009,80672,46.3,36915,3071,33844,37456,2.38364259544,0.0380677310591
"Josephine County, Oregon",2012,82636,47.1,37955,3582,34373,36699,2.40409623833,0.0433467253981
"Josephine County, Oregon",2015,83409,47.9,38028,3501,34527,37665,2.4157615779,0.04197388771
"Juab County, Utah",2009,9563,29.2,3407,369,3038,50360,3.14779460171,0.0385862177141
"Juab County, Utah",2012,10233,29.6,3498,449,3049,53314,3.35618235487,0.0438776507378
"Juab County, Utah",2015,10400,30,3538,432,3106,54761,3.34835801674,0.0415384615385
"Juana Díaz Municipio, Puerto Rico",2009,52947,32.7,17160,2143,15017,16654,3.5258040887,0.0404744367009
"Juana Díaz Municipio, Puerto Rico",2012,50695,34.5,18242,2179,16063,16938,3.15601070784,0.0429825426571
"Juana Díaz Municipio, Puerto Rico",2015,49259,36.4,19087,2468,16619,18609,2.96401708887,0.0501025193366
"Judith Basin County, Montana",2009,2077,53.6,1408,428,980,39900,2.1193877551,0.206066441984
"Judith Basin County, Montana",2012,2052,51.3,1314,444,870,41100,2.35862068966,0.216374269006
"Judith Basin County, Montana",2015,1997,51.4,1327,414,913,44602,2.18729463308,0.20731096645
"Juncos Municipio, Puerto Rico",2009,40658,32.8,13798,2052,11746,16968,3.46143367955,0.0504697722465
"Juncos Municipio, Puerto Rico",2012,40292,34.4,14903,2453,12450,18946,3.23630522088,0.0608805718257
"Juncos Municipio, Puerto Rico",2015,40104,36.1,15829,2845,12984,19141,3.0887245841,0.0709405545581
"Juneau City and Borough, Alaska",2009,30777,37.6,12842,994,11848,76437,2.59765361242,0.0322968450466
"Juneau City and Borough, Alaska",2012,31636,37.8,13052,729,12323,78947,2.56723200519,0.0230433683146
"Juneau City and Borough, Alaska",2015,32531,37,13159,1045,12114,85746,2.68540531616,0.0321232055578
"Juneau County, Wisconsin",2009,26493,42.3,14127,3134,10993,45746,2.40998817429,0.118295398785
"Juneau County, Wisconsin",2012,26701,43.2,14680,3893,10787,45461,2.47529433577,0.14579978278
"Juneau County, Wisconsin",2015,26494,44.4,14768,4784,9984,44961,2.65364583333,0.180569185476
"Juniata County, Pennsylvania",2009,23107,40.3,10501,1705,8796,42901,2.6269895407,0.0737871640628
"Juniata County, Pennsylvania",2012,24664,41.1,10960,1694,9266,44991,2.66177422836,0.0686831008758
"Juniata County, Pennsylvania",2015,24829,43,10982,1589,9393,47398,2.64335143192,0.0639977445729
"Kalamazoo County, Michigan",2009,245053,33.5,107734,9416,98318,44553,2.49245306048,0.0384243408569
"Kalamazoo County, Michigan",2012,250704,34,109871,10151,99720,46011,2.51407942238,0.0404899802157
"Kalamazoo County, Michigan",2015,256752,34,110196,9855,100341,47476,2.55879451072,0.0383833426809
"Kalawao County, Hawaii",2009,78,63.6,136,65,71,52813,1.0985915493,0.833333333333
"Kalawao County, Hawaii",2012,66,58.4,95,47,48,66250,1.375,0.712121212121
"Kalawao County, Hawaii",2015,85,51.9,98,44,54,66250,1.57407407407,0.517647058824
"Kalkaska County, Michigan",2009,17106,41.6,11749,4506,7243,39304,2.36172856551,0.263416345142
"Kalkaska County, Michigan",2012,17231,43.2,12136,4860,7276,39849,2.36819681143,0.282049793976
"Kalkaska County, Michigan",2015,17230,44.4,12130,4945,7185,40534,2.39805149617,0.286999419617
"Kanabec County, Minnesota",2009,16059,41.5,7627,1300,6327,45382,2.5381697487,0.0809514913756
"Kanabec County, Minnesota",2012,16255,42.1,7829,1483,6346,46323,2.5614560353,0.0912334666257
"Kanabec County, Minnesota",2015,16003,43.9,7794,1603,6191,47384,2.58488127928,0.100168718365
"Kanawha County, West Virginia",2009,191624,41.5,95348,11758,83590,41478,2.29242732384,0.0613597461696
"Kanawha County, West Virginia",2012,192572,42.3,92679,9718,82961,45642,2.32123527923,0.0504642419459
"Kanawha County, West Virginia",2015,190781,42.8,92446,10196,82250,45882,2.31952583587,0.0534434770758
"Kandiyohi County, Minnesota",2009,40950,39.3,19803,3037,16766,50381,2.44244303948,0.0741636141636
"Kandiyohi County, Minnesota",2012,42150,39.8,19498,2211,17287,50156,2.43824839475,0.0524555160142
"Kandiyohi County, Minnesota",2015,42444,39.9,19569,2868,16701,52632,2.54140470631,0.0675713881821
"Kane County, Illinois",2009,494371,33.7,170445,8902,161543,68327,3.06030592474,0.0180067196498
"Kane County, Illinois",2012,514891,34.7,181587,11518,170069,68674,3.02754176246,0.0223697831191
"Kane County, Illinois",2015,524886,35.9,183384,10905,172479,70696,3.04318786635,0.0207759399184
"Kane County, Utah",2009,6447,43.7,4763,2017,2746,41313,2.34777858704,0.312858693966
"Kane County, Utah",2012,7093,45.5,5753,2543,3210,46979,2.20965732087,0.358522486959
"Kane County, Utah",2015,7202,43.6,5854,3065,2789,50194,2.58228755826,0.425576228825
"Kankakee County, Illinois",2009,111244,36,44051,3849,40202,50911,2.76712601363,0.0345996188558
"Kankakee County, Illinois",2012,113170,36.7,45175,4107,41068,49994,2.75567351709,0.0362905363612
"Kankakee County, Illinois",2015,112221,37.3,45184,4304,40880,52110,2.74513209393,0.0383528929523
"Karnes County, Texas",2009,15060,38.4,5632,945,4687,35101,3.21314273523,0.0627490039841
"Karnes County, Texas",2012,14936,36.9,5644,1148,4496,39706,3.32206405694,0.0768612747724
"Karnes County, Texas",2015,14879,35.5,5773,1464,4309,45502,3.45300533767,0.0983937092547
"Kauai County, Hawaii",2009,63033,39.9,28933,6965,21968,63317,2.86930990532,0.110497675821
"Kauai County, Hawaii",2012,67113,41.5,29726,7634,22092,64752,3.03788701793,0.1137484541
"Kauai County, Hawaii",2015,69691,41.6,30238,7833,22405,65101,3.11051104664,0.112396148714
"Kaufman County, Texas",2009,95993,34.5,31232,2817,28415,55857,3.37825092381,0.0293458898045
"Kaufman County, Texas",2012,103385,35.3,38047,3450,34597,61564,2.98826487846,0.0333704115684
"Kaufman County, Texas",2015,109289,35.8,38931,3513,35418,60391,3.08569089164,0.0321441316143
"Kay County, Oklahoma",2009,45958,39.2,22037,3437,18600,37803,2.47086021505,0.0747856738761
"Kay County, Oklahoma",2012,46288,39.3,21717,3287,18430,41026,2.51155724362,0.071011925337
"Kay County, Oklahoma",2015,45587,38.8,21626,3511,18115,42134,2.51653325973,0.0770175707987
"Kearney County, Nebraska",2009,6550,41,2863,157,2706,49894,2.42054693274,0.0239694656489
"Kearney County, Nebraska",2012,6514,41.9,2899,313,2586,54485,2.51894818252,0.0480503530857
"Kearney County, Nebraska",2015,6549,40.8,2922,155,2767,51934,2.3668232743,0.0236677355321
"Kearny County, Kansas",2009,4197,32.4,1731,202,1529,40965,2.74493132767,0.0481296163927
"Kearny County, Kansas",2012,3952,35.7,1565,181,1384,47069,2.85549132948,0.0457995951417
"Kearny County, Kansas",2015,3952,34.8,1556,177,1379,50506,2.86584481508,0.0447874493927
"Keith County, Nebraska",2009,7934,45.6,5385,1712,3673,40826,2.16008712224,0.215780186539
"Keith County, Nebraska",2012,8284,48.2,5427,1662,3765,43662,2.20026560425,0.200627716079
"Keith County, Nebraska",2015,8146,49.1,5381,1476,3905,41781,2.08604353393,0.181193223668
"Kemper County, Mississippi",2009,9998,37.9,4793,879,3914,29833,2.55442003066,0.0879175835167
"Kemper County, Mississippi",2012,10391,37.4,4724,938,3786,27471,2.74458531432,0.0902704263305
"Kemper County, Mississippi",2015,10211,38.3,4729,1064,3665,30056,2.7860845839,0.104201351484
"Kenai Peninsula Borough, Alaska",2009,53052,39.7,25499,5896,19603,55966,2.70632046115,0.111136243685
"Kenai Peninsula Borough, Alaska",2012,55474,40.9,30302,8338,21964,59421,2.52567838281,0.150304647222
"Kenai Peninsula Borough, Alaska",2015,57221,40.5,30671,9186,21485,63684,2.66329997673,0.160535467748
"Kendall County, Illinois",2009,94070,32.7,32322,2074,30248,79504,3.10995768315,0.0220474115021
"Kendall County, Illinois",2012,114226,33,40002,2185,37817,83835,3.02049342888,0.0191287447691
"Kendall County, Illinois",2015,120036,33.8,40930,2414,38516,84385,3.11652300343,0.0201106334766
"Kendall County, Texas",2009,31294,42.1,12940,1305,11635,68389,2.68964331758,0.0417012845913
"Kendall County, Texas",2012,33745,43.1,14091,1349,12742,71553,2.64832836289,0.0399762927841
"Kendall County, Texas",2015,37361,43.6,14754,1202,13552,73240,2.75686245573,0.0321725863869
"Kenedy County, Texas",2009,336,30.5,334,193,141,25417,2.3829787234,0.574404761905
"Kenedy County, Texas",2012,451,45.1,389,221,168,37206,2.68452380952,0.490022172949
"Kenedy County, Texas",2015,565,29.4,247,102,145,36438,3.89655172414,0.180530973451
"Kennebec County, Maine",2009,120777,41.5,59992,9256,50736,46368,2.38049905393,0.0766371080587
"Kennebec County, Maine",2012,122022,42.7,60956,9680,51276,47424,2.37970980576,0.079329956893
"Kennebec County, Maine",2015,121112,44,61383,9940,51443,46917,2.354295045,0.0820727921263
"Kenosha County, Wisconsin",2009,162740,35.9,67129,6916,60213,55055,2.70273861126,0.0424972348531
"Kenosha County, Wisconsin",2012,166373,36.5,69222,6921,62301,55117,2.67047077896,0.041599297963
"Kenosha County, Wisconsin",2015,167738,37.4,69510,7180,62330,54918,2.6911278678,0.0428048504215
"Kent County, Delaware",2009,151332,35.8,61532,4792,56740,52016,2.66711314769,0.0316654772289
"Kent County, Delaware",2012,162785,36.6,65394,7578,57816,55786,2.81557008441,0.0465522007556
"Kent County, Delaware",2015,169509,37,67315,6744,60571,54976,2.79851744234,0.0397854981151
"Kent County, Maryland",2009,19998,44.1,10584,2513,8071,48284,2.47775988106,0.125662566257
"Kent County, Maryland",2012,20184,45.3,10552,2796,7756,54614,2.60237235688,0.138525564804
"Kent County, Maryland",2015,19923,46.2,10644,3020,7624,58147,2.61319517314,0.151583596848
"Kent County, Michigan",2009,601813,33.8,243049,17532,225517,49908,2.66859261164,0.0291319728886
"Kent County, Michigan",2012,605244,34.3,246875,18671,228204,51030,2.65220592102,0.0308487155593
"Kent County, Michigan",2015,622590,34.8,248224,15263,232961,53063,2.6725074154,0.0245153311168
"Kent County, Rhode Island",2009,169202,41.4,72350,3588,68762,62007,2.46069049766,0.0212054231037
"Kent County, Rhode Island",2012,166066,42.6,73633,4911,68722,61884,2.41648962487,0.0295725795768
"Kent County, Rhode Island",2015,164958,43.5,73631,5015,68616,64383,2.40407485135,0.0304016780029
"Kent County, Texas",2009,703,47.8,586,199,387,38092,1.8165374677,0.28307254623
"Kent County, Texas",2012,829,45.6,545,151,394,38750,2.10406091371,0.182147165259
"Kent County, Texas",2015,821,49.1,539,167,372,47024,2.20698924731,0.20341047503
"Kenton County, Kentucky",2009,156399,35.5,70043,6767,63276,53219,2.47169542955,0.0432675400738
"Kenton County, Kentucky",2012,159926,36.2,69053,6793,62260,53900,2.56867973016,0.0424758951015
"Kenton County, Kentucky",2015,163007,36.4,69369,7144,62225,54296,2.619638409,0.0438263387462
"Keokuk County, Iowa",2009,10712,43,5064,387,4677,42196,2.2903570665,0.0361277072442
"Keokuk County, Iowa",2012,10480,43.6,4943,533,4410,42688,2.37641723356,0.050858778626
"Keokuk County, Iowa",2015,10291,44.3,4899,552,4347,43838,2.36737980216,0.0536391021281
"Kern County, California",2009,780953,30.3,266880,27603,239277,46216,3.26380303999,0.0353452768605
"Kern County, California",2012,839153,30.7,283810,30632,253178,47727,3.3144783512,0.0365034743366
"Kern County, California",2015,865736,31.1,289529,29829,259700,49026,3.33360030805,0.0344550763743
"Kerr County, Texas",2009,47410,46.1,21453,2756,18697,43371,2.53570091459,0.0581311959502
"Kerr County, Texas",2012,49469,47.3,23703,3327,20376,43849,2.42780722419,0.0672542400291
"Kerr County, Texas",2015,50149,47.9,23977,3661,20316,43810,2.46844851349,0.073002452691
"Kershaw County, South Carolina",2009,58176,39.8,25647,2996,22651,45035,2.56836342766,0.05149889989
"Kershaw County, South Carolina",2012,61583,40.8,27438,3488,23950,44068,2.57131524008,0.0566390075183
"Kershaw County, South Carolina",2015,62722,41.3,27896,3702,24194,43622,2.59246094073,0.0590223526036
"Ketchikan Gateway Borough, Alaska",2009,13132,38.2,6623,661,5962,57500,2.20261657162,0.0503350593969
"Ketchikan Gateway Borough, Alaska",2012,13525,38.4,6190,823,5367,59736,2.52002981181,0.0608502772643
"Ketchikan Gateway Borough, Alaska",2015,13699,38.7,6220,953,5267,64222,2.60091133473,0.0695671216877
"Kewaunee County, Wisconsin",2009,20398,40.6,9074,803,8271,54711,2.46620723008,0.0393666045691
"Kewaunee County, Wisconsin",2012,20600,41.8,9283,1113,8170,55611,2.52141982864,0.0540291262136
"Kewaunee County, Wisconsin",2015,20483,43.5,9335,1197,8138,56863,2.51695748341,0.0584387052678
"Keweenaw County, Michigan",2009,2224,50,2397,1416,981,35977,2.26707441386,0.636690647482
"Keweenaw County, Michigan",2012,2168,51.8,2462,1450,1012,42406,2.14229249012,0.668819188192
"Keweenaw County, Michigan",2015,2198,54.5,2473,1433,1040,37813,2.11346153846,0.651956323931
"Keya Paha County, Nebraska",2009,863,45.4,556,186,370,34038,2.33243243243,0.215527230591
"Keya Paha County, Nebraska",2012,742,53.7,534,165,369,33472,2.0108401084,0.222371967655
"Keya Paha County, Nebraska",2015,711,52.8,488,145,343,38625,2.07288629738,0.203938115331
"Kidder County, North Dakota",2009,2298,48.5,1633,491,1142,38438,2.0122591944,0.213664055701
"Kidder County, North Dakota",2012,2426,48.5,1711,566,1145,45478,2.11877729258,0.233305853256
"Kidder County, North Dakota",2015,2430,47,1683,599,1084,54559,2.24169741697,0.246502057613
"Kimball County, Nebraska",2009,3644,45.9,1981,330,1651,40233,2.20714718353,0.0905598243688
"Kimball County, Nebraska",2012,3789,46.8,1954,273,1681,43542,2.25401546698,0.0720506730008
"Kimball County, Nebraska",2015,3720,45.7,1933,359,1574,40242,2.36340533672,0.0965053763441
"Kimble County, Texas",2009,4485,48.1,3065,1215,1850,42188,2.42432432432,0.270903010033
"Kimble County, Texas",2012,4577,51.3,3403,1453,1950,46786,2.34717948718,0.317456849465
"Kimble County, Texas",2015,4486,52.8,3351,1361,1990,40125,2.25427135678,0.303388319215
"King County, Texas",2009,233,36.7,184,90,94,48182,2.47872340426,0.386266094421
"King County, Texas",2012,227,53.9,160,57,103,63750,2.20388349515,0.251101321586
"King County, Texas",2015,267,46.2,159,46,113,63250,2.36283185841,0.172284644195
"King County, Washington",2009,1858788,36.8,817572,50086,767486,67246,2.42191779394,0.0269455150345
"King County, Washington",2012,1940777,37.1,851180,54625,796555,71175,2.43646326996,0.0281459436092
"King County, Washington",2015,2045756,37.2,871836,52185,819651,75302,2.49588666396,0.0255089072206
"King George County, Virginia",2009,22286,34.6,8978,1044,7934,73941,2.80892361986,0.0468455532621
"King George County, Virginia",2012,23739,36.5,9465,1299,8166,82195,2.90705363703,0.0547200808796
"King George County, Virginia",2015,24933,36.6,9706,1327,8379,81688,2.97565341926,0.0532226366663
"King William County, Virginia",2009,15492,38.1,6258,598,5660,64682,2.7371024735,0.0386005680351
"King William County, Virginia",2012,15861,39.3,6507,472,6035,63151,2.62816901408,0.0297585272051
"King William County, Virginia",2015,16097,40.7,6632,596,6036,62031,2.6668323393,0.037025532708
"King and Queen County, Virginia",2009,6806,43.5,3314,485,2829,43766,2.40579710145,0.0712606523656
"King and Queen County, Virginia",2012,6968,44.7,3415,491,2924,49410,2.3830369357,0.0704649827784
"King and Queen County, Virginia",2015,7106,45.9,3446,552,2894,48292,2.45542501728,0.0776808330988
"Kingfisher County, Oklahoma",2009,14219,38.8,6127,814,5313,48811,2.67626576322,0.0572473451016
"Kingfisher County, Oklahoma",2012,14965,38.3,6404,714,5690,53466,2.63005272408,0.0477113264283
"Kingfisher County, Oklahoma",2015,15302,38.6,6454,713,5741,60034,2.665389305,0.0465952163116
"Kingman County, Kansas",2009,7789,44.8,3719,319,3400,44032,2.29088235294,0.0409551932212
"Kingman County, Kansas",2012,7876,44.6,3819,566,3253,47801,2.42114970796,0.0718638902996
"Kingman County, Kansas",2015,7790,45.2,3811,805,3006,50844,2.59148369927,0.103337612323
"Kings County, California",2009,146696,30,41547,2284,39263,46595,3.73624022617,0.0155696133501
"Kings County, California",2012,151982,31.2,43837,3070,40767,48761,3.72806436579,0.020199760498
"Kings County, California",2015,150998,31.4,44628,3074,41554,46481,3.633777735,0.0203578855349
"Kings County, New York",2009,2538140,34.2,961271,76074,885197,42894,2.86731654084,0.0299723419512
"Kings County, New York",2012,2512740,34.1,998773,86778,911995,45215,2.75521247375,0.0345352085771
"Kings County, New York",2015,2595259,34.4,1017282,85496,931786,48201,2.7852521931,0.0329431474855
"Kingsbury County, South Dakota",2009,5345,47.1,2810,435,2375,42822,2.25052631579,0.0813844714687
"Kingsbury County, South Dakota",2012,5159,46.8,2718,399,2319,50060,2.22466580423,0.0773405698779
"Kingsbury County, South Dakota",2015,5107,46,2718,435,2283,53828,2.23696890057,0.0851772077541
"Kinney County, Texas",2009,3245,47.8,1960,727,1233,24024,2.63179237632,0.224036979969
"Kinney County, Texas",2012,3574,46.4,1909,724,1185,34083,3.01603375527,0.202574146614
"Kinney County, Texas",2015,3577,44.9,1734,655,1079,38281,3.31510658017,0.183114341627
"Kiowa County, Colorado",2009,1644,49.2,1021,277,744,42422,2.20967741935,0.168491484185
"Kiowa County, Colorado",2012,1393,40.1,755,227,528,41739,2.63825757576,0.16295764537
"Kiowa County, Colorado",2015,1463,41.2,820,237,583,40304,2.50943396226,0.161995898838
"Kiowa County, Kansas",2009,2646,42.5,1325,299,1026,38750,2.57894736842,0.113000755858
"Kiowa County, Kansas",2012,2503,42.3,1232,168,1064,41574,2.35244360902,0.067119456652
"Kiowa County, Kansas",2015,2536,41.7,1227,161,1066,43963,2.37898686679,0.0634858044164
"Kiowa County, Oklahoma",2009,9392,43.1,5356,1362,3994,32375,2.35152729094,0.145017035775
"Kiowa County, Oklahoma",2012,9421,41.8,5212,1320,3892,35426,2.42060637205,0.140112514595
"Kiowa County, Oklahoma",2015,9302,43,5183,1244,3939,39909,2.36151307438,0.133734680714
"Kit Carson County, Colorado",2009,8072,39.3,3558,580,2978,40754,2.71054398925,0.0718533201189
"Kit Carson County, Colorado",2012,8210,39,3527,476,3051,42832,2.69092100951,0.0579780755177
"Kit Carson County, Colorado",2015,7980,38.9,3503,500,3003,40603,2.65734265734,0.062656641604
"Kitsap County, Washington",2009,238825,39.2,100929,9012,91917,59358,2.59826800265,0.0377347430127
"Kitsap County, Washington",2012,251400,39.3,107187,9519,97668,61776,2.57402629316,0.0378639618138
"Kitsap County, Washington",2015,255441,39.3,108689,10950,97739,62941,2.61350126357,0.0428670417043
"Kittitas County, Washington",2009,38428,29.9,19239,3621,15618,41025,2.46049430145,0.0942281669616
"Kittitas County, Washington",2012,40954,32.4,21803,5304,16499,41739,2.48221104309,0.129511158861
"Kittitas County, Washington",2015,42204,33,22364,5411,16953,46458,2.48947089011,0.128210596152
"Kittson County, Minnesota",2009,4523,47.4,2738,670,2068,47770,2.18713733075,0.148131770948
"Kittson County, Minnesota",2012,4547,47.8,2622,687,1935,49301,2.34987080103,0.151088629866
"Kittson County, Minnesota",2015,4480,48.1,2604,692,1912,52326,2.34309623431,0.154464285714
"Klamath County, Oregon",2009,66170,40.2,31199,4438,26761,41040,2.47262807817,0.0670696690343
"Klamath County, Oregon",2012,66350,41.6,32737,4990,27747,41066,2.39124950445,0.0752072343632
"Klamath County, Oregon",2015,65972,42.5,32825,5637,27188,40336,2.42651169634,0.0854453404475
"Kleberg County, Texas",2009,30637,27.6,12970,1927,11043,34652,2.77433668387,0.0628978033097
"Kleberg County, Texas",2012,31925,28.7,12795,1771,11024,38058,2.89595428157,0.0554737666406
"Kleberg County, Texas",2015,32029,28,12995,2089,10906,38247,2.93682376673,0.0652221424334
"Klickitat County, Washington",2009,20066,44.4,9335,1086,8249,37656,2.43253727725,0.054121399382
"Klickitat County, Washington",2012,20421,45.3,9774,1480,8294,40171,2.46214130697,0.0724744135938
"Klickitat County, Washington",2015,20820,45,9894,2031,7863,48319,2.64784433422,0.0975504322767
"Knott County, Kentucky",2009,17197,40.4,8042,1451,6591,28231,2.60916401153,0.0843751817177
"Knott County, Kentucky",2012,16368,41.1,7486,1631,5855,32482,2.79555935098,0.0996456500489
"Knott County, Kentucky",2015,16000,40.8,7458,1474,5984,30411,2.67379679144,0.092125
"Knox County, Illinois",2009,52077,41.3,24019,2143,21876,38535,2.38055403182,0.0411506039134
"Knox County, Illinois",2012,52698,41.8,24040,2304,21736,40419,2.42445712183,0.0437208243197
"Knox County, Illinois",2015,52112,42.1,23945,2644,21301,39976,2.44645791277,0.0507368744243
"Knox County, Indiana",2009,37970,37.7,17690,2224,15466,39215,2.45506271822,0.0585725572821
"Knox County, Indiana",2012,38392,38.9,17055,2132,14923,41089,2.57267305502,0.0555324025839
"Knox County, Indiana",2015,38062,39.2,16997,2218,14779,42725,2.57541105623,0.0582733434922
"Knox County, Kentucky",2009,32326,37,14775,2159,12616,21195,2.56230183893,0.0667883437481
"Knox County, Kentucky",2012,31874,38.8,14489,2068,12421,24193,2.56613799211,0.0648804668382
"Knox County, Kentucky",2015,31809,39.2,14471,2004,12467,26599,2.55145584343,0.0630010374422
"Knox County, Maine",2009,40897,44.8,23343,6395,16948,45147,2.41308708992,0.156368437783
"Knox County, Maine",2012,39848,46.6,23738,6881,16857,47714,2.3638844397,0.172681188516
"Knox County, Maine",2015,39723,47.2,23889,6890,16999,50693,2.33678451674,0.173451149208
"Knox County, Missouri",2009,4040,44.3,2384,634,1750,33681,2.30857142857,0.156930693069
"Knox County, Missouri",2012,4111,43.9,2290,484,1806,32500,2.27630121816,0.1177329117
"Knox County, Missouri",2015,4035,43.6,2272,583,1689,38289,2.38898756661,0.14448574969
"Knox County, Nebraska",2009,8566,45.5,4778,967,3811,35349,2.24770401469,0.112888162503
"Knox County, Nebraska",2012,8648,46.6,4770,1002,3768,41372,2.29511677282,0.11586493987
"Knox County, Nebraska",2015,8556,47.6,4801,1085,3716,45411,2.30247578041,0.126811594203
"Knox County, Ohio",2009,58871,38.2,24032,2433,21599,45525,2.72563544609,0.0413276485876
"Knox County, Ohio",2012,60791,39,25113,2630,22483,49323,2.70386514255,0.0432629830074
"Knox County, Ohio",2015,61004,38.7,25388,2629,22759,48533,2.68043411398,0.043095534719
"Knox County, Tennessee",2009,423655,37,192729,15554,177175,46233,2.39116692536,0.0367138355502
"Knox County, Tennessee",2012,433207,37.2,195245,14125,181120,47270,2.39182310071,0.03260565965
"Knox County, Tennessee",2015,444348,37.3,198119,17390,180729,48701,2.45864249788,0.0391359925104
"Knox County, Texas",2009,3465,46.8,2165,495,1670,31926,2.0748502994,0.142857142857
"Knox County, Texas",2012,3713,41.4,2050,452,1598,33667,2.32352941176,0.121734446539
"Knox County, Texas",2015,3796,40.9,2041,604,1437,40493,2.6416144746,0.159114857745
"Kodiak Island Borough, Alaska",2009,13147,32.5,5593,988,4605,59655,2.8549402823,0.0751502243858
"Kodiak Island Borough, Alaska",2012,13710,31.5,5326,858,4468,70976,3.0684870188,0.0625820568928
"Kodiak Island Borough, Alaska",2015,13973,32.4,5320,743,4577,70887,3.05287306096,0.0531739783869
"Koochiching County, Minnesota",2009,13396,46,8116,1702,6414,39088,2.08855628313,0.127052851597
"Koochiching County, Minnesota",2012,13293,46.2,7901,1747,6154,40167,2.16005849854,0.131422553224
"Koochiching County, Minnesota",2015,13054,47.4,7877,2033,5844,42919,2.23374401095,0.155737704918
"Kootenai County, Idaho",2009,133461,38.1,58358,6212,52146,45446,2.55937176389,0.0465454327481
"Kootenai County, Idaho",2012,139083,39.1,63146,7795,55351,49151,2.51274593052,0.0560456705708
"Kootenai County, Idaho",2015,145046,39.4,65272,8851,56421,49403,2.57078038319,0.0610220206004
"Kosciusko County, Indiana",2009,76096,36.8,35809,5391,30418,49897,2.50167663883,0.0708447224558
"Kosciusko County, Indiana",2012,77328,37.8,36999,6886,30113,50822,2.56792747318,0.0890492447755
"Kosciusko County, Indiana",2015,77983,37.9,37418,7832,29586,52821,2.63580747651,0.100432145468
"Kossuth County, Iowa",2009,15495,46.2,7651,876,6775,46176,2.28708487085,0.0565343659245
"Kossuth County, Iowa",2012,15510,46.9,7481,731,6750,49431,2.29777777778,0.0471308833011
"Kossuth County, Iowa",2015,15280,46.1,7483,760,6723,51496,2.27279488324,0.0497382198953
"Kusilvak Census Area, Alaska",2015,7914,23,2193,510,1683,38229,4.70231729055,0.0644427596664
"La Crosse County, Wisconsin",2009,111491,34.4,47031,2148,44883,48543,2.48403627209,0.0192661291046
"La Crosse County, Wisconsin",2012,114718,35.3,48381,2323,46058,50771,2.49072908072,0.0202496556774
"La Crosse County, Wisconsin",2015,117048,35.4,49008,2663,46345,50539,2.52557988996,0.0227513498736
"La Paz County, Arizona",2009,20055,50.4,15846,6316,9530,31640,2.10440713536,0.314933931688
"La Paz County, Arizona",2012,20460,54.1,16039,5542,10497,35093,1.94912832238,0.270869990225
"La Paz County, Arizona",2015,20335,54.8,16104,6739,9365,34466,2.17138280833,0.33139906565
"La Plata County, Colorado",2009,49678,37.3,25304,4236,21068,53713,2.35798367192,0.0852691332179
"La Plata County, Colorado",2012,51443,37.7,25894,4834,21060,57407,2.44268755935,0.0939680811772
"La Plata County, Colorado",2015,53182,38.8,26365,4852,21513,60278,2.47208664528,0.0912338761235
"La Salle County, Texas",2009,5891,31.9,2318,612,1706,31838,3.4531066823,0.10388728569
"La Salle County, Texas",2012,6850,33.9,2568,684,1884,26731,3.63588110403,0.0998540145985
"La Salle County, Texas",2015,7191,31.7,2923,952,1971,37292,3.64840182648,0.132387706856
"La Salle Parish, Louisiana",2009,13973,37.7,6604,1435,5169,33307,2.70323079899,0.102698060545
"LaGrange County, Indiana",2009,36857,31.5,14355,1894,12461,49324,2.95778829949,0.0513877960767
"LaGrange County, Indiana",2012,37284,30.7,14127,2194,11933,46625,3.12444481689,0.058845617423
"LaGrange County, Indiana",2015,38084,31.1,14283,2564,11719,49964,3.24976533834,0.0673248608339
"LaMoure County, North Dakota",2009,4085,47.8,2217,322,1895,41992,2.15567282322,0.0788249694002
"LaMoure County, North Dakota",2012,4141,48.6,2288,322,1966,52813,2.10630722279,0.0777589954117
"LaMoure County, North Dakota",2015,4113,48.5,2251,411,1840,54821,2.23532608696,0.0999270605398
"LaPorte County, Indiana",2009,110102,38.9,48260,6180,42080,47090,2.61649239544,0.0561297705764
"LaPorte County, Indiana",2012,111335,39.5,48481,5912,42569,47754,2.61540087857,0.053101001482
"LaPorte County, Indiana",2015,111280,39.9,48682,5678,43004,46872,2.5876662636,0.0510244428469
"LaSalle County, Illinois",2009,112293,40,49175,4081,45094,50270,2.49019825254,0.0363424256187
"LaSalle County, Illinois",2012,113688,41.1,49924,5215,44709,52356,2.54284372274,0.0458711561466
"LaSalle County, Illinois",2015,112579,41.6,49935,5693,44242,50633,2.54461823607,0.0505689338154
"LaSalle Parish, Louisiana",2012,14840,38.3,6556,838,5718,43641,2.59531304652,0.0564690026954
"LaSalle Parish, Louisiana",2015,14899,38.6,6581,1030,5551,37310,2.68402089714,0.0691321565206
"Labette County, Kansas",2009,21881,40,10409,1265,9144,37674,2.39293525809,0.057812714227
"Labette County, Kansas",2012,21574,40.3,10102,1263,8839,40117,2.44077384319,0.0585426902753
"Labette County, Kansas",2015,21048,40.6,10070,1657,8413,41439,2.50184238678,0.0787248194603
"Lac qui Parle County, Minnesota",2009,7258,47.7,3750,649,3101,44753,2.34053531119,0.0894185726095
"Lac qui Parle County, Minnesota",2012,7240,49.1,3689,630,3059,50203,2.36678653155,0.0870165745856
"Lac qui Parle County, Minnesota",2015,7023,49.8,3672,594,3078,49903,2.28167641326,0.0845792396412
"Lackawanna County, Pennsylvania",2009,209100,41.5,97304,10380,86924,42801,2.40554967558,0.0496413199426
"Lackawanna County, Pennsylvania",2012,214353,42.1,96821,10666,86155,45483,2.48799257153,0.0497590423274
"Lackawanna County, Pennsylvania",2015,213459,42.3,97028,11994,85034,46271,2.51027824164,0.056188776299
"Laclede County, Missouri",2009,35046,38,15543,1304,14239,35749,2.4612683475,0.0372082405981
"Laclede County, Missouri",2012,35507,39.1,15769,1600,14169,39101,2.50596372362,0.0450615371617
"Laclede County, Missouri",2015,35514,39.8,15768,2223,13545,39712,2.6219269103,0.0625950329448
"Lafayette County, Arkansas",2009,7715,43.1,4801,1671,3130,26491,2.46485623003,0.216591056384
"Lafayette County, Arkansas",2012,7618,42.9,4372,1599,2773,28633,2.74720519293,0.209897610922
"Lafayette County, Arkansas",2015,7270,45,4353,1523,2830,31194,2.56890459364,0.209491059147
"Lafayette County, Florida",2009,7981,31.2,3166,1248,1918,46551,4.16110531804,0.156371382032
"Lafayette County, Florida",2012,8668,33.8,3365,643,2722,44180,3.18442321822,0.0741808952469
"Lafayette County, Florida",2015,8801,36.4,3239,746,2493,35864,3.53028479743,0.0847630951028
"Lafayette County, Mississippi",2009,43025,26.4,18865,4030,14835,40202,2.90023592855,0.0936664729808
"Lafayette County, Mississippi",2012,47586,27.3,22532,7231,15301,42688,3.10999281093,0.151956457782
"Lafayette County, Mississippi",2015,51169,28.5,23524,6190,17334,44643,2.95194415599,0.120971682073
"Lafayette County, Missouri",2009,32741,40.4,14515,1178,13337,47811,2.45489990253,0.0359793531047
"Lafayette County, Missouri",2012,33278,40.3,14693,1443,13250,51917,2.51154716981,0.0433619808883
"Lafayette County, Missouri",2015,32916,41,14718,1530,13188,50723,2.49590536852,0.0464819540649
"Lafayette County, Wisconsin",2009,15883,41.9,7085,547,6538,47306,2.42933618844,0.0344393376566
"Lafayette County, Wisconsin",2012,16836,41,7218,620,6598,49263,2.55168232798,0.0368258493704
"Lafayette County, Wisconsin",2015,16835,41.4,7240,594,6646,51445,2.53310261812,0.0352836352836
"Lafayette Parish, Louisiana",2009,204963,33.1,88324,7226,81098,46526,2.52734962638,0.0352551436113
"Lafayette Parish, Louisiana",2012,221602,33.6,93678,8100,85578,49705,2.58947393022,0.0365520166785
"Lafayette Parish, Louisiana",2015,231811,34,96468,7473,88995,51869,2.6047643126,0.0322374693177
"Lafourche Parish, Louisiana",2009,92852,36.1,37866,4196,33670,46196,2.75770715771,0.0451901951493
"Lafourche Parish, Louisiana",2012,96453,36.7,38622,3627,34995,50574,2.75619374196,0.0376038070356
"Lafourche Parish, Louisiana",2015,97474,36.6,39418,3826,35592,51030,2.73864913464,0.0392514927057
"Lajas Municipio, Puerto Rico",2009,27826,37.2,10994,2265,8729,14657,3.18776492153,0.0813986918709
"Lajas Municipio, Puerto Rico",2012,25671,39.1,11719,3473,8246,13698,3.11314576764,0.135288847337
"Lajas Municipio, Puerto Rico",2015,24722,41.9,12122,3705,8417,13215,2.93715100392,0.149866515654
"Lake County, California",2009,64756,43.1,35070,9910,25160,41182,2.57376788553,0.153036012107
"Lake County, California",2012,64360,44.8,35449,9346,26103,38147,2.46561697889,0.145214418894
"Lake County, California",2015,64158,45.5,35626,8633,26993,35578,2.3768384396,0.134558433866
"Lake County, Colorado",2009,8025,34.4,4528,1521,3007,39147,2.66877286332,0.18953271028
"Lake County, Colorado",2012,7372,34.2,4416,1537,2879,45082,2.56061132338,0.208491589799
"Lake County, Colorado",2015,7362,39,4523,1498,3025,45367,2.43371900826,0.203477315947
"Lake County, Florida",2009,297828,47.2,138560,21374,117186,44837,2.54149813118,0.0717662543481
"Lake County, Florida",2012,297995,45.7,144786,27531,117255,45663,2.54142680483,0.0923874561654
"Lake County, Florida",2015,310561,46.4,146181,26930,119251,46403,2.60426327662,0.0867140432958
"Lake County, Illinois",2009,702558,35.9,251726,16886,234840,78423,2.99164537557,0.0240350262896
"Lake County, Illinois",2012,701282,36.7,260020,19276,240744,79085,2.91297810122,0.0274868027413
"Lake County, Illinois",2015,702898,37.6,261229,18803,242426,78026,2.89943322911,0.0267506807531
"Lake County, Indiana",2009,491203,36.9,208921,24578,184343,47962,2.66461433306,0.0500363393546
"Lake County, Indiana",2012,495230,37.3,208913,26885,182028,49315,2.72062539829,0.0542879066292
"Lake County, Indiana",2015,491596,38.1,209868,26554,183314,50135,2.68171552636,0.0540158992343
"Lake County, Michigan",2009,11191,46.8,14377,10441,3936,30629,2.84324186992,0.932981860424
"Lake County, Michigan",2012,11543,50,14927,10788,4139,30390,2.78883788355,0.934592393658
"Lake County, Michigan",2015,11426,51.5,14927,10562,4365,30439,2.61764032073,0.924382986172
"Lake County, Minnesota",2009,10751,46.9,7487,2294,5193,44433,2.07028692471,0.213375499953
"Lake County, Minnesota",2012,10849,48.4,7671,2580,5091,47210,2.13101551758,0.2378099364
"Lake County, Minnesota",2015,10750,50.2,7715,2628,5087,48417,2.11322980145,0.244465116279
"Lake County, Montana",2009,28239,39.7,14145,3370,10775,39048,2.62078886311,0.119338503488
"Lake County, Montana",2012,28794,41,16484,4461,12023,37211,2.3949097563,0.154928110023
"Lake County, Montana",2015,29157,41.6,16613,4635,11978,38732,2.43421272333,0.158966971911
"Lake County, Ohio",2009,234634,41.4,98530,5409,93121,54616,2.51966795889,0.023052924981
"Lake County, Ohio",2012,229873,42.5,101036,6647,94389,56231,2.43537912257,0.0289159666425
"Lake County, Ohio",2015,229437,43.2,101632,6817,94815,58029,2.41983863313,0.0297118599005
"Lake County, Oregon",2009,7160,46.7,4132,884,3248,37500,2.20443349754,0.123463687151
"Lake County, Oregon",2012,7886,48,4413,847,3566,40049,2.21144139091,0.107405528785
"Lake County, Oregon",2015,7842,48.3,4411,885,3526,32369,2.22404991492,0.11285386381
"Lake County, South Dakota",2009,11500,40,5684,1204,4480,46241,2.56696428571,0.104695652174
"Lake County, South Dakota",2012,11364,41.2,5567,973,4594,46071,2.47366129734,0.0856212601197
"Lake County, South Dakota",2015,12086,41.9,5619,855,4764,54535,2.53694374475,0.0707430084395
"Lake County, Tennessee",2009,7404,38.1,2775,370,2405,23441,3.07858627859,0.0499729875743
"Lake County, Tennessee",2012,7780,39.7,2615,264,2351,26212,3.30923011484,0.0339331619537
"Lake County, Tennessee",2015,7687,40.3,2602,510,2092,30086,3.67447418738,0.0663457785872
"Lake and Peninsula Borough, Alaska",2009,1399,24.8,1495,1030,465,41458,3.00860215054,0.736240171551
"Lake and Peninsula Borough, Alaska",2012,1551,28.7,1653,1083,570,49808,2.72105263158,0.698259187621
"Lake and Peninsula Borough, Alaska",2015,1474,31.1,1508,1017,491,50781,3.00203665988,0.689959294437
"Lake of the Woods County, Minnesota",2009,4068,47.7,3531,1715,1816,44306,2.24008810573,0.421583087512
"Lake of the Woods County, Minnesota",2012,4039,48.5,3668,1919,1749,41979,2.30931961121,0.475117603367
"Lake of the Woods County, Minnesota",2015,3949,50.3,3671,2048,1623,42263,2.43314849045,0.518612306913
"Lamar County, Alabama",2009,14438,41.2,7718,1573,6145,31094,2.34955248169,0.10894860784
"Lamar County, Alabama",2012,14513,42.6,7372,1265,6107,35271,2.37645325037,0.0871632329635
"Lamar County, Alabama",2015,14133,43.7,7314,1176,6138,35450,2.30254154448,0.0832095096582
"Lamar County, Georgia",2009,17010,37.7,7256,957,6299,35835,2.70042863947,0.0562610229277
"Lamar County, Georgia",2012,18151,38.2,7478,1020,6458,39224,2.81062248374,0.0561952509504
"Lamar County, Georgia",2015,18114,38.6,7521,1090,6431,40344,2.81666925828,0.0601744507011
"Lamar County, Mississippi",2009,47307,32.8,16656,1485,15171,48328,3.11825192802,0.0313907032786
"Lamar County, Mississippi",2012,55580,33.1,23676,2203,21473,50743,2.5883667862,0.0396365599136
"Lamar County, Mississippi",2015,58885,34,24202,2337,21865,52035,2.69311685342,0.0396875265348
"Lamar County, Texas",2009,48993,38.8,22149,3222,18927,37029,2.58852433032,0.065764496969
"Lamar County, Texas",2012,49740,40.1,22494,3234,19260,39630,2.58255451713,0.0650180940893
"Lamar County, Texas",2015,49566,40.3,22558,3532,19026,40748,2.60517187007,0.0712585239882
"Lamb County, Texas",2009,13741,37.1,6361,1378,4983,35716,2.75757575758,0.100283822138
"Lamb County, Texas",2012,13996,36.1,6148,1258,4890,35265,2.86216768916,0.0898828236639
"Lamb County, Texas",2015,13742,36.1,6103,1238,4865,39851,2.8246659815,0.0900887789259
"Lamoille County, Vermont",2009,25253,39.4,12062,2208,9854,51037,2.56271564847,0.0874351562191
"Lamoille County, Vermont",2012,24471,40.1,12950,2975,9975,54064,2.45323308271,0.12157247354
"Lamoille County, Vermont",2015,25027,40.5,13122,2946,10176,50939,2.45941430818,0.1177128701
"Lampasas County, Texas",2009,20471,39.1,8110,1404,6706,44301,3.05263942738,0.0685848273167
"Lampasas County, Texas",2012,19837,40.3,8677,1586,7091,47968,2.79748977577,0.0799516055855
"Lampasas County, Texas",2015,20219,40.8,8892,1387,7505,49630,2.69407061959,0.0685988426727
"Lancaster County, Nebraska",2009,274432,31.5,116158,7403,108755,50217,2.52339662544,0.0269757171175
"Lancaster County, Nebraska",2012,286425,32.6,120976,7252,113724,51810,2.51859765749,0.0253190189404
"Lancaster County, Nebraska",2015,298080,32.9,123773,6106,117667,51830,2.53325061402,0.0204844337091
"Lancaster County, Pennsylvania",2009,498918,37.6,193957,7656,186301,54893,2.67802105195,0.015345207028
"Lancaster County, Pennsylvania",2012,519913,38,202800,9494,193306,56172,2.68958542415,0.0182607474712
"Lancaster County, Pennsylvania",2015,530216,38.4,205587,10257,195330,57721,2.71446270414,0.0193449462106
"Lancaster County, South Carolina",2009,73725,38.1,29391,3385,26006,38590,2.83492271014,0.0459138691082
"Lancaster County, South Carolina",2012,76364,40.1,32381,3432,28949,42107,2.63788041038,0.0449426431303
"Lancaster County, South Carolina",2015,81263,41.6,33464,4069,29395,44016,2.76451777513,0.0500719884818
"Lancaster County, Virginia",2009,11408,53.7,7190,1862,5328,44485,2.14114114114,0.163218793829
"Lancaster County, Virginia",2012,11371,54.2,7418,2023,5395,49516,2.10769230769,0.177908715153
"Lancaster County, Virginia",2015,11129,55.6,7544,2380,5164,50374,2.15511231603,0.213855692335
"Lander County, Nevada",2009,5047,36.5,2287,453,1834,54008,2.75190839695,0.0897562908659
"Lander County, Nevada",2012,5751,35.4,2318,338,1980,70341,2.90454545455,0.0587723874109
"Lander County, Nevada",2015,5946,37.2,2484,370,2114,78190,2.81267738884,0.0622267070299
"Lane County, Kansas",2009,1661,44.2,1011,262,749,40265,2.217623498,0.157736303432
"Lane County, Kansas",2012,1666,45.3,974,215,759,49063,2.19499341238,0.129051620648
"Lane County, Kansas",2015,1674,44.6,955,150,805,56507,2.07950310559,0.089605734767
"Lane County, Oregon",2009,343774,38.3,149234,9641,139593,42852,2.46268795713,0.0280445874324
"Lane County, Oregon",2012,351794,38.8,155815,10341,145474,42628,2.41826030768,0.0293950436903
"Lane County, Oregon",2015,357060,39.3,157510,11275,146235,44103,2.4416863268,0.0315773259396
"Langlade County, Wisconsin",2009,20255,44.4,12083,3343,8740,40140,2.31750572082,0.165045667736
"Langlade County, Wisconsin",2012,19951,46.1,12339,3545,8794,42958,2.26870593587,0.177685329056
"Langlade County, Wisconsin",2015,19551,47.2,12406,3693,8713,41775,2.24388844256,0.188890593832
"Lanier County, Georgia",2009,7967,33.8,3578,639,2939,34497,2.71078598163,0.0802058491277
"Lanier County, Georgia",2012,10066,32.7,4215,588,3627,41867,2.7752963882,0.0584144645341
"Lanier County, Georgia",2015,10403,33.6,4298,586,3712,37605,2.80253232759,0.0563299048351
"Lapeer County, Michigan",2009,91453,40.1,35721,2528,33193,56116,2.75518934715,0.027642614239
"Lapeer County, Michigan",2012,88626,41.6,36283,3500,32783,52369,2.70341335448,0.0394917969896
"Lapeer County, Michigan",2015,88235,43.3,36238,3556,32682,52996,2.69980417355,0.0403014676716
"Laramie County, Wyoming",2009,86892,36,37707,3836,33871,51465,2.56538041392,0.0441467568936
"Laramie County, Wyoming",2012,91719,37.3,40384,3648,36736,54596,2.49670622822,0.0397736564943
"Laramie County, Wyoming",2015,95431,36.7,41256,3962,37294,60706,2.55888346651,0.0415169075039
"Lares Municipio, Puerto Rico",2009,37589,35.9,11916,1703,10213,12227,3.68050523842,0.0453058075501
"Lares Municipio, Puerto Rico",2012,30628,37.5,11944,2047,9897,12094,3.09467515409,0.0668342692961
"Lares Municipio, Puerto Rico",2015,28727,39.2,12178,2050,10128,11905,2.83639415482,0.0713614369757
"Larimer County, Colorado",2009,286978,34.7,127685,12829,114856,54755,2.4985895382,0.0447037752023
"Larimer County, Colorado",2012,300870,35.4,132936,12344,120592,57927,2.49494162133,0.0410276863762
"Larimer County, Colorado",2015,318227,35.5,136851,11713,125138,59805,2.5430085186,0.0368070591119
"Larue County, Kentucky",2009,13579,41,6525,1377,5148,38970,2.63772338772,0.101406583695
"Larue County, Kentucky",2012,14175,39.5,6196,927,5269,39103,2.69026380717,0.0653968253968
"Larue County, Kentucky",2015,14149,40.6,6249,921,5328,38578,2.65559309309,0.0650929394303
"Las Animas County, Colorado",2009,15814,43.1,8088,1683,6405,37587,2.46900858704,0.106424686986
"Las Animas County, Colorado",2012,15385,44.2,8206,2045,6161,41623,2.49715955202,0.132921676958
"Las Animas County, Colorado",2015,14503,45,8232,2406,5826,45067,2.48935805012,0.165896711025
"Las Marías Municipio, Puerto Rico",2009,12093,34.7,3993,446,3547,14088,3.40936002255,0.0368808401555
"Las Marías Municipio, Puerto Rico",2012,9853,36.6,3929,674,3255,14460,3.02703533026,0.0684055617578
"Las Marías Municipio, Puerto Rico",2015,9306,38,3905,761,3144,13944,2.95992366412,0.0817751987965
"Las Piedras Municipio, Puerto Rico",2009,39253,33.6,13197,1803,11394,16987,3.44505880288,0.0459327949456
"Las Piedras Municipio, Puerto Rico",2012,38687,35.4,14065,2410,11655,19345,3.31934791935,0.0622948277199
"Las Piedras Municipio, Puerto Rico",2015,38605,37,15616,2732,12884,18838,2.99635206458,0.0707680352286
"Lassen County, California",2009,34428,36.6,12809,2521,10288,48653,3.34642301711,0.0732252817474
"Lassen County, California",2012,34628,37.4,12705,2578,10127,51921,3.41937395082,0.0744484232413
"Lassen County, California",2015,32645,37,12733,3026,9707,51555,3.36303698362,0.0926941338643
"Latah County, Idaho",2009,37511,26,15250,1050,14200,36448,2.64161971831,0.0279917890752
"Latah County, Idaho",2012,37365,28.1,15963,950,15013,39466,2.48884300273,0.0254248628396
"Latah County, Idaho",2015,38339,28.5,16255,1175,15080,42439,2.54237400531,0.0306476433918
"Latimer County, Oklahoma",2009,10522,37.8,4901,873,4028,40550,2.61221449851,0.0829690172971
"Latimer County, Oklahoma",2012,11099,39.9,4969,745,4224,40585,2.62760416667,0.067123164249
"Latimer County, Oklahoma",2015,10774,39.3,4986,851,4135,39205,2.60556227328,0.0789864488584
"Lauderdale County, Alabama",2009,88550,39.6,42111,5653,36458,37691,2.42882220637,0.0638396386222
"Lauderdale County, Alabama",2012,92528,40.4,43762,5461,38301,40701,2.41581159761,0.0590199723327
"Lauderdale County, Alabama",2015,92737,41.1,44158,5546,38612,43125,2.40176629027,0.059803530414
"Lauderdale County, Mississippi",2009,77966,35.4,35221,4233,30988,33354,2.51600619595,0.0542928969038
"Lauderdale County, Mississippi",2012,80204,36.9,34745,5030,29715,36814,2.69910819451,0.0627150765548
"Lauderdale County, Mississippi",2015,79832,37.5,34885,5184,29701,38132,2.68785562776,0.0649363663694
"Lauderdale County, Tennessee",2009,26568,36.1,11516,2000,9516,31667,2.79192938209,0.0752785305631
"Lauderdale County, Tennessee",2012,27772,36.2,11258,1432,9826,32987,2.8263789945,0.0515627250468
"Lauderdale County, Tennessee",2015,27427,37.1,11282,1482,9800,30281,2.79867346939,0.0540343457177
"Laurel County, Kentucky",2009,57023,37,23609,3312,20297,35330,2.80942996502,0.0580818266314
"Laurel County, Kentucky",2012,58891,37.6,25355,2865,22490,36835,2.61854157403,0.0486491993683
"Laurel County, Kentucky",2015,59751,38.5,25447,2283,23164,36020,2.5794767743,0.038208565547
"Laurens County, Georgia",2009,47510,37,20352,3315,17037,38247,2.78863649704,0.0697747842559
"Laurens County, Georgia",2012,48264,38,21310,3777,17533,35912,2.75275195346,0.0782570860269
"Laurens County, Georgia",2015,47886,38.5,21323,3683,17640,32356,2.71462585034,0.0769118322683
"Laurens County, South Carolina",2009,69697,39.6,31668,5380,26288,38816,2.65128575776,0.0771912707864
"Laurens County, South Carolina",2012,66623,40.1,30740,5726,25014,38829,2.66342848005,0.0859462948231
"Laurens County, South Carolina",2015,66389,40.9,30630,5470,25160,38515,2.63867249603,0.0823931675428
"Lavaca County, Texas",2009,18632,44,9970,2251,7719,41696,2.41378416893,0.120813653929
"Lavaca County, Texas",2012,19269,45.2,10327,2448,7879,42934,2.44561492575,0.127043437646
"Lavaca County, Texas",2015,19549,44.9,10368,2667,7701,48677,2.53850149331,0.136426415673
"Lawrence County, Alabama",2009,34094,39.3,15562,1975,13587,41472,2.50931037021,0.0579280811873
"Lawrence County, Alabama",2012,34148,41,15227,1786,13441,39526,2.54058477792,0.0523017453438
"Lawrence County, Alabama",2015,33586,41.7,15190,1653,13537,40003,2.48105193174,0.0492169356279
"Lawrence County, Arkansas",2009,16912,40.3,8325,1256,7069,29119,2.39241759796,0.0742667928098
"Lawrence County, Arkansas",2012,17314,39.8,8006,1397,6609,32205,2.61976093206,0.0806861499365
"Lawrence County, Arkansas",2015,17029,41.1,7981,1285,6696,32379,2.54316009558,0.0754595102472
"Lawrence County, Illinois",2009,16550,38.8,7195,852,6343,38085,2.60917546902,0.0514803625378
"Lawrence County, Illinois",2012,16778,40.8,6889,842,6047,39324,2.7745989747,0.0501847657647
"Lawrence County, Illinois",2015,16665,40.7,5921,906,5015,40841,3.32303090728,0.0543654365437
"Lawrence County, Indiana",2009,45891,40.8,21312,2538,18774,40328,2.44439117929,0.0553049617572
"Lawrence County, Indiana",2012,46131,41.4,21071,2202,18869,41600,2.44480364619,0.0477336281459
"Lawrence County, Indiana",2015,45814,41.9,20965,2471,18494,45875,2.47723586028,0.0539354782381
"Lawrence County, Kentucky",2009,16338,38.2,7452,1398,6054,27002,2.69871159564,0.0855673889093
"Lawrence County, Kentucky",2012,15889,39.5,7281,1615,5666,32622,2.80427109072,0.101642645856
"Lawrence County, Kentucky",2015,15821,40.3,7272,1239,6033,35935,2.6224100779,0.0783136337779
"Lawrence County, Mississippi",2009,13258,37.5,5916,1016,4900,34643,2.70571428571,0.0766329763162
"Lawrence County, Mississippi",2012,12832,40.1,6011,1186,4825,38364,2.65948186528,0.0924251870324
"Lawrence County, Mississippi",2015,12586,40.7,6027,1247,4780,35634,2.63305439331,0.0990783410138
"Lawrence County, Missouri",2009,37351,37.7,15564,1502,14062,38232,2.65616555255,0.0402131134374
"Lawrence County, Missouri",2012,38559,39.3,16579,1672,14907,38568,2.58663715033,0.0433621203869
"Lawrence County, Missouri",2015,38244,39.6,16573,2090,14483,40597,2.64061313264,0.0546490952829
"Lawrence County, Ohio",2009,62683,39.3,27505,2844,24661,34596,2.54178662666,0.0453711532632
"Lawrence County, Ohio",2012,62441,40,27596,3606,23990,40244,2.60279283035,0.0577505164876
"Lawrence County, Ohio",2015,61827,41.2,27418,3870,23548,42874,2.6255732971,0.0625940123247
"Lawrence County, Pennsylvania",2009,90962,42.6,40512,4201,36311,42833,2.5050811049,0.0461841208417
"Lawrence County, Pennsylvania",2012,90885,43.7,40956,4244,36712,44079,2.47562105034,0.0466963745393
"Lawrence County, Pennsylvania",2015,89162,44.4,40830,4395,36435,44571,2.44715246329,0.0492922994101
"Lawrence County, South Dakota",2009,23159,38.7,11937,1537,10400,38996,2.22682692308,0.0663672870158
"Lawrence County, South Dakota",2012,24063,41.2,12745,2002,10743,43733,2.23987712929,0.0831982712048
"Lawrence County, South Dakota",2015,24645,41.5,13183,2655,10528,45548,2.34090045593,0.107729762629
"Lawrence County, Tennessee",2009,40899,38.6,17435,2036,15399,35662,2.65595168517,0.0497811682437
"Lawrence County, Tennessee",2012,41779,39.8,18130,2041,16089,36663,2.59674311641,0.0488522942148
"Lawrence County, Tennessee",2015,42226,39.9,18146,2042,16104,37814,2.62208147044,0.048358831052
"Le Flore County, Oklahoma",2009,49480,36.9,21158,2811,18347,35963,2.69689867553,0.0568108326597
"Le Flore County, Oklahoma",2012,50056,38.5,21434,2872,18562,36084,2.69669216679,0.0573757391721
"Le Flore County, Oklahoma",2015,49899,39.7,21652,3488,18164,36490,2.74713719445,0.0699012004249
"Le Sueur County, Minnesota",2009,27768,39.7,12401,1695,10706,56489,2.59368578367,0.0610414866033
"Le Sueur County, Minnesota",2012,27744,40.2,12426,1434,10992,57831,2.52401746725,0.0516868512111
"Le Sueur County, Minnesota",2015,27707,41.3,12468,1629,10839,60632,2.55623212473,0.0587938066193
"Lea County, New Mexico",2009,58058,31.5,24240,2969,21271,42816,2.72944384373,0.0511385166558
"Lea County, New Mexico",2012,64670,31.6,24907,3905,21002,48793,3.07923054947,0.0603834853874
"Lea County, New Mexico",2015,68149,31.8,25117,3668,21449,57533,3.17725768101,0.053823240253
"Leake County, Mississippi",2009,22782,32.5,9057,1722,7335,32396,3.10593047035,0.0755859889386
"Leake County, Mississippi",2012,23563,32.7,9384,1407,7977,30862,2.95386736868,0.0597122607478
"Leake County, Mississippi",2015,23153,34.8,9416,1102,8314,33452,2.78482078422,0.0475964237896
"Leavenworth County, Kansas",2009,73504,36.8,27934,2508,25426,59515,2.89089907968,0.0341205920766
"Leavenworth County, Kansas",2012,76286,37.4,28670,2503,26167,62035,2.9153513968,0.0328107385366
"Leavenworth County, Kansas",2015,78227,37.3,28999,2252,26747,63726,2.92470183572,0.0287880143684
"Lebanon County, Pennsylvania",2009,127882,40.6,53389,3005,50384,51547,2.5381470308,0.0234982249261
"Lebanon County, Pennsylvania",2012,133578,40.8,55466,3322,52144,54259,2.56171371586,0.0248693647157
"Lebanon County, Pennsylvania",2015,135776,41.1,56017,3750,52267,55499,2.59773853483,0.0276190195616
"Lee County, Alabama",2009,130669,26.9,60498,6361,54137,38588,2.41367271921,0.0486802531587
"Lee County, Alabama",2012,140938,29.6,62638,7288,55350,43189,2.54630532972,0.0517106812925
"Lee County, Alabama",2015,150982,30.3,64964,7793,57171,44570,2.64088436445,0.0516154243552
"Lee County, Arkansas",2009,10776,37.5,5039,835,4204,26283,2.56327307326,0.0774870081663
"Lee County, Arkansas",2012,10430,39.8,4401,1000,3401,26098,3.06674507498,0.0958772770853
"Lee County, Arkansas",2015,9966,40.6,4370,765,3605,28393,2.76449375867,0.076760987357
"Lee County, Florida",2009,573676,44,349375,105386,243989,50362,2.35123714594,0.183702996116
"Lee County, Florida",2012,624155,45.5,370867,128776,242091,48453,2.57818341037,0.206320545377
"Lee County, Florida",2015,663675,46.9,374333,122046,252287,48537,2.63063495146,0.183894225336
"Lee County, Georgia",2009,32861,34.8,11588,993,10595,60456,3.10155733837,0.0302181917775
"Lee County, Georgia",2012,28449,35.9,10382,757,9625,58400,2.95574025974,0.0266090196492
"Lee County, Georgia",2015,28946,36.7,10589,574,10015,61537,2.8902646031,0.0198300283286
"Lee County, Illinois",2009,34994,40.9,14823,1273,13550,50483,2.58258302583,0.0363776647425
"Lee County, Illinois",2012,35778,41.6,15049,1363,13686,50342,2.61420429636,0.0380960366706
"Lee County, Illinois",2015,35027,42.2,15047,1530,13517,52379,2.59132943701,0.0436805892597
"Lee County, Iowa",2009,35772,42.1,16750,2106,14644,41700,2.44277519803,0.0588728614559
"Lee County, Iowa",2012,35741,42.4,16262,2042,14220,41954,2.51343178622,0.0571332643183
"Lee County, Iowa",2015,35369,42.9,16217,1805,14412,43312,2.45413544269,0.0510333908225
"Lee County, Kentucky",2009,7427,40.2,3506,682,2824,19104,2.62995750708,0.0918271172748
"Lee County, Kentucky",2012,7831,41.2,3436,608,2828,22789,2.76909476662,0.0776401481292
"Lee County, Kentucky",2015,7119,41.9,3436,577,2859,22698,2.49003147954,0.0810507093693
"Lee County, Mississippi",2009,80099,35.6,33539,3869,29670,37894,2.69966295922,0.0483027253773
"Lee County, Mississippi",2012,83235,35.9,35735,3976,31759,41242,2.62083189017,0.0477683666727
"Lee County, Mississippi",2015,85036,36.5,36151,3840,32311,42784,2.63179722076,0.0451573451244
"Lee County, North Carolina",2009,57919,38.1,23306,2425,20881,43330,2.77376562425,0.0418688167959
"Lee County, North Carolina",2012,57876,37.6,24070,2922,21148,45284,2.73671269151,0.0504872486005
"Lee County, North Carolina",2015,59418,37.5,24208,3002,21206,45608,2.80194284636,0.0505234104144
"Lee County, South Carolina",2009,20074,37.7,8026,1442,6584,24847,3.04890643985,0.0718342134104
"Lee County, South Carolina",2012,19160,38.4,7786,1210,6576,27755,2.91362530414,0.0631524008351
"Lee County, South Carolina",2015,18461,40.1,7705,1320,6385,30954,2.89130775255,0.0715020854775
"Lee County, Texas",2009,16203,38.6,7245,1385,5860,45161,2.76501706485,0.0854779979016
"Lee County, Texas",2012,16591,40.7,7495,1469,6026,50860,2.75323597743,0.0885419805919
"Lee County, Texas",2015,16664,39.9,7569,1573,5996,53902,2.77918612408,0.0943951032165
"Lee County, Virginia",2009,25001,39.7,11587,1943,9644,29889,2.59238905019,0.0777168913243
"Lee County, Virginia",2012,25528,41.4,11732,1891,9841,31729,2.5940453206,0.0740755249138
"Lee County, Virginia",2015,25206,42.8,11728,2283,9445,31086,2.66871360508,0.090573672935
"Leelanau County, Michigan",2009,21877,47.5,14885,5427,9458,56574,2.31306830197,0.248068748
"Leelanau County, Michigan",2012,21677,50.5,14960,5644,9316,53982,2.32685702018,0.260368132122
"Leelanau County, Michigan",2015,21772,52.4,15141,5907,9234,56189,2.3578081005,0.271311776594
"Leflore County, Mississippi",2009,35033,30.9,15027,2174,12853,20490,2.72566715942,0.0620557759826
"Leflore County, Mississippi",2012,32196,32.5,13271,2329,10942,23659,2.94242368854,0.0723381786557
"Leflore County, Mississippi",2015,31516,32.9,13168,2344,10824,24233,2.91167775314,0.0743749206752
"Lehigh County, Pennsylvania",2009,337077,39.1,137462,7573,129889,53551,2.59511582967,0.0224666767534
"Lehigh County, Pennsylvania",2012,350165,39.3,142377,9075,133302,54645,2.62685481088,0.025916353719
"Lehigh County, Pennsylvania",2015,356756,39.5,143313,9353,133960,56117,2.66315318005,0.0262167980356
"Lemhi County, Idaho",2009,7818,47.1,4465,1136,3329,38750,2.34845298889,0.145305704784
"Lemhi County, Idaho",2012,7892,50,4721,1005,3716,36372,2.12378902045,0.127344145971
"Lemhi County, Idaho",2015,7790,51.2,4740,1019,3721,34329,2.09352324644,0.13080872914
"Lenawee County, Michigan",2009,100786,38.9,42878,5086,37792,50277,2.66686071126,0.0504633580061
"Lenawee County, Michigan",2012,99878,40.2,43406,5815,37591,48528,2.65696576308,0.0582210296562
"Lenawee County, Michigan",2015,98902,40.9,43412,5448,37964,48043,2.6051522495,0.0550848314493
"Lenoir County, North Carolina",2009,56831,40.7,28159,3462,24697,32188,2.30112969187,0.0609174570217
"Lenoir County, North Carolina",2012,59372,41,27447,3489,23958,34440,2.47817013106,0.0587650744459
"Lenoir County, North Carolina",2015,58782,42.1,27285,3950,23335,34717,2.51904863938,0.0671974413936
"Leon County, Florida",2009,261023,27.8,120717,12125,108592,42889,2.40370377192,0.0464518452397
"Leon County, Florida",2012,276506,29.6,124129,14569,109560,45915,2.5237860533,0.0526896342213
"Leon County, Florida",2015,282940,30,125915,15081,110834,46745,2.55282674991,0.0533010532268
"Leon County, Texas",2009,16518,44.5,8752,2272,6480,38067,2.54907407407,0.137546918513
"Leon County, Texas",2012,16827,45,9474,3040,6434,43534,2.6153248368,0.180662031259
"Leon County, Texas",2015,16819,44.9,9522,3380,6142,49802,2.73835884077,0.200963196385
"Leslie County, Kentucky",2009,11674,39.2,5849,1045,4804,24848,2.43005828476,0.0895151618982
"Leslie County, Kentucky",2012,11318,41.8,5298,981,4317,26386,2.62172805189,0.0866760911822
"Leslie County, Kentucky",2015,10997,42,5257,1107,4150,25872,2.64987951807,0.100663817405
"Letcher County, Kentucky",2009,23915,39.9,12023,2087,9936,28383,2.4069041868,0.0872674053941
"Letcher County, Kentucky",2012,24336,41.3,11614,2290,9324,29532,2.61003861004,0.0940992767916
"Letcher County, Kentucky",2015,23671,41.6,11580,1988,9592,30333,2.46778565471,0.0839846225339
"Levy County, Florida",2009,38555,42.9,18105,3633,14472,35294,2.66411000553,0.094229023473
"Levy County, Florida",2012,40541,45.2,19974,4170,15804,35093,2.56523664895,0.102858834267
"Levy County, Florida",2015,39821,46.6,19917,4401,15516,35782,2.56644753803,0.110519575099
"Lewis County, Idaho",2009,3645,47.6,1824,232,1592,36000,2.28957286432,0.0636488340192
"Lewis County, Idaho",2012,3818,47.7,1877,207,1670,37340,2.28622754491,0.0542168674699
"Lewis County, Idaho",2015,3812,48.2,1879,254,1625,36505,2.34584615385,0.0666316894019
"Lewis County, Kentucky",2009,13840,38.6,6524,1278,5246,25885,2.63820053374,0.0923410404624
"Lewis County, Kentucky",2012,13889,40.3,6480,1555,4925,27311,2.82010152284,0.111959104327
"Lewis County, Kentucky",2015,13790,40.8,6471,1098,5373,28630,2.56653638563,0.0796229151559
"Lewis County, Missouri",2009,9951,39.6,4799,917,3882,39344,2.56336939722,0.0921515425585
"Lewis County, Missouri",2012,10203,38.7,4542,660,3882,41758,2.62828438949,0.0646868568068
"Lewis County, Missouri",2015,10172,39.3,4515,669,3846,43909,2.64482579303,0.065768777035
"Lewis County, New York",2009,26205,40.2,16108,4987,11121,41719,2.35635284597,0.190307193284
"Lewis County, New York",2012,27062,40.3,15183,4526,10657,45187,2.53936379844,0.167245584214
"Lewis County, New York",2015,27124,41.4,15249,4710,10539,49819,2.57367871715,0.173646954726
"Lewis County, Tennessee",2009,11466,38.7,5061,727,4334,31167,2.64559298569,0.0634048491191
"Lewis County, Tennessee",2012,12050,41.1,5443,718,4725,33956,2.55026455026,0.0595850622407
"Lewis County, Tennessee",2015,11944,43.5,5454,742,4712,36621,2.53480475382,0.062123241795
"Lewis County, Washington",2009,73459,40.7,31788,3491,28297,44661,2.59599957593,0.0475231081283
"Lewis County, Washington",2012,75399,42,33893,4407,29486,43490,2.55711184969,0.0584490510484
"Lewis County, Washington",2015,75515,42.8,34110,4595,29515,44100,2.55852956124,0.0608488379792
"Lewis County, West Virginia",2009,17215,41.9,8179,1359,6820,32655,2.52419354839,0.0789427824572
"Lewis County, West Virginia",2012,16389,44,7976,1406,6570,35179,2.49452054795,0.0857892488864
"Lewis County, West Virginia",2015,16434,43.3,7940,1414,6526,37849,2.51823475329,0.0860411342339
"Lewis and Clark County, Montana",2009,60081,40.4,26536,2947,23589,50245,2.54699224215,0.0490504485611
"Lewis and Clark County, Montana",2012,63432,40.7,30062,3464,26598,54535,2.38484096549,0.0546096607391
"Lewis and Clark County, Montana",2015,65357,40.9,30554,3801,26753,56197,2.44297835757,0.0581575041694
"Lexington County, South Carolina",2009,244348,37.4,104482,8546,95936,51983,2.54698965977,0.0349747082031
"Lexington County, South Carolina",2012,262424,37.7,113810,10433,103377,53644,2.53851436973,0.0397562722922
"Lexington County, South Carolina",2015,273843,38.5,117446,10809,106637,53857,2.56799234787,0.0394715220035
"Lexington city, Virginia",2009,6909,21.8,2267,240,2027,32847,3.40848544647,0.034737299175
"Lexington city, Virginia",2012,6990,21.7,1982,181,1801,36511,3.88117712382,0.0258941344778
"Lexington city, Virginia",2015,7071,21.4,1911,273,1638,34017,4.31684981685,0.0386084005091
"Liberty County, Florida",2009,7811,34.6,2966,1082,1884,39583,4.14596602972,0.138522596338
"Liberty County, Florida",2012,8300,38.2,3295,940,2355,39225,3.52441613588,0.113253012048
"Liberty County, Florida",2015,8295,37.6,3409,976,2433,39406,3.40937114673,0.117661241712
"Liberty County, Georgia",2009,60994,25.1,24430,3403,21027,40911,2.90074665906,0.0557923730203
"Liberty County, Georgia",2012,64663,27.6,26604,3613,22991,44295,2.81253533992,0.0558743021512
"Liberty County, Georgia",2015,64427,27.6,27088,4145,22943,42201,2.80813319967,0.06433638071
"Liberty County, Montana",2009,2100,43.7,1035,273,762,39310,2.75590551181,0.13
"Liberty County, Montana",2012,2326,47.6,1145,298,847,40734,2.74616292798,0.128116938951
"Liberty County, Montana",2015,2369,44.8,1125,261,864,47768,2.74189814815,0.110173068805
"Liberty County, Texas",2009,74941,35.2,28527,4242,24285,44730,3.08589664402,0.0566045288961
"Liberty County, Texas",2012,75662,36.1,28823,4362,24461,48408,3.09316871755,0.057651132669
"Liberty County, Texas",2015,77486,36.4,29363,4044,25319,48729,3.06038943086,0.0521900730455
"Licking County, Ohio",2009,156414,38.5,65694,5736,59958,53200,2.60872610828,0.0366719091641
"Licking County, Ohio",2012,166135,39.1,69208,5427,63781,54247,2.60477258118,0.0326662051946
"Licking County, Ohio",2015,168693,39.7,69779,5549,64230,56549,2.6263895376,0.0328940738501
"Limestone County, Alabama",2009,74076,38,28981,2867,26114,44997,2.83663935054,0.0387034937092
"Limestone County, Alabama",2012,83313,38.7,34658,3472,31186,48197,2.6714872058,0.0416741684971
"Limestone County, Alabama",2015,88805,39,35357,3144,32213,49570,2.75680625834,0.03540341197
"Limestone County, Texas",2009,22367,39.5,10086,2389,7697,39119,2.9059373782,0.106809138463
"Limestone County, Texas",2012,23350,38.9,10536,2608,7928,40213,2.94525731584,0.111691648822
"Limestone County, Texas",2015,23454,39.3,10551,2467,8084,37554,2.90128649184,0.105184616697
"Lincoln County, Arkansas",2009,13753,36.4,5212,898,4314,34876,3.18799258229,0.0652948447611
"Lincoln County, Arkansas",2012,14167,37.7,4875,746,4129,34107,3.43109711795,0.0526575845274
"Lincoln County, Arkansas",2015,14062,37.5,4857,817,4040,32580,3.48069306931,0.05809984355
"Lincoln County, Colorado",2009,5285,42.6,2461,454,2007,39572,2.63328350772,0.085903500473
"Lincoln County, Colorado",2012,5443,39.4,2401,527,1874,43807,2.90448239061,0.0968216057321
"Lincoln County, Colorado",2015,5478,37.8,2155,478,1677,39005,3.26654740608,0.0872581234027
"Lincoln County, Georgia",2009,8038,43.6,4829,1355,3474,35350,2.31375935521,0.168574272207
"Lincoln County, Georgia",2012,7962,45.2,4781,1369,3412,34347,2.33352872216,0.171941723185
"Lincoln County, Georgia",2015,7720,47.2,4788,1363,3425,34243,2.25401459854,0.176554404145
"Lincoln County, Idaho",2009,4533,33.8,2046,294,1752,45903,2.58732876712,0.0648577101257
"Lincoln County, Idaho",2012,5167,33.1,1959,300,1659,43926,3.11452682339,0.0580607702729
"Lincoln County, Idaho",2015,5260,33.8,1961,337,1624,43273,3.23891625616,0.0640684410646
"Lincoln County, Kansas",2009,3249,46.8,1876,447,1429,40123,2.27361791463,0.13758079409
"Lincoln County, Kansas",2012,3240,46.3,1872,413,1459,41250,2.22069910898,0.127469135802
"Lincoln County, Kansas",2015,3154,46.2,1859,524,1335,44276,2.36254681648,0.166138237159
"Lincoln County, Kentucky",2009,25076,38.6,11454,894,10560,33531,2.37462121212,0.035651619078
"Lincoln County, Kentucky",2012,24671,39.2,10865,1098,9767,34454,2.52595474557,0.0445056949455
"Lincoln County, Kentucky",2015,24498,40.3,10849,1079,9770,37139,2.50747185261,0.0440444117887
"Lincoln County, Maine",2009,34789,46.7,22544,7611,14933,48034,2.32967253733,0.218776049901
"Lincoln County, Maine",2012,34440,48.1,23468,8418,15050,50494,2.28837209302,0.244425087108
"Lincoln County, Maine",2015,34156,49.8,23602,8726,14876,50462,2.29604732455,0.255474879963
"Lincoln County, Minnesota",2009,5832,45.8,3146,451,2695,41730,2.16400742115,0.0773319615912
"Lincoln County, Minnesota",2012,5876,46.5,3105,563,2542,47778,2.3115656963,0.0958134785568
"Lincoln County, Minnesota",2015,5808,46.5,3126,629,2497,49575,2.32599118943,0.108298898072
"Lincoln County, Mississippi",2009,34315,37.3,14667,1623,13044,38276,2.63071143821,0.0472971003934
"Lincoln County, Mississippi",2012,34850,37.5,15224,2040,13184,37176,2.64335558252,0.0585365853659
"Lincoln County, Mississippi",2015,34765,37.7,15271,2278,12993,36473,2.67567151543,0.0655256723716
"Lincoln County, Missouri",2009,50926,34.7,17526,1826,15700,53295,3.24369426752,0.0358559478459
"Lincoln County, Missouri",2012,52637,35.6,20837,2173,18664,53822,2.82024217745,0.041282747877
"Lincoln County, Missouri",2015,53850,36.5,21071,2573,18498,53718,2.91112552708,0.0477808727948
"Lincoln County, Montana",2009,18698,47,9421,1406,8015,32644,2.33287585777,0.0751952080436
"Lincoln County, Montana",2012,19594,49.2,11356,2385,8971,33234,2.18414892431,0.12172093498
"Lincoln County, Montana",2015,19337,50.8,11498,2853,8645,35275,2.23678426836,0.147540983607
"Lincoln County, Nebraska",2009,35481,39.1,16230,1428,14802,44667,2.39704094041,0.0402468927031
"Lincoln County, Nebraska",2012,36212,38.7,16585,1557,15028,49382,2.40963534735,0.042996796642
"Lincoln County, Nebraska",2015,35896,40.1,16615,1605,15010,50194,2.39147235177,0.0447125027858
"Lincoln County, Nevada",2009,4523,32.3,1895,415,1480,42955,3.05608108108,0.0917532611099
"Lincoln County, Nevada",2012,5282,35.9,2656,680,1976,39293,2.67307692308,0.128739113972
"Lincoln County, Nevada",2015,5194,37.4,2671,788,1883,44866,2.75836431227,0.151713515595
"Lincoln County, New Mexico",2009,20888,47.3,16602,8545,8057,44079,2.59252823632,0.409086556875
"Lincoln County, New Mexico",2012,20440,49.2,17458,8792,8666,44149,2.35864297254,0.430136986301
"Lincoln County, New Mexico",2015,19931,50.4,17636,9157,8479,40708,2.35063097063,0.459435050926
"Lincoln County, North Carolina",2009,72728,38.9,30915,3042,27873,47859,2.60926344491,0.0418270817292
"Lincoln County, North Carolina",2012,78052,40.8,33510,3709,29801,50065,2.61910674138,0.0475196023164
"Lincoln County, North Carolina",2015,79578,42,33864,3776,30088,49215,2.64484179739,0.0474503003343
"Lincoln County, Oklahoma",2009,32135,39.1,14328,1998,12330,40592,2.60624493106,0.0621751983818
"Lincoln County, Oklahoma",2012,34106,40.4,15168,2183,12985,42953,2.62656911821,0.0640063331965
"Lincoln County, Oklahoma",2015,34504,40.7,15222,1991,13231,45149,2.60781497997,0.0577034546719
"Lincoln County, Oregon",2009,45892,47.8,29024,9136,19888,38170,2.30752212389,0.199076091694
"Lincoln County, Oregon",2012,45992,49.6,30516,9477,21039,41996,2.18603545796,0.20605757523
"Lincoln County, Oregon",2015,46347,50.4,30703,10137,20566,42101,2.25357385977,0.21871965823
"Lincoln County, South Dakota",2009,37607,32.1,11682,629,11053,65992,3.40242468108,0.016725609594
"Lincoln County, South Dakota",2012,45055,33.2,17711,862,16849,73340,2.67404593744,0.01913217179
"Lincoln County, South Dakota",2015,49874,33.8,18781,744,18037,76094,2.7650939735,0.0149175923327
"Lincoln County, Tennessee",2009,32764,40.7,14570,1478,13092,42546,2.50259700581,0.04511048712
"Lincoln County, Tennessee",2012,33295,41.9,15227,1814,13413,40904,2.48229329755,0.0544826550533
"Lincoln County, Tennessee",2015,33550,42.9,15328,1684,13644,40389,2.4589563178,0.0501937406855
"Lincoln County, Washington",2009,10243,46.4,5522,1018,4504,43665,2.27420071048,0.0993849458167
"Lincoln County, Washington",2012,10536,47.8,5767,1157,4610,45563,2.28546637744,0.109813971147
"Lincoln County, Washington",2015,10363,48.3,5828,1458,4370,46069,2.37139588101,0.140692849561
"Lincoln County, West Virginia",2009,22211,39.2,10185,1378,8807,29291,2.52197115931,0.0620413308721
"Lincoln County, West Virginia",2012,21714,41.3,9890,1390,8500,34066,2.55458823529,0.0640140001842
"Lincoln County, West Virginia",2015,21560,41.9,9831,1837,7994,35800,2.69702276708,0.0852040816327
"Lincoln County, Wisconsin",2009,29632,43.1,15870,3070,12800,46770,2.315,0.103604211663
"Lincoln County, Wisconsin",2012,28710,44.8,16718,3964,12754,48293,2.25105849145,0.13807035876
"Lincoln County, Wisconsin",2015,28286,46.1,16854,4435,12419,49721,2.27763910138,0.156791345542
"Lincoln County, Wyoming",2009,16185,37.7,8231,1756,6475,57446,2.49961389961,0.108495520544
"Lincoln County, Wyoming",2012,17960,37.5,8925,2579,6346,62542,2.83012921525,0.14359688196
"Lincoln County, Wyoming",2015,18316,38.1,9008,2211,6797,66647,2.69471825806,0.120714129723
"Lincoln Parish, Louisiana",2009,42801,24.4,18347,2559,15788,31843,2.71098302508,0.0597883227027
"Lincoln Parish, Louisiana",2012,46543,27.8,19431,2828,16603,35433,2.80328856231,0.0607610166942
"Lincoln Parish, Louisiana",2015,47349,27.4,19645,2476,17169,33467,2.75781932553,0.052292551057
"Linn County, Iowa",2009,204955,35.9,91663,6087,85576,52642,2.39500560905,0.0296992022639
"Linn County, Iowa",2012,211954,36.7,92375,6721,85654,56790,2.47453709109,0.0317097105976
"Linn County, Iowa",2015,216640,37.1,94058,6740,87318,59322,2.48104629057,0.031111521418
"Linn County, Kansas",2009,9594,42.7,5082,1060,4022,44363,2.38538040776,0.110485720242
"Linn County, Kansas",2012,9613,44.3,5364,1118,4246,44771,2.26401318888,0.116300842609
"Linn County, Kansas",2015,9528,43.7,5446,1264,4182,46964,2.27833572453,0.132661628883
"Linn County, Missouri",2009,12765,43,6690,1315,5375,36767,2.37488372093,0.103016059538
"Linn County, Missouri",2012,12668,43,6448,1575,4873,39028,2.59963061769,0.124329017998
"Linn County, Missouri",2015,12401,42.8,6380,1552,4828,37997,2.56855840928,0.125151197484
"Linn County, Oregon",2009,112843,39.1,46925,3648,43277,45700,2.60745892737,0.0323281018761
"Linn County, Oregon",2012,116871,39,48718,4152,44566,47129,2.62242516717,0.0355263495649
"Linn County, Oregon",2015,118971,39.5,49005,3905,45100,45644,2.63793791574,0.0328231249632
"Lipscomb County, Texas",2009,2994,40.3,1550,358,1192,48646,2.51174496644,0.11957247829
"Lipscomb County, Texas",2012,3324,36.3,1410,281,1129,56131,2.94419840567,0.0845367027677
"Lipscomb County, Texas",2015,3483,34.4,1454,256,1198,63125,2.90734557596,0.0734998564456
"Litchfield County, Connecticut",2009,188411,42.5,83106,9402,73704,69561,2.55631987409,0.0499015450266
"Litchfield County, Connecticut",2012,189277,44.4,87302,11153,76149,71345,2.48561373097,0.0589242221717
"Litchfield County, Connecticut",2015,186304,46,87447,12929,74518,72061,2.50012077619,0.0693973290965
"Little River County, Arkansas",2009,12921,41.4,6711,1198,5513,32884,2.34373299474,0.0927172819441
"Little River County, Arkansas",2012,13068,41.1,6482,1245,5237,39042,2.49532174909,0.0952708907254
"Little River County, Arkansas",2015,12720,41.7,6454,1203,5251,36205,2.42239573415,0.0945754716981
"Live Oak County, Texas",2009,11271,41.1,6462,2261,4201,41652,2.68293263509,0.20060331825
"Live Oak County, Texas",2012,11526,42.8,6082,2253,3829,42182,3.010185427,0.195471108798
"Live Oak County, Texas",2015,11873,42,6097,2398,3699,50400,3.20978642876,0.20197085825
"Livingston County, Illinois",2009,37965,40.2,15708,1102,14606,49799,2.59927427085,0.0290267351508
"Livingston County, Illinois",2012,38903,40.2,15863,1489,14374,54339,2.70648392932,0.0382746831864
"Livingston County, Illinois",2015,37689,41.3,15847,1383,14464,54254,2.60571073009,0.0366950569132
"Livingston County, Kentucky",2009,9609,43.3,5031,1076,3955,40913,2.42958280657,0.111978353627
"Livingston County, Kentucky",2012,9479,44.7,4832,1279,3553,40101,2.66788629327,0.13492984492
"Livingston County, Kentucky",2015,9394,45.9,4830,1004,3826,42171,2.4553058024,0.106876729828
"Livingston County, Michigan",2009,182081,39.4,72111,5293,66818,74210,2.72502918375,0.0290694800666
"Livingston County, Michigan",2012,181678,40.9,72845,5446,67399,72396,2.69555928129,0.029976111582
"Livingston County, Michigan",2015,184591,42.1,74169,5189,68980,75204,2.67600753842,0.028110796301
"Livingston County, Missouri",2009,14143,41.2,6761,969,5792,38462,2.44181629834,0.0685144594499
"Livingston County, Missouri",2012,15068,41.5,6740,1191,5549,42241,2.71544422418,0.0790416777276
"Livingston County, Missouri",2015,15042,42,6741,1033,5708,43350,2.63524877365,0.0686743784071
"Livingston County, New York",2009,63162,38.4,25066,2402,22664,51698,2.78688669255,0.038029194769
"Livingston County, New York",2012,65215,39.7,27046,2919,24127,54244,2.7029883533,0.0447596411868
"Livingston County, New York",2015,64801,40.1,27249,3023,24226,51734,2.67485346322,0.0466505146526
"Livingston Parish, Louisiana",2009,116476,34,44903,4429,40474,52779,2.8777980926,0.0380250008585
"Livingston Parish, Louisiana",2012,128192,34.7,50282,4764,45518,57150,2.81629245573,0.0371630054918
"Livingston Parish, Louisiana",2015,133949,35.3,52888,5280,47608,58251,2.81358175097,0.039417987443
"Llano County, Texas",2009,18150,53.1,13767,5138,8629,42381,2.10337234906,0.283085399449
"Llano County, Texas",2012,19115,55.3,14309,5773,8536,45533,2.23933926898,0.302014125033
"Llano County, Texas",2015,19323,56.3,14665,6011,8654,48259,2.23284030506,0.311080060032
"Logan County, Arkansas",2009,22550,40.6,10307,1486,8821,35716,2.55639950119,0.0658980044346
"Logan County, Arkansas",2012,22352,41.7,10119,1719,8400,37237,2.66095238095,0.0769058697208
"Logan County, Arkansas",2015,22001,42.8,10133,1524,8609,35325,2.55558136834,0.0692695786555
"Logan County, Colorado",2009,20828,38.2,8761,695,8066,39992,2.58219687577,0.0333685423468
"Logan County, Colorado",2012,22541,37.5,8954,934,8020,41369,2.81059850374,0.0414356062287
"Logan County, Colorado",2015,21928,37.6,8949,983,7966,42319,2.75269897063,0.0448285297337
"Logan County, Illinois",2009,29942,37.9,12046,1047,10999,47644,2.72224747704,0.0349676040345
"Logan County, Illinois",2012,30278,39.4,12007,1067,10940,46647,2.7676416819,0.0352401083295
"Logan County, Illinois",2015,29956,39.7,11722,1011,10711,50539,2.79675100364,0.0337494992656
"Logan County, Kansas",2009,2641,46.2,1405,114,1291,35121,2.04570100697,0.0431654676259
"Logan County, Kansas",2012,2766,44.3,1437,151,1286,46047,2.15085536547,0.0545914678236
"Logan County, Kansas",2015,2793,42.2,1443,200,1243,46875,2.24698310539,0.0716075904046
"Logan County, Kentucky",2009,27040,39.5,12179,1559,10620,37376,2.5461393597,0.0576553254438
"Logan County, Kentucky",2012,26786,40.5,12340,1441,10899,35962,2.45765666575,0.0537967595012
"Logan County, Kentucky",2015,26851,40.5,12314,1444,10870,38570,2.47019319227,0.053778257793
"Logan County, Nebraska",2009,720,44.1,443,91,352,42857,2.04545454545,0.126388888889
"Logan County, Nebraska",2012,724,50.5,415,87,328,44444,2.20731707317,0.120165745856
"Logan County, Nebraska",2015,851,44.8,415,50,365,48281,2.33150684932,0.0587544065805
"Logan County, North Dakota",2009,1946,51.4,1043,255,788,40917,2.46954314721,0.131038026721
"Logan County, North Dakota",2012,1972,51.1,1088,234,854,47857,2.30913348946,0.118661257606
"Logan County, North Dakota",2015,1945,51.8,1153,275,878,51458,2.215261959,0.141388174807
"Logan County, Ohio",2009,46430,39.1,23096,4633,18463,47579,2.51475924823,0.0997846220116
"Logan County, Ohio",2012,45816,39.6,23174,5124,18050,47345,2.53828254848,0.111838658984
"Logan County, Ohio",2015,45484,40.7,23163,4523,18640,49783,2.44012875536,0.0994415618679
"Logan County, Oklahoma",2009,37242,37.3,14579,1857,12722,44387,2.92736991039,0.0498630578379
"Logan County, Oklahoma",2012,41982,37.4,17037,2355,14682,52031,2.85941969759,0.0560954694869
"Logan County, Oklahoma",2015,44493,38.5,17231,2140,15091,55299,2.94831356438,0.048097453532
"Logan County, West Virginia",2009,35553,40.5,17495,2234,15261,34214,2.32966384903,0.0628357663207
"Logan County, West Virginia",2012,36508,42.2,16783,1981,14802,36698,2.46642345629,0.0542620795442
"Logan County, West Virginia",2015,35760,42.6,16729,2686,14043,36763,2.54646443068,0.0751118568233
"Long County, Georgia",2009,11394,29.2,4506,981,3525,41943,3.23234042553,0.0860979462875
"Long County, Georgia",2012,14488,30.2,5921,1066,4855,40044,2.98414006179,0.0735781336278
"Long County, Georgia",2015,16588,31.2,6155,1138,5017,48863,3.3063583815,0.0686038099831
"Lonoke County, Arkansas",2009,63424,35.3,25244,2241,23003,50295,2.75720558188,0.0353336276488
"Lonoke County, Arkansas",2012,68274,35.5,27237,2239,24998,51499,2.73117849428,0.0327943287342
"Lonoke County, Arkansas",2015,70691,35.5,28253,2344,25909,53631,2.72843413486,0.033158393572
"Lorain County, Ohio",2009,302811,38.8,122567,10787,111780,51981,2.70899087493,0.0356228802785
"Lorain County, Ohio",2012,301108,40.1,126926,10535,116391,51756,2.58703851672,0.0349874463648
"Lorain County, Ohio",2015,303152,41,128268,10970,117298,52457,2.5844600931,0.0361864675146
"Los Alamos County, New Mexico",2009,18431,42.6,8570,767,7803,100423,2.36204024093,0.0416146709348
"Los Alamos County, New Mexico",2012,18008,44,8371,873,7498,106426,2.4017071219,0.0484784540204
"Los Alamos County, New Mexico",2015,17939,43.5,8313,698,7615,101934,2.35574523966,0.0389096382184
"Los Angeles County, California",2009,9785295,33.8,3370108,191842,3178266,54828,3.07881561833,0.0196051319863
"Los Angeles County, California",2012,9840024,34.8,3441416,222905,3218511,56241,3.05732184852,0.0226528919035
"Los Angeles County, California",2015,10038388,35.6,3476718,213649,3263069,56196,3.07636399966,0.0212831980593
"Loudon County, Tennessee",2009,45176,44.4,19641,1565,18076,49653,2.49922549237,0.0346422879405
"Loudon County, Tennessee",2012,48586,45.9,21693,2031,19662,49602,2.47106092971,0.0418021652328
"Loudon County, Tennessee",2015,50229,46.5,22144,2135,20009,51107,2.51032035584,0.0425053256087
"Loudoun County, Virginia",2009,277465,34.2,100433,9405,91028,112021,3.04812804851,0.0338961670841
"Loudoun County, Virginia",2012,314980,34.8,109928,5733,104195,122068,3.02298574788,0.0182011556289
"Loudoun County, Virginia",2015,351129,35.3,118919,5487,113432,123453,3.09550215107,0.0156267354733
"Louisa County, Iowa",2009,11657,38.6,5241,846,4395,47948,2.65233219568,0.0725744188042
"Louisa County, Iowa",2012,11448,39.3,5014,702,4312,49905,2.65491651206,0.061320754717
"Louisa County, Iowa",2015,11271,40.8,5016,705,4311,51144,2.61447459986,0.0625499068406
"Louisa County, Virginia",2009,31661,41,15146,2188,12958,51775,2.44335545609,0.0691071033764
"Louisa County, Virginia",2012,33083,43.1,16293,3270,13023,55765,2.54035168548,0.0988423057159
"Louisa County, Virginia",2015,33986,43.7,16692,3863,12829,57829,2.64915425988,0.113664450068
"Loup County, Nebraska",2009,550,48,353,133,220,31364,2.5,0.241818181818
"Loup County, Nebraska",2012,534,47.5,402,169,233,37708,2.29184549356,0.316479400749
"Loup County, Nebraska",2015,548,51.8,442,184,258,55417,2.12403100775,0.335766423358
"Love County, Oklahoma",2009,9072,43,4258,721,3537,39981,2.56488549618,0.079475308642
"Love County, Oklahoma",2012,9404,41,4521,1029,3492,41517,2.69301260023,0.109421522756
"Love County, Oklahoma",2015,9663,39.1,4528,1326,3202,44549,3.01780137414,0.137224464452
"Loving County, Texas",2009,81,47.7,76,35,41,81328,1.9756097561,0.432098765432
"Loving County, Texas",2012,85,47,70,35,35,39375,2.42857142857,0.411764705882
"Loving County, Texas",2015,117,55.3,73,28,45,,2.6,0.239316239316
"Lowndes County, Alabama",2009,12632,38.8,5919,1138,4781,30270,2.64212507844,0.0900886637112
"Lowndes County, Alabama",2012,11304,40.7,5176,924,4252,28023,2.65851364064,0.0817409766454
"Lowndes County, Alabama",2015,10742,39.5,5091,809,4282,25876,2.50864082205,0.0753118599888
"Lowndes County, Georgia",2009,102440,29.3,44380,4205,40175,39200,2.54984443062,0.0410484185865
"Lowndes County, Georgia",2012,109730,29.8,44256,4887,39369,38348,2.78721836978,0.0445365898114
"Lowndes County, Georgia",2015,113203,29.4,45399,6071,39328,36834,2.87843266884,0.0536293207777
"Lowndes County, Mississippi",2009,59499,34.8,26714,3254,23460,37314,2.53618925831,0.0546899947898
"Lowndes County, Mississippi",2012,59584,36.2,26595,3166,23429,37508,2.54317299074,0.0531350698174
"Lowndes County, Mississippi",2015,59699,36.3,26895,3625,23270,40239,2.56549204985,0.0607212851137
"Loíza Municipio, Puerto Rico",2009,33678,30.4,11012,2155,8857,19156,3.802416168,0.0639883603539
"Loíza Municipio, Puerto Rico",2012,29997,33.2,11351,2485,8866,19100,3.38337468983,0.0828416174951
"Loíza Municipio, Puerto Rico",2015,28454,35.7,11684,2677,9007,18718,3.15909847896,0.0940816756871
"Lubbock County, Texas",2009,262985,29.3,114575,12337,102238,40467,2.57228232164,0.0469114208035
"Lubbock County, Texas",2012,278339,30.4,115573,10782,104791,43993,2.65613459171,0.0387369358947
"Lubbock County, Texas",2015,290782,30.6,119565,12025,107540,46075,2.70394271899,0.0413540040305
"Lucas County, Iowa",2009,9410,42.2,4279,653,3626,43606,2.59514616657,0.069394261424
"Lucas County, Iowa",2012,8913,43.8,4225,578,3647,44020,2.44392651494,0.0648490968249
"Lucas County, Iowa",2015,8731,45.4,4208,530,3678,43962,2.3738444807,0.060703241324
"Lucas County, Ohio",2009,464956,36.2,203725,23696,180029,42696,2.58267279161,0.0509639621814
"Lucas County, Ohio",2012,441198,37.1,202623,24008,178615,41436,2.47010609411,0.054415477858
"Lucas County, Ohio",2015,436261,37.7,202269,24650,177619,41777,2.45616178449,0.05650287328
"Luce County, Michigan",2009,6645,40.6,4283,1721,2562,36869,2.59367681499,0.2589917231
"Luce County, Michigan",2012,6590,43.5,4352,1948,2404,42414,2.74126455907,0.29559939302
"Luce County, Michigan",2015,6477,44.3,4336,1959,2377,37088,2.72486327303,0.302454840204
"Lumpkin County, Georgia",2009,26417,34.4,11027,1160,9867,41589,2.67730819905,0.0439111178408
"Lumpkin County, Georgia",2012,30040,36.1,12827,2045,10782,44595,2.78612502319,0.0680758988016
"Lumpkin County, Georgia",2015,30921,36,13008,1922,11086,43804,2.78919357749,0.0621584036739
"Luna County, New Mexico",2009,26724,37.8,11841,2118,9723,26661,2.74853440296,0.0792546026044
"Luna County, New Mexico",2012,25162,38.4,11023,1918,9105,29365,2.7635365184,0.0762260551625
"Luna County, New Mexico",2015,24789,39,10972,1928,9044,27476,2.74093321539,0.0777764330953
"Lunenburg County, Virginia",2009,12908,41.8,5956,1333,4623,35963,2.7921263249,0.103269290363
"Lunenburg County, Virginia",2012,12838,43.8,5939,1338,4601,34455,2.79026298631,0.104221841408
"Lunenburg County, Virginia",2015,12558,44.7,5933,1417,4516,39506,2.78077945084,0.112836438923
"Luquillo Municipio, Puerto Rico",2009,20508,35,9799,3294,6505,22097,3.1526518063,0.160620245758
"Luquillo Municipio, Puerto Rico",2012,20050,37.6,10197,3483,6714,20084,2.98629728925,0.173715710723
"Luquillo Municipio, Puerto Rico",2015,19497,39.3,10471,3683,6788,18170,2.87227460224,0.188900856542
"Luzerne County, Pennsylvania",2009,311919,42.2,148045,16788,131257,41830,2.37639897301,0.05382166524
"Luzerne County, Pennsylvania",2012,320555,42.7,148663,17663,131000,43486,2.44698473282,0.0551013086678
"Luzerne County, Pennsylvania",2015,320095,42.9,148441,19749,128692,45897,2.48729524757,0.0616973086115
"Lycoming County, Pennsylvania",2009,117043,40.3,53987,6005,47982,41856,2.4393105748,0.0513059302991
"Lycoming County, Pennsylvania",2012,116447,41.2,52621,6145,46476,44557,2.50552973578,0.0527707884274
"Lycoming County, Pennsylvania",2015,116656,41.4,52641,6735,45906,47313,2.54119287239,0.057733849952
"Lyman County, South Dakota",2009,3855,36.7,1704,286,1418,34132,2.71861777151,0.0741893644617
"Lyman County, South Dakota",2012,3752,36.8,1705,308,1397,46339,2.68575518969,0.0820895522388
"Lyman County, South Dakota",2015,3837,35.5,1717,323,1394,43030,2.7525107604,0.0841803492312
"Lynchburg city, Virginia",2009,71357,33,29780,3163,26617,37281,2.68088064019,0.0443264150679
"Lynchburg city, Virginia",2012,75657,30.3,31900,3434,28466,37774,2.65780229045,0.0453890585141
"Lynchburg city, Virginia",2015,78158,28.7,32252,3724,28528,39589,2.73969433539,0.047647073876
"Lynn County, Texas",2009,5841,38.6,2711,470,2241,39148,2.60642570281,0.080465673686
"Lynn County, Texas",2012,5886,40.6,2670,497,2173,45066,2.70869765301,0.0844376486578
"Lynn County, Texas",2015,5764,37.4,2668,480,2188,39526,2.63436928702,0.0832755031228
"Lyon County, Iowa",2009,11274,40.2,4887,385,4502,49838,2.50422034651,0.0341493702324
"Lyon County, Iowa",2012,11623,38.3,4858,413,4445,49727,2.61484814398,0.0355329949239
"Lyon County, Iowa",2015,11723,38.4,4924,428,4496,57130,2.60742882562,0.0365094259149
"Lyon County, Kansas",2009,35186,31.4,15256,1306,13950,35949,2.52229390681,0.0371170351844
"Lyon County, Kansas",2012,34103,32.2,15228,2032,13196,38877,2.58434374053,0.0595842008034
"Lyon County, Kansas",2015,33462,32.5,15218,1946,13272,40021,2.5212477396,0.058155519694
"Lyon County, Kentucky",2009,8325,45,4457,1216,3241,39934,2.56865165073,0.146066066066
"Lyon County, Kentucky",2012,8336,47.7,4774,1496,3278,38414,2.54301403295,0.179462571977
"Lyon County, Kentucky",2015,8402,49,4796,1566,3230,46931,2.60123839009,0.186384194239
"Lyon County, Minnesota",2009,24910,35.6,10973,685,10288,45842,2.42126749611,0.027498996387
"Lyon County, Minnesota",2012,25714,34.4,11109,918,10191,47256,2.52320675105,0.0357003966711
"Lyon County, Minnesota",2015,25699,35.1,11117,1159,9958,51600,2.58073910424,0.0450990310907
"Lyon County, Nevada",2009,50931,39.3,17718,3258,14460,48513,3.52219917012,0.0639688990988
"Lyon County, Nevada",2012,51797,40.6,22286,3738,18548,46088,2.79259219323,0.07216634168
"Lyon County, Nevada",2015,51657,43.2,22419,2895,19524,47255,2.64582052858,0.056042743481
"Mackinac County, Michigan",2009,10871,46.8,10022,5298,4724,39919,2.30122777307,0.48735166958
"Mackinac County, Michigan",2012,11144,49.1,10969,6029,4940,38507,2.25587044534,0.541008614501
"Mackinac County, Michigan",2015,11044,50.9,11021,5812,5209,38434,2.12017661739,0.526258601956
"Macomb County, Michigan",2009,828469,38.6,351827,24281,327546,55466,2.52932107246,0.029308278282
"Macomb County, Michigan",2012,841769,40,356715,26119,330596,53628,2.54621653015,0.0310287026488
"Macomb County, Michigan",2015,854689,40.8,359902,23523,336379,54582,2.5408512422,0.0275222917342
"Macon County, Alabama",2009,22304,34,10966,2733,8233,26305,2.70909753431,0.122534074605
"Macon County, Alabama",2012,21214,36.6,10285,2191,8094,27957,2.62095379293,0.103280852267
"Macon County, Alabama",2015,20018,37.5,10238,2229,8009,30738,2.4994381321,0.111349785193
"Macon County, Georgia",2009,13397,36.9,5684,1260,4424,28382,3.02825497288,0.0940509069195
"Macon County, Georgia",2012,14552,38.9,6097,1322,4775,30906,3.04753926702,0.0908466190214
"Macon County, Georgia",2015,14045,40.5,6072,1388,4684,28684,2.99850555081,0.0988252046992
"Macon County, Illinois",2009,108772,39.7,52124,5855,46269,44107,2.3508612678,0.0538281910786
"Macon County, Illinois",2012,110558,40.4,50505,5431,45074,46165,2.45281093313,0.049123536967
"Macon County, Illinois",2015,109193,40.6,50391,5476,44915,47176,2.43110319492,0.0501497348731
"Macon County, Missouri",2009,15456,42.8,7707,1239,6468,35578,2.38961038961,0.0801630434783
"Macon County, Missouri",2012,15532,42.1,7657,1291,6366,37405,2.43983663211,0.0831187226371
"Macon County, Missouri",2015,15460,42.9,7630,1387,6243,36976,2.47637353836,0.0897153945666
"Macon County, North Carolina",2009,32607,47.5,23204,8457,14747,38351,2.21109378179,0.259361486797
"Macon County, North Carolina",2012,33815,48.4,25122,9279,15843,38134,2.13438111469,0.274404849919
"Macon County, North Carolina",2015,33919,49,25303,9767,15536,39133,2.18325180227,0.287950706094
"Macon County, Tennessee",2009,21708,36.5,9516,1300,8216,32354,2.64216163583,0.0598857564032
"Macon County, Tennessee",2012,22265,38.3,9851,1429,8422,35452,2.64367133697,0.0641814507074
"Macon County, Tennessee",2015,22761,39.6,9942,1086,8856,33509,2.57012195122,0.0477131936207
"Macoupin County, Illinois",2009,48148,41.2,22167,2555,19612,46857,2.45502753416,0.053065547894
"Macoupin County, Illinois",2012,47712,41.9,21602,2223,19379,48788,2.46204654523,0.0465920523139
"Macoupin County, Illinois",2015,46844,42.6,21558,2576,18982,51206,2.467811611,0.0549910340705
"Madera County, California",2009,144794,33.1,48192,6220,41972,46083,3.44977604117,0.0429575811152
"Madera County, California",2012,150615,33.2,49222,7159,42063,47937,3.580700378,0.0475317863427
"Madera County, California",2015,153187,33.5,49704,6545,43159,45073,3.5493639797,0.0427255576518
"Madison County, Alabama",2009,314047,37.1,137964,13418,124546,54979,2.52153421226,0.0427260887702
"Madison County, Alabama",2012,334661,37.3,146628,15365,131263,58242,2.54954556882,0.0459121319783
"Madison County, Alabama",2015,346438,37.8,152720,14953,137767,57993,2.51466606662,0.0431621242473
"Madison County, Arkansas",2009,15478,40.6,6931,1491,5440,36667,2.84522058824,0.0963302752294
"Madison County, Arkansas",2012,15674,40.4,7462,1393,6069,33481,2.58263305322,0.088873293352
"Madison County, Arkansas",2015,15702,41.8,7483,1145,6338,37691,2.4774376775,0.0729206470513
"Madison County, Florida",2009,18924,38.9,8279,1665,6614,36682,2.86120350771,0.0879835129994
"Madison County, Florida",2012,19187,40.2,8457,1580,6877,34361,2.79002472008,0.0823474227341
"Madison County, Florida",2015,18729,41.5,8448,1834,6614,32164,2.83172059268,0.0979230071013
"Madison County, Georgia",2009,27735,37.7,11789,2014,9775,40106,2.83734015345,0.0726158283757
"Madison County, Georgia",2012,27988,38.8,11776,2385,9391,41404,2.98030028751,0.0852150921824
"Madison County, Georgia",2015,28232,40.2,11752,1557,10195,41912,2.76920058852,0.0551501841882
"Madison County, Idaho",2009,37120,21.9,10981,977,10004,35511,3.71051579368,0.0263200431034
"Madison County, Idaho",2012,37311,22.7,11317,1228,10089,33776,3.69818614332,0.032912545898
"Madison County, Idaho",2015,37916,23.2,12386,2081,10305,32233,3.67937894226,0.0548844814854
"Madison County, Illinois",2009,266886,37.9,117068,9849,107219,50877,2.48916703196,0.036903396956
"Madison County, Illinois",2012,268586,38.4,117203,10270,106933,52756,2.5117222934,0.0382372871259
"Madison County, Illinois",2015,267356,39.5,117919,10808,107111,53431,2.49606482994,0.0404255000823
"Madison County, Indiana",2009,131015,39,59384,7652,51732,43372,2.53257171577,0.0584055260848
"Madison County, Indiana",2012,131244,39.3,59078,8298,50780,44245,2.58456085073,0.0632257474627
"Madison County, Indiana",2015,130280,39.8,58844,7570,51274,44195,2.54085891485,0.0581056186675
"Madison County, Iowa",2009,15253,38.9,6467,624,5843,57690,2.61047407154,0.040909984921
"Madison County, Iowa",2012,15630,39.4,6566,569,5997,56765,2.60630315158,0.0364043506078
"Madison County, Iowa",2015,15644,40.5,6667,442,6225,60060,2.51309236948,0.0282536435694
"Madison County, Kentucky",2009,81334,32,33103,3383,29720,39854,2.7366756393,0.0415939213613
"Madison County, Kentucky",2012,83174,33.6,35005,3724,31281,42020,2.6589303411,0.0447736071368
"Madison County, Kentucky",2015,85838,33.9,35633,3569,32064,42390,2.67708333333,0.0415783219553
"Madison County, Mississippi",2009,89151,34.8,36184,2602,33582,56938,2.65472574594,0.0291864364954
"Madison County, Mississippi",2012,95481,36.1,38628,2854,35774,60195,2.66900542293,0.0298907636074
"Madison County, Mississippi",2015,100202,37,40400,3293,37107,64376,2.70035303312,0.0328636154967
"Madison County, Missouri",2009,12226,39.9,5914,1057,4857,32271,2.51719168211,0.0864550956977
"Madison County, Missouri",2012,12334,41.2,5969,1186,4783,36197,2.57871628685,0.0961569644884
"Madison County, Missouri",2015,12401,42.3,5946,1296,4650,35097,2.66688172043,0.104507700992
"Madison County, Montana",2009,7314,47.3,4749,1786,2963,42054,2.46844414445,0.244189226142
"Madison County, Montana",2012,7688,50,6800,3074,3726,48600,2.06333870102,0.399843912591
"Madison County, Montana",2015,7767,52.1,6931,3562,3369,46250,2.3054318789,0.458606926741
"Madison County, Nebraska",2009,34727,37.2,15079,1357,13722,42911,2.53075353447,0.0390762231117
"Madison County, Nebraska",2012,34766,37.2,15021,1098,13923,45717,2.49701932055,0.0315825806823
"Madison County, Nebraska",2015,35111,37.5,15070,1063,14007,50218,2.50667523381,0.030275412264
"Madison County, New York",2009,69868,38.6,29612,3731,25881,51670,2.6995865693,0.05340069846
"Madison County, New York",2012,72977,39.3,31651,5038,26613,52293,2.74215608913,0.0690354495252
"Madison County, New York",2015,72427,40.8,31742,5454,26288,54145,2.75513542301,0.0753034089497
"Madison County, North Carolina",2009,20227,42.2,10777,2633,8144,37500,2.48366895874,0.130172541652
"Madison County, North Carolina",2012,20727,43.6,10630,2402,8228,38658,2.51908118619,0.115887489748
"Madison County, North Carolina",2015,21027,44,10672,2222,8450,37904,2.48840236686,0.105673657678
"Madison County, Ohio",2009,41629,38.1,15418,885,14533,53041,2.86444643226,0.0212592183334
"Madison County, Ohio",2012,43213,39,15903,1124,14779,54647,2.92394613979,0.0260106912272
"Madison County, Ohio",2015,43456,40.2,15913,1007,14906,57406,2.91533610627,0.0231728645066
"Madison County, Tennessee",2009,96346,35.7,42656,4292,38364,39743,2.51136482119,0.044547775725
"Madison County, Tennessee",2012,97976,36.8,41974,5914,36060,42348,2.71702717693,0.0603617212379
"Madison County, Tennessee",2015,98184,37.6,42442,5676,36766,42544,2.67051079802,0.0578098264483
"Madison County, Texas",2009,13202,34,5068,1376,3692,33952,3.5758396533,0.104226632328
"Madison County, Texas",2012,13590,34.3,5102,1514,3588,41202,3.78762541806,0.11140544518
"Madison County, Texas",2015,13838,35.1,5162,1041,4121,39390,3.35792283426,0.0752276340512
"Madison County, Virginia",2009,13571,42.8,5966,687,5279,52964,2.57075203637,0.0506226512416
"Madison County, Virginia",2012,13270,44.7,5943,874,5069,54510,2.6178733478,0.0658628485305
"Madison County, Virginia",2015,13147,44.6,5983,980,5003,47736,2.62782330602,0.0745417205446
"Madison Parish, Louisiana",2009,11790,34,5117,777,4340,26021,2.71658986175,0.065903307888
"Madison Parish, Louisiana",2012,12113,34.9,4823,773,4050,24700,2.99086419753,0.0638157351606
"Madison Parish, Louisiana",2015,11873,34.6,4884,824,4060,23854,2.92438423645,0.069401162301
"Magoffin County, Kentucky",2009,13132,37.8,5827,1324,4503,19556,2.91627803686,0.10082241852
"Magoffin County, Kentucky",2012,13229,39.4,5944,959,4985,25461,2.65376128385,0.0724922518709
"Magoffin County, Kentucky",2015,12979,41,5932,936,4996,28500,2.59787830264,0.072116495878
"Mahaska County, Iowa",2009,22094,38.9,9796,864,8932,44713,2.47357814599,0.0391056395401
"Mahaska County, Iowa",2012,22432,39.3,9759,858,8901,47758,2.52016627345,0.0382489300999
"Mahaska County, Iowa",2015,22396,39.8,9759,736,9023,48726,2.48210129669,0.032863011252
"Mahnomen County, Minnesota",2009,5051,38.8,2807,843,1964,38409,2.57179226069,0.166897644031
"Mahnomen County, Minnesota",2012,5442,37.2,2801,754,2047,39442,2.65852467025,0.13855200294
"Mahnomen County, Minnesota",2015,5496,36.3,2782,781,2001,41118,2.74662668666,0.142103347889
"Mahoning County, Ohio",2009,241071,42,113980,13612,100368,38977,2.4018711143,0.0564646929743
"Mahoning County, Ohio",2012,238352,42.9,111869,13409,98460,41112,2.42080032501,0.0562571323085
"Mahoning County, Ohio",2015,234550,43.3,111465,13675,97790,41375,2.39850700481,0.0583031336602
"Major County, Oklahoma",2009,7175,44.6,3617,464,3153,43817,2.27561052965,0.064668989547
"Major County, Oklahoma",2012,7563,43.6,3673,541,3132,48698,2.41475095785,0.0715324606638
"Major County, Oklahoma",2015,7700,41.6,3651,600,3051,51571,2.52376270075,0.0779220779221
"Malheur County, Oregon",2009,30875,35.8,11505,1235,10270,39489,3.00632911392,0.04
"Malheur County, Oregon",2012,31057,36.2,11675,1541,10134,37191,3.06463390566,0.0496184435071
"Malheur County, Oregon",2015,30551,36.1,11629,1343,10286,35418,2.97015360684,0.0439592812019
"Manassas Park city, Virginia",2009,11633,30.9,4309,523,3786,69087,3.07263602747,0.044958308261
"Manassas Park city, Virginia",2012,14409,31,4873,596,4277,71810,3.36895019874,0.0413630369908
"Manassas Park city, Virginia",2015,15625,32.7,4895,172,4723,73528,3.30827863646,0.011008
"Manassas city, Virginia",2009,35559,32.7,12910,1267,11643,72150,3.05410976552,0.0356309232543
"Manassas city, Virginia",2012,37943,32.3,13128,1117,12011,70634,3.15902089751,0.0294388951849
"Manassas city, Virginia",2015,40743,33.3,13284,851,12433,72890,3.27700474544,0.0208870235378
"Manatee County, Florida",2009,313011,44.3,168199,35771,132428,47935,2.36363155828,0.114280328806
"Manatee County, Florida",2012,324834,45.6,172901,41729,131172,47910,2.47639740188,0.128462537789
"Manatee County, Florida",2015,343729,46.7,177046,42321,134725,49675,2.55133791056,0.123123158069
"Manatí Municipio, Puerto Rico",2009,49393,35,16985,1983,15002,16003,3.29242767631,0.0401473893062
"Manatí Municipio, Puerto Rico",2012,43974,37.2,17955,2455,15500,17513,2.83703225806,0.0558284440806
"Manatí Municipio, Puerto Rico",2015,42167,39.1,18904,2829,16075,18162,2.62314152411,0.0670903787322
"Manistee County, Michigan",2009,24741,45.4,15616,4880,10736,39995,2.30448956781,0.19724344206
"Manistee County, Michigan",2012,24753,47.1,15686,5038,10648,41228,2.32466190834,0.203530885145
"Manistee County, Michigan",2015,24536,48.2,15680,5538,10142,41395,2.4192466969,0.225709162048
"Manitowoc County, Wisconsin",2009,80802,41.9,36786,2777,34009,49026,2.37590049693,0.0343679611891
"Manitowoc County, Wisconsin",2012,81266,43.3,37143,2919,34224,50091,2.37453249182,0.0359190805503
"Manitowoc County, Wisconsin",2015,80521,44.2,37197,3270,33927,48398,2.37336045038,0.0406105239627
"Marathon County, Wisconsin",2009,129803,38.9,56754,3777,52977,53150,2.45017649169,0.0290979407256
"Marathon County, Wisconsin",2012,134041,39.2,57688,4795,52893,53762,2.53419166998,0.0357726367306
"Marathon County, Wisconsin",2015,135177,40.6,58226,4378,53848,54083,2.51034393107,0.0323871664558
"Marengo County, Alabama",2009,21210,39.3,10450,1899,8551,30819,2.48041164776,0.0895332390382
"Marengo County, Alabama",2012,20909,41.1,10255,1675,8580,34515,2.43694638695,0.0801090439524
"Marengo County, Alabama",2015,20306,42.2,10218,1937,8281,32042,2.45211930926,0.095390524968
"Maricao Municipio, Puerto Rico",2009,6321,34.1,2106,531,1575,11185,4.01333333333,0.0840056953014
"Maricao Municipio, Puerto Rico",2012,6546,36.7,2318,593,1725,12288,3.7947826087,0.0905896730828
"Maricao Municipio, Puerto Rico",2015,6315,40.7,2571,664,1907,12606,3.31148400629,0.105146476643
"Maricopa County, Arizona",2009,3855521,33.3,1530720,192252,1338468,55223,2.88054776057,0.0498640780325
"Maricopa County, Arizona",2012,3841819,34.6,1636502,234353,1402149,54385,2.73995060439,0.0610005312588
"Maricopa County, Arizona",2015,4018143,35.6,1668555,226037,1442518,54229,2.78550631604,0.0562540954864
"Maries County, Missouri",2009,8954,41,4328,901,3427,39241,2.61278085789,0.100625418807
"Maries County, Missouri",2012,9140,43.1,4590,894,3696,44885,2.47294372294,0.0978118161926
"Maries County, Missouri",2015,9057,44.2,4588,902,3686,39700,2.45713510581,0.0995914762062
"Marin County, California",2009,246711,43.7,108205,7119,101086,87728,2.44060502938,0.0288556245972
"Marin County, California",2012,252759,44.6,111063,7911,103152,90962,2.45035481619,0.0312985887743
"Marin County, California",2015,258349,45.4,111990,8320,103670,93257,2.49203241053,0.0322044985659
"Marinette County, Wisconsin",2009,42366,44.6,28545,9730,18815,40553,2.25171405793,0.229665297644
"Marinette County, Wisconsin",2012,41704,45.8,30259,11404,18855,41533,2.21182710156,0.273450987915
"Marinette County, Wisconsin",2015,41287,47.2,30393,12074,18319,43425,2.25378022818,0.292440719839
"Marion County, Alabama",2009,29415,41.4,14976,1895,13081,32224,2.24868129348,0.0644229134795
"Marion County, Alabama",2012,30641,43.2,14731,2004,12727,31970,2.4075587334,0.0654025651904
"Marion County, Alabama",2015,30387,44.1,14724,2010,12714,32299,2.39004247286,0.0661467074736
"Marion County, Arkansas",2009,16581,48.3,8878,2128,6750,31772,2.45644444444,0.128339665883
"Marion County, Arkansas",2012,16712,50.2,9335,2135,7200,33497,2.32111111111,0.127752513164
"Marion County, Arkansas",2015,16458,51.3,9333,2632,6701,34195,2.45605133562,0.159922226273
"Marion County, Florida",2009,318886,45.6,157056,25314,131742,40306,2.42053407418,0.0793826006786
"Marion County, Florida",2012,331987,47.4,163797,29064,134733,39770,2.46403627916,0.0875455966649
"Marion County, Florida",2015,336811,48.2,163687,31400,132287,39459,2.54606272725,0.0932273589639
"Marion County, Georgia",2009,7026,39.2,3247,686,2561,32432,2.7434595861,0.0976373469969
"Marion County, Georgia",2012,8615,41.2,4105,1080,3025,33875,2.8479338843,0.125362739408
"Marion County, Georgia",2015,8739,41.7,4118,1063,3055,36242,2.86055646481,0.121638631422
"Marion County, Illinois",2009,39488,41,18491,2055,16436,37446,2.40253102945,0.0520411264182
"Marion County, Illinois",2012,39319,41.4,18313,2355,15958,41723,2.46390525128,0.0598947073934
"Marion County, Illinois",2015,38665,41.7,18195,2412,15783,42238,2.44978774631,0.0623819992241
"Marion County, Indiana",2009,878881,33.7,417311,59027,358284,43858,2.45302888212,0.0671615383653
"Marion County, Indiana",2012,904535,33.9,418040,58602,359438,42603,2.51652579861,0.0647868794463
"Marion County, Indiana",2015,926335,34.1,419109,55551,363558,42168,2.54797033761,0.0599685858788
"Marion County, Iowa",2009,32650,39.2,13846,1190,12656,52053,2.57980404551,0.0364471669219
"Marion County, Iowa",2012,33388,38.8,13913,1191,12722,53684,2.62443012105,0.0356714987421
"Marion County, Iowa",2015,33248,39.2,13986,1008,12978,54693,2.56187394051,0.0303176130895
"Marion County, Kansas",2009,12239,44.7,5867,800,5067,42706,2.41543319518,0.065364817387
"Marion County, Kansas",2012,12565,44.3,5948,978,4970,45323,2.52816901408,0.0778352566653
"Marion County, Kansas",2015,12290,45,5930,1122,4808,45927,2.55615640599,0.0912937347437
"Marion County, Kentucky",2009,19245,37.6,7539,804,6735,37239,2.8574610245,0.0417770849571
"Marion County, Kentucky",2012,19872,38.2,8151,728,7423,37710,2.67708473663,0.0366344605475
"Marion County, Kentucky",2015,19717,38.8,8196,801,7395,38826,2.66626098715,0.0406248415073
"Marion County, Mississippi",2009,25527,36,10861,1816,9045,30699,2.82222222222,0.0711403611862
"Marion County, Mississippi",2012,26810,37.8,11788,2002,9786,31865,2.73962804006,0.0746736292428
"Marion County, Mississippi",2015,26109,39.1,11845,2031,9814,30668,2.66038312615,0.0777892680685
"Marion County, Missouri",2009,28241,38.5,12811,1349,11462,38530,2.4638806491,0.0477674303318
"Marion County, Missouri",2012,28703,39.3,12835,1655,11180,42756,2.56735241503,0.0576594781033
"Marion County, Missouri",2015,28840,39.7,12885,1672,11213,40814,2.57201462588,0.0579750346741
"Marion County, Ohio",2009,65593,38.4,27645,2807,24838,40936,2.64083259522,0.0427942006007
"Marion County, Ohio",2012,66514,40,27843,3107,24736,40966,2.68895536869,0.0467119704122
"Marion County, Ohio",2015,65943,40.4,27829,3351,24478,42966,2.6939700956,0.0508166143488
"Marion County, Oregon",2009,309829,34.6,118759,6920,111839,46453,2.77031268162,0.0223349008647
"Marion County, Oregon",2012,315391,35.1,121057,7830,113227,46654,2.78547519585,0.0248263266866
"Marion County, Oregon",2015,323259,35.8,122315,8319,113996,48432,2.83570476157,0.0257347823262
"Marion County, South Carolina",2009,34023,37.6,15540,2636,12904,29626,2.63662430254,0.0774770008524
"Marion County, South Carolina",2012,33038,39.1,14969,2844,12125,30562,2.72478350515,0.0860826926569
"Marion County, South Carolina",2015,32167,39.5,14834,2876,11958,29874,2.68999832748,0.089408399913
"Marion County, Tennessee",2009,27960,39.8,13471,1553,11918,38367,2.34603121329,0.0555436337625
"Marion County, Tennessee",2012,28184,42.3,12985,1771,11214,39817,2.51328696273,0.0628370706784
"Marion County, Tennessee",2015,28306,43.1,13019,1494,11525,41348,2.45605206074,0.0527803292588
"Marion County, Texas",2009,10570,46.1,6705,1716,4989,30385,2.11866105432,0.162346263009
"Marion County, Texas",2012,10544,48.8,6236,1616,4620,32226,2.28225108225,0.153262518968
"Marion County, Texas",2015,10248,49.1,6236,1773,4463,34175,2.29621330943,0.173009367681
"Marion County, West Virginia",2009,56568,40.4,27220,4054,23166,35209,2.44185444185,0.0716659595531
"Marion County, West Virginia",2012,56460,41.3,26483,3722,22761,40827,2.48055885067,0.0659227771874
"Marion County, West Virginia",2015,56790,41.1,26367,3886,22481,43165,2.52613317913,0.0684275400599
"Mariposa County, California",2009,17865,46.4,9797,2114,7683,47808,2.32526356892,0.118331933949
"Mariposa County, California",2012,18193,49.4,10165,2909,7256,52584,2.50730429989,0.159896663552
"Mariposa County, California",2015,17789,50.6,10312,2967,7345,47681,2.42191967325,0.166788464782
"Marlboro County, South Carolina",2009,28571,36.2,12075,2111,9964,26002,2.8674227218,0.0738861082916
"Marlboro County, South Carolina",2012,28750,39.1,12039,2158,9881,28612,2.90962453193,0.0750608695652
"Marlboro County, South Carolina",2015,27993,39.4,11983,2033,9950,30767,2.81336683417,0.0726252991819
"Marquette County, Michigan",2009,65298,39.2,34481,9117,25364,43692,2.5744362088,0.139621427915
"Marquette County, Michigan",2012,67178,39.5,34355,8031,26324,45349,2.55196778605,0.119548066331
"Marquette County, Michigan",2015,67582,39.1,34480,8023,26457,45409,2.55440904109,0.118715042467
"Marquette County, Wisconsin",2009,14884,45.9,9471,2769,6702,43195,2.2208296031,0.186038699274
"Marquette County, Wisconsin",2012,15366,47.2,9876,3278,6598,44879,2.32888754168,0.213328127034
"Marquette County, Wisconsin",2015,15140,48.6,9882,3550,6332,46242,2.39102969046,0.234478203435
"Marshall County, Alabama",2009,87925,37.4,38283,5210,33073,37396,2.65851298642,0.059255046915
"Marshall County, Alabama",2012,93070,38.1,40222,5826,34396,38649,2.70583788813,0.0625980444826
"Marshall County, Alabama",2015,94318,38.8,40370,6109,34261,38983,2.75292606754,0.0647702453402
"Marshall County, Illinois",2009,12831,43.3,6143,700,5443,47484,2.35733970237,0.0545553737043
"Marshall County, Illinois",2012,12567,44.9,5922,830,5092,52565,2.46798900236,0.066045993475
"Marshall County, Illinois",2015,12173,45.9,5912,919,4993,53423,2.43801321851,0.0754949478354
"Marshall County, Indiana",2009,46605,37,19352,2107,17245,50786,2.70252247028,0.0452097414441
"Marshall County, Indiana",2012,47045,38.2,19826,2053,17773,47218,2.64699262927,0.0436390689765
"Marshall County, Indiana",2015,46962,39.5,19948,2624,17324,48485,2.71080581852,0.0558749627358
"Marshall County, Iowa",2009,39093,40.1,17039,1358,15681,45870,2.49301702698,0.0347376768219
"Marshall County, Iowa",2012,40568,39.4,16852,1475,15377,49259,2.63822592183,0.0363587063696
"Marshall County, Iowa",2015,40962,38.9,16736,1439,15297,53351,2.67777995685,0.0351301205996
"Marshall County, Kansas",2009,10178,45,5086,604,4482,42328,2.27086122267,0.0593436824523
"Marshall County, Kansas",2012,10083,44.9,4893,569,4324,41867,2.33186864015,0.0564316175741
"Marshall County, Kansas",2015,10005,45,4882,560,4322,45374,2.31490050902,0.055972013993
"Marshall County, Kentucky",2009,31075,43,15465,2643,12822,41892,2.42356886601,0.0850522928399
"Marshall County, Kentucky",2012,31393,43.9,15740,3468,12272,44802,2.55809973924,0.110470487051
"Marshall County, Kentucky",2015,31181,44.9,15898,3296,12602,45212,2.47428979527,0.105705397518
"Marshall County, Minnesota",2009,9452,44,4885,714,4171,46316,2.26612323184,0.0755395683453
"Marshall County, Minnesota",2012,9475,44.2,4805,723,4082,51000,2.32116609505,0.0763060686016
"Marshall County, Minnesota",2015,9453,43.8,4804,777,4027,54092,2.34740501614,0.0821961282133
"Marshall County, Mississippi",2009,36394,36,14594,1983,12611,31831,2.88589326778,0.0544870033522
"Marshall County, Mississippi",2012,37019,38.5,14874,1855,13019,34459,2.84345955911,0.0501094032794
"Marshall County, Mississippi",2015,36385,39.6,14997,1891,13106,37419,2.77620936975,0.0519719664697
"Marshall County, Oklahoma",2009,14760,39.9,8963,3566,5397,38624,2.73485269594,0.241598915989
"Marshall County, Oklahoma",2012,15774,42.7,9946,4018,5928,36727,2.66093117409,0.254722961836
"Marshall County, Oklahoma",2015,16014,43.1,10022,4057,5965,40475,2.6846605197,0.253340826777
"Marshall County, South Dakota",2009,4266,45.1,2654,826,1828,40823,2.33369803063,0.193624003751
"Marshall County, South Dakota",2012,4631,43,2541,840,1701,44516,2.72251616696,0.181386309652
"Marshall County, South Dakota",2015,4701,42.6,2555,790,1765,51788,2.66345609065,0.168049351202
"Marshall County, Tennessee",2009,29297,37.9,12772,1216,11556,40318,2.53521979924,0.0415059562413
"Marshall County, Tennessee",2012,30585,39.3,13085,1399,11686,40687,2.61723429745,0.0457413764917
"Marshall County, Tennessee",2015,31159,39.4,13233,1265,11968,42661,2.60352606952,0.0405982220225
"Marshall County, West Virginia",2009,33205,43.2,16087,1932,14155,34330,2.34581419993,0.0581840084325
"Marshall County, West Virginia",2012,32993,44,15938,1870,14068,40288,2.34525163492,0.056678689419
"Marshall County, West Virginia",2015,32480,44.3,15855,2286,13569,45182,2.39369150269,0.070381773399
"Martin County, Florida",2009,138791,48.2,75211,17278,57933,52734,2.3957157406,0.124489340087
"Martin County, Florida",2012,146497,49.8,78037,18475,59562,50573,2.4595715389,0.126111797511
"Martin County, Florida",2015,151586,50.7,78706,16754,61952,51593,2.44682980372,0.110524718642
"Martin County, Indiana",2009,10067,41.5,4954,840,4114,42257,2.44701020904,0.0834409456641
"Martin County, Indiana",2012,10300,42,4783,675,4108,44291,2.50730282376,0.0655339805825
"Martin County, Indiana",2015,10262,42.5,4753,552,4201,44589,2.44275172578,0.0537906840772
"Martin County, Kentucky",2009,13300,36.3,5923,1156,4767,22692,2.79001468429,0.0869172932331
"Martin County, Kentucky",2012,12934,38.6,5200,792,4408,25340,2.93421052632,0.0612339570125
"Martin County, Kentucky",2015,12631,38.1,5150,830,4320,25795,2.92384259259,0.0657113451033
"Martin County, Minnesota",2009,20448,45.2,10056,926,9130,42832,2.23964950712,0.0452856025039
"Martin County, Minnesota",2012,20727,45.6,10003,1116,8887,46790,2.33228311016,0.0538428137212
"Martin County, Minnesota",2015,20350,45.4,9970,1139,8831,51391,2.30438228966,0.0559705159705
"Martin County, North Carolina",2009,23699,42.6,11188,1435,9753,32121,2.42991899928,0.0605510781046
"Martin County, North Carolina",2012,24298,44.1,11658,2132,9526,35585,2.55070333823,0.0877438472302
"Martin County, North Carolina",2015,23729,46,11595,2326,9269,35080,2.56003883914,0.0980235155295
"Martin County, Texas",2009,4447,43.3,2374,492,1882,37463,2.36291179596,0.110636384079
"Martin County, Texas",2012,4804,35.1,1836,305,1531,41964,3.13781841933,0.0634887593672
"Martin County, Texas",2015,5252,31.9,1886,256,1630,55682,3.22208588957,0.048743335872
"Martinsville city, Virginia",2009,14660,43.4,7290,1333,5957,31729,2.46097028706,0.0909276944065
"Martinsville city, Virginia",2012,13854,44.1,7210,1205,6005,28840,2.30707743547,0.0869784899668
"Martinsville city, Virginia",2015,13624,42.4,7176,1319,5857,29587,2.32610551477,0.0968144450969
"Mason County, Illinois",2009,15075,41.8,7122,652,6470,42687,2.32998454405,0.0432504145937
"Mason County, Illinois",2012,14636,44.3,7075,675,6400,42394,2.286875,0.04611915824
"Mason County, Illinois",2015,14126,44.7,7030,914,6116,41567,2.3096795291,0.0647033838312
"Mason County, Kentucky",2009,17174,40.6,8061,1256,6805,37107,2.5237325496,0.0731338069174
"Mason County, Kentucky",2012,17495,40.8,8112,1384,6728,39192,2.60032699168,0.0791083166619
"Mason County, Kentucky",2015,17296,41.1,8128,1392,6736,38824,2.567695962,0.0804810360777
"Mason County, Michigan",2009,28676,44.5,17180,4783,12397,39511,2.31314027587,0.166794532013
"Mason County, Michigan",2012,28672,45.1,17289,4953,12336,40957,2.3242542153,0.172746930804
"Mason County, Michigan",2015,28711,45.7,17278,5030,12248,42024,2.34413781842,0.175194176448
"Mason County, Texas",2009,3890,46.4,2343,855,1488,37847,2.61424731183,0.219794344473
"Mason County, Texas",2012,3978,49.8,2532,842,1690,44408,2.35384615385,0.211664152841
"Mason County, Texas",2015,4066,50.5,2752,1038,1714,37654,2.37222870478,0.255287752091
"Mason County, Washington",2009,56341,43.1,28698,8504,20194,49081,2.78998712489,0.150938038018
"Mason County, Washington",2012,60545,44.5,32347,9073,23274,48878,2.60140070465,0.149855479395
"Mason County, Washington",2015,60791,45.4,32605,9579,23026,50406,2.64010249283,0.157572667007
"Mason County, West Virginia",2009,25536,41.6,12518,1803,10715,34737,2.38320111993,0.0706062030075
"Mason County, West Virginia",2012,27242,42.2,12966,2585,10381,37877,2.6242173201,0.0948902430071
"Mason County, West Virginia",2015,27177,43,12952,2114,10838,36448,2.50756597158,0.0777863634691
"Massac County, Illinois",2009,15081,41,7201,683,6518,38237,2.31374654802,0.045288773954
"Massac County, Illinois",2012,15370,42.3,7116,959,6157,42190,2.49634562287,0.0623942745608
"Massac County, Illinois",2015,15016,43.7,7097,1110,5987,40977,2.50810088525,0.0739211507725
"Matagorda County, Texas",2009,37008,36.5,19465,5416,14049,40307,2.63420884049,0.146346735841
"Matagorda County, Texas",2012,36653,38.1,18841,5503,13338,43146,2.74801319538,0.150137778627
"Matagorda County, Texas",2015,36598,37.2,18985,5603,13382,40797,2.73486773278,0.153095797585
"Matanuska-Susitna Borough, Alaska",2009,82099,34.1,28532,6576,21956,66052,3.73925122973,0.0800984177639
"Matanuska-Susitna Borough, Alaska",2012,89319,34.8,40578,9655,30923,70728,2.88843255829,0.108095701922
"Matanuska-Susitna Borough, Alaska",2015,96178,34.6,41311,10213,31098,72983,3.0927390829,0.106188525442
"Mathews County, Virginia",2009,9011,48.6,5772,1946,3826,49318,2.35520125457,0.215958273222
"Mathews County, Virginia",2012,8965,50.3,5675,1860,3815,55590,2.3499344692,0.207473508087
"Mathews County, Virginia",2015,8880,51.1,5702,1896,3806,63845,2.33315817131,0.213513513514
"Maui County, Hawaii",2009,142196,37.9,64656,15722,48934,63659,2.90587321699,0.110565698051
"Maui County, Hawaii",2012,154937,39.5,70190,17923,52267,64058,2.96433696214,0.115679276093
"Maui County, Hawaii",2015,160863,40,71157,17694,53463,66476,3.00886594467,0.109994218683
"Maunabo Municipio, Puerto Rico",2009,12669,36.3,4750,822,3928,15035,3.22530549898,0.0648827847502
"Maunabo Municipio, Puerto Rico",2012,12201,37.7,5001,1000,4001,16043,3.04948762809,0.0819604950414
"Maunabo Municipio, Puerto Rico",2015,11701,41.5,5286,1200,4086,19541,2.86368086148,0.102555337151
"Maury County, Tennessee",2009,80190,37.5,34982,2892,32090,45724,2.49890931754,0.0360643471755
"Maury County, Tennessee",2012,80965,37.9,35277,3300,31977,45603,2.53197610783,0.0407583523745
"Maury County, Tennessee",2015,84089,38.6,35768,3303,32465,47692,2.59014323117,0.0392798106768
"Maverick County, Texas",2009,51300,28.8,16617,2958,13659,30123,3.75576542939,0.0576608187135
"Maverick County, Texas",2012,54107,30.1,17497,2049,15448,30959,3.50252459865,0.0378694069159
"Maverick County, Texas",2015,56548,29.9,17929,1899,16030,33747,3.52763568309,0.0335820895522
"Mayagüez Municipio, Puerto Rico",2009,93697,37.3,38469,6133,32336,13538,2.89760638298,0.0654556709393
"Mayagüez Municipio, Puerto Rico",2012,88664,37.2,39853,8565,31288,15060,2.83380209665,0.0966006496436
"Mayagüez Municipio, Puerto Rico",2015,83418,38.3,41452,11021,30431,14871,2.74121783707,0.132117768347
"Mayes County, Oklahoma",2009,39666,39.6,18344,2817,15527,39463,2.55464674438,0.0710180003025
"Mayes County, Oklahoma",2012,41162,39.2,19193,2994,16199,41475,2.54102105068,0.0727369904281
"Mayes County, Oklahoma",2015,41007,39.3,19231,3491,15740,42071,2.60527318933,0.0851318067647
"McClain County, Oklahoma",2009,31676,37.9,12764,1675,11089,52538,2.85652448372,0.052879151408
"McClain County, Oklahoma",2012,34471,38.2,13992,1482,12510,54554,2.7554756195,0.0429926604972
"McClain County, Oklahoma",2015,36512,38.3,14514,1270,13244,56088,2.75687103594,0.0347830850131
"McCone County, Montana",2009,1747,45.9,1098,336,762,40903,2.29265091864,0.192329708071
"McCone County, Montana",2012,1808,47.1,1040,277,763,46528,2.36959370904,0.153207964602
"McCone County, Montana",2015,1728,51.2,1029,292,737,40750,2.34464043419,0.168981481481
"McCook County, South Dakota",2009,5697,41.5,2564,338,2226,43984,2.55929919137,0.0593294716517
"McCook County, South Dakota",2012,5592,42.4,2490,287,2203,47392,2.5383567862,0.0513233190272
"McCook County, South Dakota",2015,5613,42.8,2501,248,2253,56954,2.4913448735,0.0441831462676
"McCormick County, South Carolina",2009,10087,48.1,4893,1094,3799,34786,2.65517241379,0.108456429067
"McCormick County, South Carolina",2012,10140,49.9,5420,1404,4016,38385,2.52490039841,0.138461538462
"McCormick County, South Carolina",2015,9895,51.9,5456,1453,4003,38712,2.47189607794,0.146841839313
"McCracken County, Kentucky",2009,65059,41.4,32009,3850,28159,40847,2.31041585284,0.0591770546735
"McCracken County, Kentucky",2012,65558,42.1,31166,3873,27293,44757,2.40200784084,0.0590774581287
"McCracken County, Kentucky",2015,65408,42.5,31342,3828,27514,44067,2.37726248455,0.0585249510763
"McCreary County, Kentucky",2009,18199,36,7609,1209,6400,22441,2.84359375,0.0664322215506
"McCreary County, Kentucky",2012,18204,38.6,7494,1207,6287,21758,2.895498648,0.066304108987
"McCreary County, Kentucky",2015,18001,38.8,7441,1164,6277,19328,2.86777122829,0.0646630742737
"McCulloch County, Texas",2009,7893,42.5,4325,1062,3263,36495,2.41893962611,0.134549600912
"McCulloch County, Texas",2012,8281,40.8,4300,1247,3053,36560,2.712414019,0.150585678058
"McCulloch County, Texas",2015,8273,44.2,4284,1139,3145,40561,2.63052464229,0.137676779886
"McCurtain County, Oklahoma",2009,33451,37.8,16092,2245,13847,31352,2.4157579259,0.0671130907895
"McCurtain County, Oklahoma",2012,33144,38.8,15555,2481,13074,32134,2.53510784764,0.0748551774077
"McCurtain County, Oklahoma",2015,33143,39.1,15571,2663,12908,32324,2.56763247598,0.0803487916
"McDonald County, Missouri",2009,22890,35.3,9725,1668,8057,36498,2.84100781929,0.072870249017
"McDonald County, Missouri",2012,22970,36.5,9919,1662,8257,36719,2.78188203948,0.072355245973
"McDonald County, Missouri",2015,22763,37,9850,1532,8318,38368,2.73659533542,0.0673022009401
"McDonough County, Illinois",2009,32907,25.6,14283,1394,12889,32337,2.5531073008,0.0423618075182
"McDonough County, Illinois",2012,32568,29.4,14412,1614,12798,35812,2.54477262072,0.0495578481945
"McDonough County, Illinois",2015,32009,30.7,14403,2274,12129,40314,2.63904691236,0.0710425192914
"McDowell County, North Carolina",2009,43587,40,19819,2870,16949,37374,2.57165614491,0.0658453208525
"McDowell County, North Carolina",2012,44926,41.8,20767,3537,17230,36388,2.60742890308,0.0787294662334
"McDowell County, North Carolina",2015,44961,43.1,20893,3570,17323,35965,2.59545113433,0.0794021485287
"McDowell County, West Virginia",2009,22971,42.6,13732,4240,9492,21360,2.42003792668,0.184580558095
"McDowell County, West Virginia",2012,21966,44,11421,3073,8348,22972,2.63128893148,0.139898024219
"McDowell County, West Virginia",2015,20802,44.1,11221,3041,8180,24921,2.54303178484,0.146187866551
"McDuffie County, Georgia",2009,21624,37.8,9312,996,8316,34897,2.60028860029,0.0460599334073
"McDuffie County, Georgia",2012,21762,38.5,9324,1107,8217,38855,2.64841182913,0.0508684863524
"McDuffie County, Georgia",2015,21582,38.2,9271,1140,8131,36656,2.65428606567,0.0528217959411
"McHenry County, Illinois",2009,312946,36.8,113470,6519,106951,77314,2.92606894746,0.020831069897
"McHenry County, Illinois",2012,308163,38,116015,7065,108950,77325,2.82848095457,0.0229261786782
"McHenry County, Illinois",2015,307357,39.3,116772,7281,109491,77222,2.80714396617,0.0236890651588
"McHenry County, North Dakota",2009,5275,45.3,3032,453,2579,37039,2.04536642109,0.0858767772512
"McHenry County, North Dakota",2012,5478,45.4,2949,446,2503,41763,2.18857371155,0.0814165753925
"McHenry County, North Dakota",2015,5817,43.3,3036,428,2608,57386,2.23044478528,0.0735774454186
"McIntosh County, Georgia",2009,11268,40.3,6718,2197,4521,37629,2.49236894492,0.194976925808
"McIntosh County, Georgia",2012,14119,43.5,9085,3999,5086,39506,2.7760519072,0.283235356612
"McIntosh County, Georgia",2015,14007,47.6,9304,4008,5296,42988,2.64482628399,0.286142642964
"McIntosh County, North Dakota",2009,2754,51.1,1801,569,1232,37500,2.23538961039,0.206608569354
"McIntosh County, North Dakota",2012,2813,53.1,1863,573,1290,36327,2.18062015504,0.203697120512
"McIntosh County, North Dakota",2015,2759,53.4,1855,566,1289,42277,2.1404189294,0.205146792316
"McIntosh County, Oklahoma",2009,19591,45.3,13429,5682,7747,28305,2.52884987737,0.290031136746
"McIntosh County, Oklahoma",2012,20266,46.7,13356,5356,8000,32669,2.53325,0.264285009375
"McIntosh County, Oklahoma",2015,20280,47.4,13408,5035,8373,36011,2.42207094231,0.248274161736
"McKean County, Pennsylvania",2009,43622,40.6,21809,4157,17652,40080,2.47122139134,0.0952959515841
"McKean County, Pennsylvania",2012,43451,41.8,21251,3857,17394,41351,2.49804530298,0.0887666566937
"McKean County, Pennsylvania",2015,42884,42.4,21083,3683,17400,43965,2.46459770115,0.0858828467494
"McKenzie County, North Dakota",2009,5594,41.8,2788,490,2298,46330,2.43429068755,0.0875938505542
"McKenzie County, North Dakota",2012,6692,37.6,3125,516,2609,61893,2.56496742047,0.077106993425
"McKenzie County, North Dakota",2015,9615,32.2,3944,730,3214,72794,2.99159925327,0.0759230369215
"McKinley County, New Mexico",2009,70388,29.7,26895,8765,18130,32615,3.88240485383,0.124524066602
"McKinley County, New Mexico",2012,71888,30.3,25842,8324,17518,30780,4.10366480192,0.115791230803
"McKinley County, New Mexico",2015,73998,30.8,25780,7331,18449,28772,4.01094910293,0.0990702451418
"McLean County, Illinois",2009,163686,30.6,67864,5543,62321,55812,2.62649829111,0.0338636169251
"McLean County, Illinois",2012,169689,32.2,69691,5982,63709,61049,2.66350123217,0.0352527270477
"McLean County, Illinois",2015,173114,32.7,70897,5551,65346,62211,2.64919046307,0.0320655752856
"McLean County, Kentucky",2009,9690,40.3,4614,675,3939,39857,2.46001523229,0.0696594427245
"McLean County, Kentucky",2012,9554,42.2,4277,578,3699,40563,2.5828602325,0.0604982206406
"McLean County, Kentucky",2015,9500,41.8,4250,491,3759,40770,2.5272678904,0.0516842105263
"McLean County, North Dakota",2009,8360,48.8,5284,1433,3851,50679,2.17086471046,0.171411483254
"McLean County, North Dakota",2012,9020,49.2,5602,1596,4006,54539,2.25162256615,0.176940133038
"McLean County, North Dakota",2015,9451,47.1,5815,1581,4234,55686,2.23216816249,0.167283885303
"McLennan County, Texas",2009,228369,31.3,91931,10080,81851,40038,2.79005754359,0.0441390906822
"McLennan County, Texas",2012,234626,32.8,95089,11123,83966,41589,2.79429769192,0.0474073632078
"McLennan County, Texas",2015,241505,32.9,96935,10166,86769,42687,2.78330970738,0.0420943665763
"McLeod County, Minnesota",2009,36879,38.1,15626,1070,14556,56615,2.53359439406,0.0290138018927
"McLeod County, Minnesota",2012,36527,39.1,15767,830,14937,55275,2.44540403026,0.0227229172941
"McLeod County, Minnesota",2015,36046,39.9,15746,927,14819,56128,2.43241784196,0.025717139211
"McMinn County, Tennessee",2009,52055,40,22722,2132,20590,35860,2.52816901408,0.0409566804342
"McMinn County, Tennessee",2012,52325,41,23274,2662,20612,38944,2.53856976519,0.0508743430483
"McMinn County, Tennessee",2015,52506,42.7,23267,3289,19978,38535,2.62819101011,0.0626404601379
"McMullen County, Texas",2009,938,41.5,599,256,343,40550,2.73469387755,0.272921108742
"McMullen County, Texas",2012,696,41.9,498,209,289,38438,2.40830449827,0.300287356322
"McMullen County, Texas",2015,778,42.2,454,176,278,46250,2.79856115108,0.226221079692
"McNairy County, Tennessee",2009,25436,41.1,11798,1790,10008,34279,2.5415667466,0.0703727001101
"McNairy County, Tennessee",2012,26001,42,11946,2038,9908,33066,2.62424303593,0.0783816007077
"McNairy County, Tennessee",2015,26103,42.6,11978,2106,9872,32557,2.64414505673,0.0806803815653
"McPherson County, Kansas",2009,28984,40.5,12521,918,11603,50501,2.49797466173,0.0316726469776
"McPherson County, Kansas",2012,29208,41.8,12727,1199,11528,54171,2.53365718251,0.0410503971515
"McPherson County, Kansas",2015,29252,42,12824,1033,11791,56128,2.48087524383,0.0353138246957
"McPherson County, Nebraska",2009,498,39.8,261,51,210,50833,2.37142857143,0.102409638554
"McPherson County, Nebraska",2012,348,49,225,53,172,51563,2.02325581395,0.152298850575
"McPherson County, Nebraska",2015,433,46.9,244,47,197,54306,2.19796954315,0.108545034642
"McPherson County, South Dakota",2009,2515,47.9,1527,415,1112,30690,2.26169064748,0.165009940358
"McPherson County, South Dakota",2012,2485,50.1,1442,383,1059,36314,2.34655335222,0.154124748491
"McPherson County, South Dakota",2015,2263,52.1,1388,379,1009,36375,2.24281466799,0.167476800707
"Meade County, Kansas",2009,4438,36.9,1985,283,1702,45292,2.60752056404,0.0637674628211
"Meade County, Kansas",2012,4504,40,1989,225,1764,49846,2.55328798186,0.0499555950266
"Meade County, Kansas",2015,4383,39.8,1943,249,1694,52250,2.58736717828,0.056810403833
"Meade County, Kentucky",2009,27230,36,11261,1493,9768,42868,2.78767403767,0.0548292324642
"Meade County, Kentucky",2012,28979,35.6,11855,1602,10253,45629,2.82639227543,0.0552814106767
"Meade County, Kentucky",2015,29098,36.7,12106,1532,10574,49884,2.75184414602,0.0526496666438
"Meade County, South Dakota",2009,24126,36,11501,1388,10113,41934,2.38564224266,0.0575312940396
"Meade County, South Dakota",2012,25456,36.1,11104,1081,10023,50077,2.53975855532,0.0424654305468
"Meade County, South Dakota",2015,26381,36.2,11361,768,10593,52473,2.4904182007,0.0291118608089
"Meagher County, Montana",2009,1628,43.1,1304,609,695,33365,2.34244604317,0.374078624079
"Meagher County, Montana",2012,1900,46.9,1337,611,726,35000,2.61707988981,0.321578947368
"Meagher County, Montana",2015,1898,49.6,1350,593,757,41641,2.5072655218,0.312434141201
"Mecklenburg County, North Carolina",2009,861189,33.7,388558,36018,352540,55587,2.44281216316,0.0418235718292
"Mecklenburg County, North Carolina",2012,926873,34,398454,35989,362465,55961,2.55713793056,0.0388284047545
"Mecklenburg County, North Carolina",2015,990288,34.5,412598,32812,379786,56854,2.60748948092,0.0331337954211
"Mecklenburg County, Virginia",2009,31987,44,18728,6196,12532,34741,2.55242578998,0.193703692125
"Mecklenburg County, Virginia",2012,32548,45.9,18606,5964,12642,35399,2.57459262775,0.183237065257
"Mecklenburg County, Virginia",2015,31555,47.2,18661,6179,12482,37356,2.52804037814,0.195816827761
"Mecosta County, Michigan",2009,41976,34.6,21522,5140,16382,36100,2.5623245025,0.122450924338
"Mecosta County, Michigan",2012,42947,34.1,21159,5464,15695,38332,2.73634915578,0.127226581601
"Mecosta County, Michigan",2015,43301,35.7,21092,5614,15478,41889,2.79758366714,0.129650585437
"Medina County, Ohio",2009,169946,39.2,66033,3700,62333,66458,2.7264209969,0.0217716215739
"Medina County, Ohio",2012,172334,40.5,69105,3833,65272,65768,2.64024390244,0.0222416934557
"Medina County, Ohio",2015,174831,41.4,70239,4237,66002,66952,2.64887427654,0.0242348324954
"Medina County, Texas",2009,43654,37.1,15807,2323,13484,46348,3.23746662711,0.0532139093783
"Medina County, Texas",2012,46009,37.9,17859,2446,15413,52206,2.98507753195,0.0531635114869
"Medina County, Texas",2015,47392,38.5,18070,3095,14975,57338,3.16474123539,0.0653063808238
"Meeker County, Minnesota",2009,23195,41.2,10783,1436,9347,52031,2.48154488071,0.0619098943738
"Meeker County, Minnesota",2012,23262,41.4,10667,1265,9402,52705,2.47415443523,0.0543805347777
"Meeker County, Minnesota",2015,23129,42,10688,1514,9174,55042,2.52114671899,0.0654589476415
"Meigs County, Ohio",2009,22898,40.7,10905,1366,9539,33928,2.40046126428,0.0596558651411
"Meigs County, Ohio",2012,23664,41.5,11161,1563,9598,34704,2.46551364868,0.0660496957404
"Meigs County, Ohio",2015,23473,42.3,11076,1754,9322,37813,2.51802188372,0.0747241511524
"Meigs County, Tennessee",2009,11747,39.3,5698,1042,4656,32096,2.52298109966,0.0887034987656
"Meigs County, Tennessee",2012,11696,43.2,5638,1002,4636,33492,2.5228645384,0.0856703146375
"Meigs County, Tennessee",2015,11716,44.3,5652,1032,4620,34424,2.53593073593,0.088084670536
"Mellette County, South Dakota",2009,2032,34,855,203,652,34632,3.11656441718,0.0999015748031
"Mellette County, South Dakota",2012,2057,31.5,809,155,654,35563,3.14525993884,0.0753524550316
"Mellette County, South Dakota",2015,2086,32,817,142,675,30938,3.09037037037,0.0680728667306
"Menard County, Illinois",2009,12460,42.4,5684,555,5129,56821,2.42932345486,0.0445425361156
"Menard County, Illinois",2012,12728,43,5661,599,5062,59428,2.5144211774,0.0470615964802
"Menard County, Illinois",2015,12611,42.5,5651,507,5144,60486,2.4515940902,0.0402029973832
"Menard County, Texas",2009,2132,47.1,1622,733,889,31016,2.39820022497,0.343808630394
"Menard County, Texas",2012,2232,43.7,1664,795,869,35048,2.56846950518,0.356182795699
"Menard County, Texas",2015,2182,45.7,1725,774,951,34464,2.29442691903,0.354720439963
"Mendocino County, California",2009,86030,40.8,38933,4966,33967,43404,2.53275237731,0.0577240497501
"Mendocino County, California",2012,87577,41.7,40258,6030,34228,43721,2.55863620428,0.0688536944632
"Mendocino County, California",2015,87544,42.2,40643,6626,34017,42980,2.57353676103,0.0756876542082
"Menifee County, Kentucky",2009,6687,40.1,4022,1665,2357,29224,2.83708103521,0.248990578735
"Menifee County, Kentucky",2012,6331,41.6,3991,1639,2352,25988,2.69175170068,0.258884852314
"Menifee County, Kentucky",2015,6343,41.6,3798,1371,2427,31503,2.61351462711,0.216143780545
"Menominee County, Michigan",2009,24230,44.9,14395,3418,10977,41514,2.20734262549,0.141064795708
"Menominee County, Michigan",2012,24041,46.2,14235,3366,10869,40865,2.21188701812,0.140010814858
"Menominee County, Michigan",2015,23717,47.5,14178,3499,10679,40373,2.22090083341,0.147531306658
"Menominee County, Wisconsin",2009,4537,31.2,2282,771,1511,31372,3.00264725347,0.169936081111
"Menominee County, Wisconsin",2012,4274,32.6,2359,1075,1284,37644,3.32866043614,0.251520823584
"Menominee County, Wisconsin",2015,4451,31.6,2307,1048,1259,35343,3.53534551231,0.235452707257
"Merced County, California",2009,242235,29.4,82040,8912,73128,43848,3.31247948802,0.0367907197556
"Merced County, California",2012,256398,29.7,83650,9154,74496,43565,3.44176868557,0.0357023065703
"Merced County, California",2015,263885,30.4,84063,6371,77692,42462,3.39655305566,0.024143092635
"Mercer County, Illinois",2009,16440,42.7,7303,589,6714,51200,2.44861483467,0.0358272506083
"Mercer County, Illinois",2012,16421,43.7,7343,575,6768,52700,2.42627068558,0.0350161378722
"Mercer County, Illinois",2015,16107,44.3,7359,752,6607,54757,2.4378689269,0.0466877755013
"Mercer County, Kentucky",2009,21734,40.1,10089,1403,8686,43969,2.50218742805,0.0645532345634
"Mercer County, Kentucky",2012,21283,42.3,9949,1463,8486,44431,2.50801319821,0.0687403091669
"Mercer County, Kentucky",2015,21342,42.6,10038,1214,8824,42083,2.41863100635,0.0568831412239
"Mercer County, Missouri",2009,3474,45.4,2186,564,1622,32591,2.14180024661,0.162348877375
"Mercer County, Missouri",2012,3763,43.7,2134,568,1566,38125,2.40293742018,0.150943396226
"Mercer County, Missouri",2015,3718,44.1,2119,616,1503,40768,2.47371922821,0.165680473373
"Mercer County, New Jersey",2009,363778,36.9,140279,12842,127437,71767,2.85457127836,0.0353017499684
"Mercer County, New Jersey",2012,366442,37.8,143311,13019,130292,73759,2.81246738096,0.0355281326922
"Mercer County, New Jersey",2015,370212,38.4,143833,13287,130546,72804,2.83587394482,0.0358902466695
"Mercer County, North Dakota",2009,7955,45.3,4459,819,3640,57640,2.18543956044,0.102954116908
"Mercer County, North Dakota",2012,8400,46.8,4456,826,3630,63244,2.31404958678,0.0983333333333
"Mercer County, North Dakota",2015,8633,45.6,4616,943,3673,72704,2.35039477267,0.10923201668
"Mercer County, Ohio",2009,40761,38.1,16745,1530,15215,50685,2.67900098587,0.0375358798852
"Mercer County, Ohio",2012,40866,39.4,17551,1836,15715,52234,2.6004454343,0.0449273234474
"Mercer County, Ohio",2015,40863,40.1,17645,1726,15919,53099,2.56693259627,0.0422387000465
"Mercer County, Pennsylvania",2009,117098,41.9,51633,4919,46714,42264,2.50670034679,0.0420075492323
"Mercer County, Pennsylvania",2012,116474,42.8,51719,5330,46389,43589,2.51081075255,0.0457612857805
"Mercer County, Pennsylvania",2015,115320,43.8,51662,6116,45546,44156,2.5319457252,0.0530350329518
"Mercer County, West Virginia",2009,61451,41.4,30323,4691,25632,31478,2.39743289638,0.0763372443085
"Mercer County, West Virginia",2012,62251,42.1,30052,4268,25784,34517,2.41432671424,0.0685611476121
"Mercer County, West Virginia",2015,61891,42.3,29898,4447,25451,36195,2.4317708538,0.0718521271267
"Meriwether County, Georgia",2009,22858,38,10403,1536,8867,37305,2.57787301229,0.0671974800945
"Meriwether County, Georgia",2012,21966,41.6,9980,1899,8081,37660,2.71822794209,0.0864517891287
"Meriwether County, Georgia",2015,21297,42.1,9925,1982,7943,35832,2.68122875488,0.0930647509039
"Merrick County, Nebraska",2009,7672,42.7,3796,651,3145,46171,2.43942766296,0.0848540145985
"Merrick County, Nebraska",2012,7779,43.3,3697,431,3266,49609,2.38181261482,0.0554055791233
"Merrick County, Nebraska",2015,7776,43.8,3724,399,3325,51012,2.33864661654,0.0513117283951
"Merrimack County, New Hampshire",2009,148156,40,61574,5814,55760,62225,2.65703012912,0.0392424201517
"Merrimack County, New Hampshire",2012,146742,41.5,63397,6173,57224,65487,2.56434363204,0.0420670292077
"Merrimack County, New Hampshire",2015,147262,42.6,63653,6948,56705,65983,2.59698439291,0.0471812144341
"Mesa County, Colorado",2009,137879,38.1,58329,3518,54811,50611,2.51553520279,0.0255151255811
"Mesa County, Colorado",2012,146562,37.9,62555,3920,58635,51029,2.49956510617,0.0267463599023
"Mesa County, Colorado",2015,147834,38.4,63472,4257,59215,49322,2.49656337077,0.0287958115183
"Metcalfe County, Kentucky",2009,10115,40.3,4829,765,4064,35011,2.48892716535,0.0756302521008
"Metcalfe County, Kentucky",2012,10074,41.9,4689,742,3947,34100,2.55231821637,0.0736549533452
"Metcalfe County, Kentucky",2015,9985,43.4,4676,740,3936,32294,2.53683943089,0.0741111667501
"Miami County, Indiana",2009,36508,39.4,15895,2143,13752,38872,2.65474112856,0.0586994631314
"Miami County, Indiana",2012,36850,39.9,15478,2158,13320,39816,2.76651651652,0.0585617367707
"Miami County, Indiana",2015,36211,40.1,15363,2199,13164,45184,2.75075964752,0.0607274032752
"Miami County, Kansas",2009,30511,39,12418,875,11543,59888,2.64324698952,0.0286781816394
"Miami County, Kansas",2012,32546,40.1,13176,1022,12154,61272,2.67780154682,0.0314017083513
"Miami County, Kansas",2015,32688,40.4,13273,713,12560,60966,2.6025477707,0.0218122858541
"Miami County, Ohio",2009,100982,39.8,42126,2529,39597,51827,2.55024370533,0.0250440672595
"Miami County, Ohio",2012,102657,40.8,44126,2901,41225,52292,2.4901637356,0.028259154271
"Miami County, Ohio",2015,103517,41.4,44266,3131,41135,51569,2.51651877963,0.0302462397481
"Miami-Dade County, Florida",2009,2457044,37.2,962935,135004,827931,42969,2.96769175209,0.0549456989781
"Miami-Dade County, Florida",2012,2512219,38.2,989364,163185,826179,43464,3.04076840491,0.0649565185201
"Miami-Dade County, Florida",2015,2639042,39,998833,156680,842153,43129,3.13368473425,0.0593700289726
"Middlesex County, Connecticut",2009,164004,41.3,72079,6603,65476,74965,2.50479565031,0.0402612131411
"Middlesex County, Connecticut",2012,165639,43,74722,7994,66728,76659,2.48230128282,0.0482615809079
"Middlesex County, Connecticut",2015,165165,44.2,75162,9045,66117,79893,2.49807160034,0.0547634183998
"Middlesex County, Massachusetts",2009,1480260,38.2,594159,32892,561267,77004,2.63735441421,0.0222204207369
"Middlesex County, Massachusetts",2012,1507558,38.5,611338,32129,579209,81420,2.60278759481,0.0213119495237
"Middlesex County, Massachusetts",2015,1556116,38.5,617089,31447,585642,85118,2.65711134106,0.0202086476844
"Middlesex County, New Jersey",2009,781957,36.6,286628,14906,271722,76321,2.87778317545,0.019062429264
"Middlesex County, New Jersey",2012,811064,37.2,295165,15024,280141,79442,2.89519920326,0.0185238156298
"Middlesex County, New Jersey",2015,830300,37.7,297940,15882,282058,79593,2.94372079501,0.0191280260147
"Middlesex County, Virginia",2009,10626,49.8,7155,2620,4535,50181,2.34310915105,0.246565029174
"Middlesex County, Virginia",2012,10855,51.2,7146,2753,4393,55625,2.47097655361,0.253615845233
"Middlesex County, Virginia",2015,10717,52.7,7211,2869,4342,54654,2.46821741133,0.267705514603
"Midland County, Michigan",2009,82738,38.9,35369,2264,33105,50361,2.49925993052,0.0273634847349
"Midland County, Michigan",2012,83744,40.3,35975,2279,33696,52947,2.48528015195,0.0272138899503
"Midland County, Michigan",2015,83624,40.9,36195,2578,33617,54059,2.48755094149,0.0308284702956
"Midland County, Texas",2009,126287,33.4,50142,3513,46629,52611,2.70833601407,0.0278175900924
"Midland County, Texas",2012,138472,33.3,54272,4374,49898,59391,2.77510120646,0.0315876133803
"Midland County, Texas",2015,151290,32.1,56735,3865,52870,68806,2.86154719122,0.0255469627867
"Mifflin County, Pennsylvania",2009,45961,41.3,21306,2350,18956,36369,2.42461489766,0.0511303061291
"Mifflin County, Pennsylvania",2012,46694,42.5,21535,2583,18952,38671,2.46380329253,0.0553175996916
"Mifflin County, Pennsylvania",2015,46675,43.5,21527,2813,18714,41288,2.49412204766,0.0602678093198
"Milam County, Texas",2009,24780,39,11271,1705,9566,37565,2.59042441982,0.068805488297
"Milam County, Texas",2012,24691,40.6,11303,1905,9398,39170,2.62726111939,0.0771536187275
"Milam County, Texas",2015,24344,41.4,11324,1978,9346,38929,2.60475069548,0.0812520538942
"Millard County, Utah",2009,12007,33.6,4843,889,3954,42289,3.03667172484,0.0740401432498
"Millard County, Utah",2012,12436,34,4931,816,4115,47235,3.02211421628,0.0656159536829
"Millard County, Utah",2015,12582,34.9,4943,783,4160,51593,3.02451923077,0.0622317596567
"Mille Lacs County, Minnesota",2009,26071,39.3,12156,2013,10143,45817,2.57034407966,0.0772122281462
"Mille Lacs County, Minnesota",2012,26004,39.5,12738,2281,10457,46363,2.48675528354,0.0877172742655
"Mille Lacs County, Minnesota",2015,25809,40.3,12718,2672,10046,49094,2.56908222178,0.103529776435
"Miller County, Arkansas",2009,42971,37.5,19148,2548,16600,39090,2.58861445783,0.059295804147
"Miller County, Arkansas",2012,43449,37.5,19255,2522,16733,40314,2.59660551007,0.0580450643283
"Miller County, Arkansas",2015,43652,37.8,19375,2415,16960,40317,2.57382075472,0.0553239255933
"Miller County, Georgia",2009,6166,38,2831,399,2432,33125,2.53536184211,0.0647096983458
"Miller County, Georgia",2012,6094,41.2,2789,295,2494,32432,2.44346431435,0.0484082704299
"Miller County, Georgia",2015,5936,41,2766,390,2376,33983,2.49831649832,0.0657008086253
"Miller County, Missouri",2009,24731,39,12037,2142,9895,35732,2.49934310258,0.0866119445231
"Miller County, Missouri",2012,24822,40.3,12711,2523,10188,34763,2.43639575972,0.101643703167
"Miller County, Missouri",2015,24956,40.8,12739,3287,9452,38094,2.64028776978,0.131711812791
"Mills County, Iowa",2009,15052,40.8,5909,503,5406,56450,2.78431372549,0.0334174860484
"Mills County, Iowa",2012,15028,41.4,6081,650,5431,62908,2.76707788621,0.0432525951557
"Mills County, Iowa",2015,14862,41.9,6082,683,5399,63979,2.75273198741,0.0459561297268
"Mills County, Texas",2009,5003,47.3,2918,1057,1861,34019,2.68833960236,0.211273236058
"Mills County, Texas",2012,4880,47.2,3023,1168,1855,34984,2.6307277628,0.239344262295
"Mills County, Texas",2015,4875,45.5,2845,997,1848,43920,2.63798701299,0.204512820513
"Milwaukee County, Wisconsin",2009,953864,33.8,408959,33694,375265,43848,2.54184109896,0.0353236939438
"Milwaukee County, Wisconsin",2012,946584,33.7,417504,37793,379711,43599,2.49290644727,0.0399256695655
"Milwaukee County, Wisconsin",2015,955939,34.2,417484,35769,381715,43873,2.50432652634,0.037417659495
"Miner County, South Dakota",2009,2454,46.6,1417,292,1125,41771,2.18133333333,0.118989405053
"Miner County, South Dakota",2012,2365,47.1,1344,273,1071,47019,2.20821661998,0.115433403805
"Miner County, South Dakota",2015,2306,43.5,1258,252,1006,44938,2.29224652087,0.109280138768
"Mineral County, Colorado",2009,1077,59,1446,977,469,52153,2.29637526652,0.907149489322
"Mineral County, Colorado",2012,702,60.3,1311,948,363,52750,1.93388429752,1.35042735043
"Mineral County, Colorado",2015,733,60.9,1249,881,368,48125,1.99184782609,1.20190995907
"Mineral County, Montana",2009,3898,46.5,1997,454,1543,36820,2.52624756967,0.116469984607
"Mineral County, Montana",2012,4203,49.6,2432,791,1641,32618,2.56124314442,0.188198905544
"Mineral County, Montana",2015,4238,51.6,2457,894,1563,36031,2.71145233525,0.210948560642
"Mineral County, Nevada",2009,4724,55,3558,1061,2497,30217,1.89187024429,0.224597798476
"Mineral County, Nevada",2012,4718,50.4,3054,805,2249,33547,2.09782125389,0.170623145401
"Mineral County, Nevada",2015,4566,48.7,2714,724,1990,38923,2.29447236181,0.158563293912
"Mineral County, West Virginia",2009,26960,40.5,13043,1737,11306,37681,2.38457456218,0.0644287833828
"Mineral County, West Virginia",2012,28049,42.1,13049,1866,11183,32968,2.50818206206,0.0665264358801
"Mineral County, West Virginia",2015,27755,43.2,13076,1811,11265,31790,2.46382600976,0.0652495045938
"Mingo County, West Virginia",2009,26562,39.3,13465,1874,11591,29804,2.29160555603,0.0705519162714
"Mingo County, West Virginia",2012,26660,41.7,12749,1876,10873,34518,2.45194518532,0.070367591898
"Mingo County, West Virginia",2015,25931,41.7,12647,1803,10844,33221,2.39127628181,0.0695306775674
"Minidoka County, Idaho",2009,18800,35.7,7605,920,6685,40344,2.81226626776,0.0489361702128
"Minidoka County, Idaho",2012,19909,35.4,7680,873,6807,43301,2.9247833113,0.0438495152946
"Minidoka County, Idaho",2015,20279,35.5,7745,597,7148,44853,2.83701734751,0.0294393214656
"Minnehaha County, South Dakota",2009,175749,34.6,73094,4388,68706,50671,2.55798620208,0.0249674251347
"Minnehaha County, South Dakota",2012,170342,34.7,71715,4815,66900,52530,2.54621823617,0.0282666635357
"Minnehaha County, South Dakota",2015,178942,34.8,74752,4612,70140,53525,2.55121186199,0.0257737143879
"Missaukee County, Michigan",2009,14967,41.7,9205,3166,6039,38397,2.478390462,0.211532037148
"Missaukee County, Michigan",2012,14945,41.9,9112,3257,5855,40406,2.55251921435,0.217932418869
"Missaukee County, Michigan",2015,14988,43,9085,3219,5866,41098,2.55506307535,0.214771817454
"Mississippi County, Arkansas",2009,46778,34.6,22804,4165,18639,32940,2.50968399592,0.0890375817692
"Mississippi County, Arkansas",2012,46388,34.6,20559,3352,17207,35651,2.69587958389,0.0722600672588
"Mississippi County, Arkansas",2015,44864,35.6,20512,3371,17141,34612,2.61735021294,0.0751381954351
"Mississippi County, Missouri",2009,13498,38.5,5958,517,5441,28966,2.4807939717,0.0383019706623
"Mississippi County, Missouri",2012,14231,39.8,5716,455,5261,29606,2.70499904961,0.0319724545007
"Mississippi County, Missouri",2015,14208,39.3,5703,518,5185,28347,2.74021215043,0.0364583333333
"Missoula County, Montana",2009,105637,32.8,45919,4219,41700,41220,2.53326139089,0.0399386578566
"Missoula County, Montana",2012,109402,34.3,50014,4449,45565,44653,2.4010095468,0.0406665326045
"Missoula County, Montana",2015,111966,34.8,51056,4432,46624,46164,2.40146705559,0.0395834449744
"Mitchell County, Georgia",2009,23808,37.2,9598,1115,8483,36344,2.80655428504,0.0468329973118
"Mitchell County, Georgia",2012,23510,37.2,9015,865,8150,32838,2.88466257669,0.0367928541046
"Mitchell County, Georgia",2015,22982,37.6,8951,811,8140,31915,2.82334152334,0.0352884866417
"Mitchell County, Iowa",2009,10790,43.2,4686,500,4186,48397,2.57763975155,0.0463392029657
"Mitchell County, Iowa",2012,10761,44.6,4852,413,4439,50574,2.42419463843,0.0383793327758
"Mitchell County, Iowa",2015,10762,43.7,4897,539,4358,49488,2.46948141349,0.0500836275785
"Mitchell County, Kansas",2009,6329,44.8,3360,573,2787,43537,2.27090060997,0.0905356296413
"Mitchell County, Kansas",2012,6359,45.1,3295,571,2724,48046,2.33443465492,0.0897939927662
"Mitchell County, Kansas",2015,6296,44.4,3290,603,2687,48217,2.34313360625,0.0957750952986
"Mitchell County, North Carolina",2009,15690,43.8,8338,1753,6585,33118,2.38268792711,0.111727214786
"Mitchell County, North Carolina",2012,15539,45.3,8701,2165,6536,36276,2.37744798042,0.13932685501
"Mitchell County, North Carolina",2015,15330,46.7,8734,2390,6344,37391,2.41645649433,0.155903457273
"Mitchell County, Texas",2009,9275,36.6,4211,1409,2802,43009,3.31013561742,0.151913746631
"Mitchell County, Texas",2012,9367,35.4,4071,1324,2747,41082,3.40990171096,0.141347283015
"Mitchell County, Texas",2015,9169,35.5,4055,1302,2753,49870,3.33054849255,0.142000218126
"Mobile County, Alabama",2009,405331,35.3,178775,23118,155657,40476,2.60400110499,0.0570348677994
"Mobile County, Alabama",2012,412297,36.6,178278,21506,156772,42973,2.6299147807,0.0521614273206
"Mobile County, Alabama",2015,414251,37,180932,26744,154188,43809,2.68666173762,0.0645598924324
"Moca Municipio, Puerto Rico",2009,44266,33.9,13860,2277,11583,12282,3.82163515497,0.0514390276962
"Moca Municipio, Puerto Rico",2012,40044,35.2,15081,3640,11441,14384,3.50004370247,0.090900009989
"Moca Municipio, Puerto Rico",2015,38815,37.3,15683,3404,12279,14427,3.16108803649,0.0876980548757
"Modoc County, California",2009,9162,45.5,4874,1101,3773,34007,2.42830638749,0.1201702685
"Modoc County, California",2012,9545,46.8,5172,1269,3903,37482,2.44555470151,0.132949188057
"Modoc County, California",2015,9184,47.8,5238,1493,3745,37860,2.4523364486,0.16256533101
"Moffat County, Colorado",2009,13555,36.2,6066,691,5375,53723,2.52186046512,0.0509774990778
"Moffat County, Colorado",2012,13547,36.4,6179,936,5243,51008,2.58382605379,0.0690927880712
"Moffat County, Colorado",2015,13117,37.1,6172,1186,4986,51387,2.63076614521,0.090417016086
"Mohave County, Arizona",2009,192988,45.2,100428,25166,75262,40157,2.56421567325,0.130401890273
"Mohave County, Arizona",2012,201216,47.4,110603,30248,80355,39383,2.50408810902,0.150326017812
"Mohave County, Arizona",2015,203362,49.2,111984,31152,80832,38488,2.51586005542,0.153184960809
"Moniteau County, Missouri",2009,15081,36.4,5947,687,5260,47329,2.86711026616,0.0455540083549
"Moniteau County, Missouri",2012,15587,37.4,6155,649,5506,49394,2.83091173266,0.0416372618207
"Moniteau County, Missouri",2015,15801,38,6144,611,5533,47725,2.85577444424,0.0386684387064
"Monmouth County, New Jersey",2009,641984,40.3,254886,23829,231057,82013,2.77846591966,0.0371177474828
"Monmouth County, New Jersey",2012,629263,41.4,258480,24819,233661,84746,2.69305960344,0.0394413782473
"Monmouth County, New Jersey",2015,629185,42.3,259823,26718,233105,85242,2.69914845241,0.0424644579893
"Mono County, California",2009,12925,38.3,13381,8367,5014,51970,2.57778220981,0.647350096712
"Mono County, California",2012,14181,37.1,13888,8832,5056,61868,2.80478639241,0.622805161836
"Mono County, California",2015,14146,38.5,13982,9076,4906,56944,2.88340807175,0.641594797116
"Monona County, Iowa",2009,9118,46.6,4743,404,4339,38670,2.10140585388,0.0443079622724
"Monona County, Iowa",2012,9242,46.8,4712,647,4065,42832,2.27355473555,0.0700064921013
"Monona County, Iowa",2015,9088,47,4719,676,4043,40302,2.24783576552,0.0743838028169
"Monongalia County, West Virginia",2009,87864,29.1,38270,6609,31661,37544,2.77514923723,0.0752185195302
"Monongalia County, West Virginia",2012,96417,29.3,43091,7314,35777,41326,2.6949436789,0.0758579918479
"Monongalia County, West Virginia",2015,101668,30,44167,7132,37035,45467,2.74518698528,0.0701498996734
"Monroe County, Alabama",2009,22790,38.9,11746,2244,9502,29810,2.39844243317,0.0984642387012
"Monroe County, Alabama",2012,22993,40,11339,2632,8707,30996,2.64074882279,0.114469621189
"Monroe County, Alabama",2015,22217,41.1,11296,2890,8406,27257,2.64299310017,0.130080568934
"Monroe County, Arkansas",2009,8606,43.2,5271,1532,3739,29607,2.3016849425,0.178015338136
"Monroe County, Arkansas",2012,8145,43.5,4499,1103,3396,28075,2.39840989399,0.135420503376
"Monroe County, Arkansas",2015,7713,45.2,4437,1073,3364,27647,2.29280618312,0.139115778556
"Monroe County, Florida",2009,74024,45.4,53852,23021,30831,54946,2.40096007265,0.310993731763
"Monroe County, Florida",2012,73475,46.4,52856,24098,28758,53418,2.55494123374,0.327975501871
"Monroe County, Florida",2015,75901,46.8,52913,24003,28910,57290,2.62542372881,0.316240892742
"Monroe County, Georgia",2009,24728,39,10061,817,9244,50579,2.67503245348,0.0330394694274
"Monroe County, Georgia",2012,26376,40.7,10698,1121,9577,47323,2.75409836066,0.0425007582651
"Monroe County, Georgia",2015,26915,41.9,10900,1319,9581,48744,2.80920571965,0.0490061304106
"Monroe County, Illinois",2009,32358,39.3,12698,730,11968,66850,2.70370989305,0.022560108783
"Monroe County, Illinois",2012,33003,40.5,13396,939,12457,71033,2.64935377699,0.0284519589128
"Monroe County, Illinois",2015,33539,42.1,13678,979,12699,70859,2.64107410032,0.0291898983273
"Monroe County, Indiana",2009,127855,27,56916,7534,49382,38124,2.58910129197,0.0589261272535
"Monroe County, Indiana",2012,138048,27.8,59018,5124,53894,38675,2.56147252013,0.0371175243394
"Monroe County, Indiana",2015,142404,28.4,59808,5643,54165,42404,2.62907781778,0.0396266958793
"Monroe County, Iowa",2009,7612,43.4,3636,399,3237,39632,2.3515600865,0.0524172359432
"Monroe County, Iowa",2012,7979,43.3,3869,495,3374,45266,2.3648488441,0.0620378493546
"Monroe County, Iowa",2015,8002,43.2,3896,570,3326,46304,2.40589296452,0.071232191952
"Monroe County, Kentucky",2009,11650,40.4,5541,863,4678,28871,2.49038050449,0.0740772532189
"Monroe County, Kentucky",2012,10925,42.1,5216,775,4441,27586,2.46003152443,0.070938215103
"Monroe County, Kentucky",2015,10765,42.7,5208,765,4443,31045,2.42291244655,0.0710636321412
"Monroe County, Michigan",2009,152899,38.9,63192,4506,58686,56855,2.60537436527,0.0294704347314
"Monroe County, Michigan",2012,151944,40.3,62979,4687,58292,54588,2.60660124888,0.0308468909598
"Monroe County, Michigan",2015,150436,41.7,63403,4837,58566,55653,2.5686575829,0.0321532080087
"Monroe County, Mississippi",2009,37089,38.5,16868,1535,15333,33116,2.41890041088,0.0413869341314
"Monroe County, Mississippi",2012,36912,39.2,16487,2094,14393,35370,2.56458000417,0.0567295188557
"Monroe County, Mississippi",2015,36175,40.6,16449,2513,13936,36783,2.59579506315,0.0694678645473
"Monroe County, Missouri",2009,9141,43.3,4897,924,3973,39262,2.3007802668,0.101083032491
"Monroe County, Missouri",2012,8876,44,4796,1246,3550,40707,2.50028169014,0.140378548896
"Monroe County, Missouri",2015,8680,44.8,4810,1297,3513,43138,2.4708226587,0.149423963134
"Monroe County, New York",2009,731621,38.2,313630,27303,286327,51105,2.55519388671,0.0373185023393
"Monroe County, New York",2012,744746,38.4,320238,25512,294726,52700,2.52690973989,0.0342559745202
"Monroe County, New York",2015,749356,38.5,323313,23549,299764,52553,2.49981985829,0.0314256508255
"Monroe County, Ohio",2009,14276,44.2,7270,1298,5972,34621,2.39048894843,0.0909218268423
"Monroe County, Ohio",2012,14679,45,7552,1481,6071,41677,2.41788832153,0.100892431365
"Monroe County, Ohio",2015,14547,45.6,7501,1445,6056,41528,2.40208058124,0.0993331958479
"Monroe County, Pennsylvania",2009,163925,38.9,78038,18541,59497,57228,2.75518093349,0.11310660363
"Monroe County, Pennsylvania",2012,169346,40,80326,21027,59299,57773,2.85579858008,0.124165908849
"Monroe County, Pennsylvania",2015,167881,41.8,80632,23335,57297,57365,2.93001378781,0.138997265921
"Monroe County, Tennessee",2009,44602,39,18889,2750,16139,36308,2.76361608526,0.0616564279629
"Monroe County, Tennessee",2012,44680,41.5,20697,3288,17409,36430,2.56648859785,0.0735899731423
"Monroe County, Tennessee",2015,45293,43,20831,3638,17193,35291,2.63438608736,0.0803214624776
"Monroe County, West Virginia",2009,13606,43.5,7586,2052,5534,38706,2.45861944344,0.150815816552
"Monroe County, West Virginia",2012,13528,44.9,7603,1989,5614,39877,2.40969006056,0.147028385571
"Monroe County, West Virginia",2015,13525,46.6,7560,1738,5822,36918,2.32308485057,0.128502772643
"Monroe County, Wisconsin",2009,43016,38,18878,1470,17408,47243,2.47104779412,0.0341733308536
"Monroe County, Wisconsin",2012,44714,38.7,19248,1804,17444,48768,2.56328823664,0.0403453057208
"Monroe County, Wisconsin",2015,45274,39.3,19505,1711,17794,50694,2.54434078903,0.037792110262
"Montague County, Texas",2009,19557,42.6,10282,2223,8059,41677,2.42672788187,0.113667740451
"Montague County, Texas",2012,19737,42.6,10130,2072,8058,45287,2.44936708861,0.104980493489
"Montague County, Texas",2015,19478,43.6,10140,2116,8024,46172,2.42746759721,0.10863538351
"Montcalm County, Michigan",2009,62913,37.9,27600,4767,22833,41082,2.75535409276,0.0757713032283
"Montcalm County, Michigan",2012,63357,39,28183,4822,23361,40707,2.71208424297,0.0761084015973
"Montcalm County, Michigan",2015,63004,40,28127,4843,23284,41584,2.70589245834,0.0768681353565
"Monterey County, California",2009,404922,32.5,139331,13971,125360,59693,3.23007338864,0.0345029413072
"Monterey County, California",2012,416199,32.9,139086,13963,125123,60143,3.3263189022,0.0335488552351
"Monterey County, California",2015,428441,33.5,139794,14392,125402,58783,3.41654040605,0.0335915563637
"Montezuma County, Colorado",2009,25000,41.4,11150,1036,10114,43697,2.47182123789,0.04144
"Montezuma County, Colorado",2012,25424,42.8,12040,1157,10883,44102,2.33612055499,0.0455081812461
"Montezuma County, Colorado",2015,25700,43.4,12002,1585,10417,43553,2.46712105213,0.061673151751
"Montgomery County, Alabama",2009,224369,33.8,102059,12470,89589,43015,2.50442576656,0.055578087882
"Montgomery County, Alabama",2012,229376,34.7,101956,13207,88749,44401,2.58454743152,0.0575779506138
"Montgomery County, Alabama",2015,228138,35.2,103070,13538,89532,44369,2.54811687441,0.0593412758944
"Montgomery County, Arkansas",2009,9064,45.3,5338,1742,3596,36095,2.52057842047,0.192188879082
"Montgomery County, Arkansas",2012,9453,46.4,5740,1943,3797,33240,2.4895970503,0.205543213795
"Montgomery County, Arkansas",2015,9197,48.5,5746,1854,3892,33037,2.36305241521,0.201587474176
"Montgomery County, Georgia",2009,8939,33,3817,530,3287,33970,2.7195010648,0.0592907484059
"Montgomery County, Georgia",2012,9054,36.8,3903,632,3271,33569,2.76796086824,0.0698034018114
"Montgomery County, Georgia",2015,8968,38,3892,752,3140,34672,2.85605095541,0.0838537020517
"Montgomery County, Illinois",2009,29782,40.9,12732,1225,11507,39514,2.58816372643,0.04113222752
"Montgomery County, Illinois",2012,29977,41.8,12860,1313,11547,42261,2.59608556335,0.0438002468559
"Montgomery County, Illinois",2015,29348,42.2,12758,1773,10985,46966,2.67164314975,0.0604129753305
"Montgomery County, Indiana",2009,37828,38.8,16551,1801,14750,48572,2.56461016949,0.0476102358042
"Montgomery County, Indiana",2012,38207,39.5,16537,1926,14611,46026,2.61494764219,0.0504096108043
"Montgomery County, Indiana",2015,38172,40.2,16527,1890,14637,48213,2.60791145727,0.0495127318453
"Montgomery County, Iowa",2009,10968,43.5,5407,691,4716,37917,2.32569974555,0.0630014587892
"Montgomery County, Iowa",2012,10710,45.2,5252,643,4609,40530,2.32371447169,0.0600373482726
"Montgomery County, Iowa",2015,10465,45.1,5207,597,4610,42418,2.27006507592,0.0570473005256
"Montgomery County, Kansas",2009,34282,40.9,17322,2380,14942,37927,2.29433810735,0.0694241876203
"Montgomery County, Kansas",2012,35167,39.7,16595,2464,14131,41073,2.48864199278,0.0700656865812
"Montgomery County, Kansas",2015,34184,39.4,16474,3039,13435,41083,2.54439895795,0.0889012403464
"Montgomery County, Kentucky",2009,25093,37.1,11020,1275,9745,34315,2.57496151873,0.0508109831427
"Montgomery County, Kentucky",2012,26517,37.3,11671,1578,10093,35832,2.62726642227,0.0595089942301
"Montgomery County, Kentucky",2015,27167,38.8,11723,1475,10248,39275,2.65095628415,0.0542938123459
"Montgomery County, Maryland",2009,946172,38,361760,17661,344099,92213,2.74970865943,0.0186657394216
"Montgomery County, Maryland",2012,974824,38.4,375973,18394,357579,96985,2.72617799144,0.0188690471306
"Montgomery County, Maryland",2015,1017859,38.5,382913,17678,365235,99435,2.78686051446,0.0173678279605
"Montgomery County, Mississippi",2009,11412,39.9,6093,1162,4931,29243,2.3143378625,0.101822642832
"Montgomery County, Mississippi",2012,10866,41.1,5256,1040,4216,30440,2.57732447818,0.095711393337
"Montgomery County, Mississippi",2015,10464,41.7,5355,1094,4261,30146,2.45576155832,0.104548929664
"Montgomery County, Missouri",2009,11884,42.7,6202,1235,4967,39511,2.39259110127,0.10392123864
"Montgomery County, Missouri",2012,12181,42.9,6135,1063,5072,40565,2.40161671924,0.08726705525
"Montgomery County, Missouri",2015,11939,43.7,6142,1268,4874,39830,2.44952810833,0.106206549962
"Montgomery County, New York",2009,48632,41.2,22630,2773,19857,42716,2.44911114468,0.0570200690903
"Montgomery County, New York",2012,50025,40.9,23079,3181,19898,42830,2.51407176601,0.0635882058971
"Montgomery County, New York",2015,49779,41,23184,3645,19539,43764,2.547673883,0.0732236485265
"Montgomery County, North Carolina",2009,27456,38.4,14886,5256,9630,33223,2.85109034268,0.191433566434
"Montgomery County, North Carolina",2012,27741,39.7,15847,5781,10066,32798,2.75591098748,0.20839191089
"Montgomery County, North Carolina",2015,27601,41.1,15994,5406,10588,32500,2.60681904042,0.195862468751
"Montgomery County, Ohio",2009,538299,38.2,254431,30572,223859,43815,2.40463416704,0.0567937150171
"Montgomery County, Ohio",2012,535626,39.2,254637,31745,222892,43895,2.40307413456,0.0592671005515
"Montgomery County, Ohio",2015,533763,39.4,254415,31728,222687,43829,2.39692034111,0.0594421119486
"Montgomery County, Pennsylvania",2009,776306,39.9,313224,14898,298326,75728,2.60220698162,0.0191908860681
"Montgomery County, Pennsylvania",2012,799886,40.6,325269,17186,308083,78984,2.59633280642,0.0214855616925
"Montgomery County, Pennsylvania",2015,812970,41.1,327146,18520,308626,80675,2.63415914408,0.0227806684133
"Montgomery County, Tennessee",2009,153491,30.7,65736,6793,58943,48794,2.60405815788,0.0442566665146
"Montgomery County, Tennessee",2012,173138,30.2,70694,7632,63062,49459,2.74552028163,0.0440804445009
"Montgomery County, Tennessee",2015,185980,30.3,75280,9046,66234,50344,2.80792342302,0.0486396386708
"Montgomery County, Texas",2009,411726,35.4,155158,15900,139258,64971,2.95656982005,0.0386179157984
"Montgomery County, Texas",2012,458339,36.2,177759,17569,160190,66422,2.86122105,0.0383318897148
"Montgomery County, Texas",2015,502586,36.4,190571,17333,173238,68838,2.90113023701,0.0344876299778
"Montgomery County, Virginia",2009,89109,24.4,36179,3352,32827,41815,2.71450330521,0.037616851272
"Montgomery County, Virginia",2012,94179,26.5,38396,3657,34739,44166,2.71104522295,0.03883031249
"Montgomery County, Virginia",2015,96467,27.5,39038,3839,35199,46663,2.74061763118,0.0397959924119
"Montmorency County, Michigan",2009,10237,51.5,9771,5324,4447,34409,2.30200134922,0.5200742405
"Montmorency County, Michigan",2012,9709,52.3,9605,5293,4312,34955,2.25162337662,0.545164280564
"Montmorency County, Michigan",2015,9401,54.6,9554,5484,4070,36250,2.30982800983,0.583342197639
"Montour County, Pennsylvania",2009,17776,43,8011,606,7405,47765,2.40054017556,0.0340909090909
"Montour County, Pennsylvania",2012,18243,43.7,7978,710,7268,49845,2.51004402862,0.038919037439
"Montour County, Pennsylvania",2015,18508,42.9,8027,647,7380,54648,2.50785907859,0.0349578560622
"Montrose County, Colorado",2009,39303,41.3,17161,1521,15640,44922,2.51297953964,0.0386993359286
"Montrose County, Colorado",2012,40994,42.6,18178,1446,16732,47139,2.45003585943,0.0352734546519
"Montrose County, Colorado",2015,40815,44.2,18302,1534,16768,43999,2.43410066794,0.0375842214872
"Moody County, South Dakota",2009,6460,40.3,2858,227,2631,51336,2.45534017484,0.0351393188854
"Moody County, South Dakota",2012,6474,40.3,2823,179,2644,50949,2.44856278366,0.0276490577695
"Moody County, South Dakota",2015,6439,40.7,2824,143,2681,52446,2.40171577769,0.0222084174561
"Moore County, North Carolina",2009,84280,44.1,40689,8589,32100,46940,2.62554517134,0.101910299003
"Moore County, North Carolina",2012,88314,45.1,43890,7417,36473,48238,2.42135278151,0.0839844192314
"Moore County, North Carolina",2015,91743,45.1,44881,7738,37143,50998,2.46999434618,0.0843443096476
"Moore County, Tennessee",2009,6044,42.2,2899,574,2325,47216,2.59956989247,0.0949702183984
"Moore County, Tennessee",2012,6349,43.2,2918,525,2393,44977,2.65315503552,0.0826901874311
"Moore County, Tennessee",2015,6351,45.5,2952,498,2454,49427,2.5880195599,0.0784128483703
"Moore County, Texas",2009,20106,30.9,7747,1052,6695,41862,3.00313666916,0.0523226897444
"Moore County, Texas",2012,21765,30.8,7871,1072,6799,48489,3.20120605971,0.0492533884677
"Moore County, Texas",2015,22281,31.1,7951,1058,6893,49802,3.23240969099,0.0474844037521
"Mora County, New Mexico",2009,5020,44.1,3282,1146,2136,33622,2.35018726592,0.22828685259
"Mora County, New Mexico",2012,4830,46.3,3304,1604,1700,40000,2.84117647059,0.332091097308
"Mora County, New Mexico",2015,4660,42.6,3247,1593,1654,23822,2.81741233374,0.341845493562
"Morehouse Parish, Louisiana",2009,28761,37.7,13269,2553,10716,31264,2.68393057111,0.0887660373422
"Morehouse Parish, Louisiana",2012,27893,38.1,12479,2135,10344,31447,2.69653905646,0.0765425017029
"Morehouse Parish, Louisiana",2015,27012,39.3,12494,2047,10447,28003,2.58562266679,0.0757811343107
"Morgan County, Alabama",2009,115197,38.5,50268,4068,46200,42913,2.49344155844,0.0353134196203
"Morgan County, Alabama",2012,119330,38.7,51180,5122,46058,45852,2.5908636936,0.0429229866756
"Morgan County, Alabama",2015,119786,39.5,51411,5176,46235,45751,2.59080782957,0.0432103918655
"Morgan County, Colorado",2009,27630,36.1,11199,1050,10149,43317,2.72243570795,0.0380021715527
"Morgan County, Colorado",2012,28200,36,11459,970,10489,42829,2.68853084183,0.0343971631206
"Morgan County, Colorado",2015,28359,36.4,11452,1031,10421,48450,2.72133192592,0.0363553016679
"Morgan County, Georgia",2009,18120,39.4,7525,826,6699,44845,2.70488132557,0.0455849889625
"Morgan County, Georgia",2012,17919,41.3,7499,961,6538,44908,2.74074640563,0.0536302249009
"Morgan County, Georgia",2015,17900,43.2,7499,1081,6418,51820,2.78903085073,0.0603910614525
"Morgan County, Illinois",2009,35300,39.6,15686,1669,14017,44539,2.51837055005,0.0472804532578
"Morgan County, Illinois",2012,35544,40.9,15504,1585,13919,46763,2.55363172642,0.0445926176007
"Morgan County, Illinois",2015,35129,41,15449,1624,13825,45978,2.54097649186,0.0462296108628
"Morgan County, Indiana",2009,70179,38.7,28657,3006,25651,54926,2.73591672839,0.0428333262087
"Morgan County, Indiana",2012,69033,39.9,27820,2102,25718,56303,2.68422894471,0.0304492054525
"Morgan County, Indiana",2015,69403,40.9,27914,2305,25609,55432,2.71010191729,0.0332118208147
"Morgan County, Kentucky",2009,14204,37.8,5839,1405,4434,31322,3.20342805593,0.0989157983667
"Morgan County, Kentucky",2012,13898,38.6,5831,1165,4666,29154,2.97856836691,0.0838250107929
"Morgan County, Kentucky",2015,13428,40.7,5849,1041,4808,29707,2.7928452579,0.0775245755139
"Morgan County, Missouri",2009,20608,44.5,14517,6539,7978,36267,2.58310353472,0.317303959627
"Morgan County, Missouri",2012,20479,47,15461,7218,8243,35446,2.48441101541,0.352458616143
"Morgan County, Missouri",2015,20225,46.5,15421,7609,7812,33525,2.5889656938,0.376217552534
"Morgan County, Ohio",2009,14495,42.7,8084,1878,6206,33601,2.3356429262,0.129561917903
"Morgan County, Ohio",2012,15042,43.2,7886,1615,6271,37152,2.39866050072,0.10736604175
"Morgan County, Ohio",2015,14913,43.9,7849,1729,6120,37067,2.43676470588,0.115939113525
"Morgan County, Tennessee",2009,19294,39.6,8143,628,7515,32928,2.56739853626,0.0325489789572
"Morgan County, Tennessee",2012,21882,40,8860,1214,7646,37522,2.86188856919,0.0554793894525
"Morgan County, Tennessee",2015,21794,40.8,8902,1532,7370,39049,2.95712347354,0.0702945764889
"Morgan County, Utah",2009,8381,32.4,2799,180,2619,70043,3.20007636502,0.021477150698
"Morgan County, Utah",2012,9485,31.9,3013,209,2804,77159,3.38266761769,0.0220347917765
"Morgan County, Utah",2015,10276,32.3,3200,176,3024,74314,3.39814814815,0.0171272868821
"Morgan County, West Virginia",2009,16303,43.1,9454,2597,6857,39040,2.37757036605,0.159295835122
"Morgan County, West Virginia",2012,17507,44.9,9743,2437,7306,35350,2.39624965782,0.139201462272
"Morgan County, West Virginia",2015,17475,46.1,9820,2472,7348,39324,2.37819814916,0.141459227468
"Morovis Municipio, Puerto Rico",2009,32630,30.5,9799,1099,8700,12960,3.75057471264,0.0336806619675
"Morovis Municipio, Puerto Rico",2012,32617,33.3,10662,1524,9138,14596,3.56938060845,0.046724100929
"Morovis Municipio, Puerto Rico",2015,32294,35.2,11612,1824,9788,16536,3.29934613813,0.0564810800768
"Morrill County, Nebraska",2009,4980,41,2492,342,2150,36986,2.31627906977,0.0686746987952
"Morrill County, Nebraska",2012,4993,43.1,2443,359,2084,42025,2.39587332054,0.0719006609253
"Morrill County, Nebraska",2015,4874,41.3,2421,440,1981,45910,2.46037354871,0.0902749281904
"Morris County, Kansas",2009,5966,45.6,3256,573,2683,39020,2.22363026463,0.0960442507543
"Morris County, Kansas",2012,5917,47.3,3207,701,2506,45000,2.36113328013,0.118472198749
"Morris County, Kansas",2015,5750,47.6,3195,789,2406,47089,2.38985868662,0.137217391304
"Morris County, New Jersey",2009,485828,40.1,184220,9280,174940,96316,2.77711215274,0.0191014103757
"Morris County, New Jersey",2012,493472,41.2,189821,10109,179712,97979,2.7459045584,0.0204854581415
"Morris County, New Jersey",2015,498192,42,190765,10672,180093,100214,2.76630407623,0.0214214599994
"Morris County, Texas",2009,12852,42.2,6205,1022,5183,37173,2.47964499325,0.0795206971678
"Morris County, Texas",2012,12914,43,6042,1014,5028,39122,2.56841686555,0.0785194362707
"Morris County, Texas",2015,12700,43.3,6019,1065,4954,39453,2.56358498183,0.0838582677165
"Morrison County, Minnesota",2009,32717,39.6,15771,2192,13579,48582,2.40938213418,0.0669988079592
"Morrison County, Minnesota",2012,33173,40.6,15725,2161,13564,47110,2.44566499558,0.0651433394628
"Morrison County, Minnesota",2015,32962,41.2,15811,2459,13352,50049,2.46869382864,0.0746010557612
"Morrow County, Ohio",2009,34435,38.2,13157,923,12234,48907,2.81469674677,0.0268041237113
"Morrow County, Ohio",2012,34895,39.6,14115,1080,13035,51534,2.67702339854,0.0309499928356
"Morrow County, Ohio",2015,34996,41.2,14123,1423,12700,51993,2.75559055118,0.0406617899188
"Morrow County, Oregon",2009,11394,36,4455,614,3841,43581,2.96641499609,0.053888011234
"Morrow County, Oregon",2012,11146,36.6,4448,657,3791,48457,2.94012134002,0.0589449129733
"Morrow County, Oregon",2015,11204,37.4,4449,677,3772,50918,2.97030752916,0.0604248482685
"Morton County, Kansas",2009,3097,36.5,1491,224,1267,41011,2.44435674822,0.0723280594123
"Morton County, Kansas",2012,3207,39.4,1473,254,1219,44198,2.63084495488,0.0792017461802
"Morton County, Kansas",2015,3106,41.6,1458,269,1189,46028,2.61227922624,0.086606567933
"Morton County, North Dakota",2009,25850,39.6,11728,1150,10578,48791,2.4437511817,0.0444874274662
"Morton County, North Dakota",2012,27439,39.9,12166,994,11172,57988,2.45605084139,0.0362258099785
"Morton County, North Dakota",2015,28985,38.9,13268,960,12308,62418,2.35497237569,0.0331205796101
"Motley County, Texas",2009,1175,44.2,834,352,482,33250,2.4377593361,0.299574468085
"Motley County, Texas",2012,1153,43,766,309,457,35313,2.52297592998,0.267996530789
"Motley County, Texas",2015,1071,44.3,745,300,445,31683,2.40674157303,0.280112044818
"Moultrie County, Illinois",2009,14344,41.4,6037,524,5513,45385,2.60185017232,0.0365309537089
"Moultrie County, Illinois",2012,14844,41,6260,645,5615,50005,2.64363312556,0.0434518997575
"Moultrie County, Illinois",2015,14927,41,6325,526,5799,49681,2.57406449388,0.0352381590407
"Mountrail County, North Dakota",2009,6540,39.7,3537,978,2559,46821,2.55568581477,0.149541284404
"Mountrail County, North Dakota",2012,7830,36.9,4140,1087,3053,65822,2.56469046839,0.138825031928
"Mountrail County, North Dakota",2015,9253,34.8,4576,1370,3206,68188,2.88615096694,0.14806008862
"Mower County, Minnesota",2009,38119,39.6,17009,1015,15994,45274,2.38333124922,0.0266271413206
"Mower County, Minnesota",2012,39115,38.6,17022,1032,15990,46239,2.44621638524,0.0263837402531
"Mower County, Minnesota",2015,39227,39,16991,1566,15425,49427,2.54307941653,0.0399214826523
"Muhlenberg County, Kentucky",2009,31378,39.7,14284,1305,12979,35617,2.41759765775,0.0415896487985
"Muhlenberg County, Kentucky",2012,31399,41,13722,1748,11974,38835,2.6222649073,0.0556705627568
"Muhlenberg County, Kentucky",2015,31309,41.5,13665,2126,11539,38961,2.71332004506,0.0679037976301
"Multnomah County, Oregon",2009,698599,35.4,310409,20329,290080,49171,2.40829771098,0.0290996694813
"Multnomah County, Oregon",2012,737110,35.9,324192,20538,303654,51582,2.42746678786,0.0278628698566
"Multnomah County, Oregon",2015,768418,36.5,329504,18835,310669,54102,2.47342992059,0.0245113987439
"Murray County, Georgia",2009,40535,34.5,16076,1790,14286,38348,2.83739325213,0.044159368447
"Murray County, Georgia",2012,39635,36.5,15978,1676,14302,36928,2.77129072857,0.0422858584584
"Murray County, Georgia",2015,39401,37.2,15818,1582,14236,35539,2.76770160157,0.0401512651963
"Murray County, Minnesota",2009,8529,46.3,4226,630,3596,45260,2.37180200222,0.0738656348927
"Murray County, Minnesota",2012,8690,47,4550,689,3861,50039,2.25071225071,0.0792865362486
"Murray County, Minnesota",2015,8529,47.6,4578,841,3737,51983,2.28231201499,0.0986047602298
"Murray County, Oklahoma",2009,12729,39.1,6742,1410,5332,39989,2.38728432108,0.110770681122
"Murray County, Oklahoma",2012,13460,41.4,6750,1688,5062,43781,2.65902805215,0.125408618128
"Murray County, Oklahoma",2015,13733,41.3,6774,1431,5343,47077,2.57027886955,0.10420155829
"Muscatine County, Iowa",2009,42448,37.6,17868,1365,16503,50188,2.57213839908,0.0321569920844
"Muscatine County, Iowa",2012,42729,38,17927,1387,16540,51675,2.58337363966,0.0324603898991
"Muscatine County, Iowa",2015,42913,38.2,17955,1610,16345,53676,2.62545120832,0.0375177685084
"Muscogee County, Georgia",2009,188737,32.5,82780,10149,72631,40549,2.59857361182,0.0537732400112
"Muscogee County, Georgia",2012,191278,33.4,82770,10588,72182,41443,2.64994042836,0.0553539873901
"Muscogee County, Georgia",2015,200285,33.5,83503,10743,72760,42306,2.75268004398,0.0536385650448
"Muskegon County, Michigan",2009,174156,37.1,73361,7707,65654,41800,2.65263350291,0.0442534279611
"Muskegon County, Michigan",2012,171755,38.5,73539,8292,65247,40843,2.63238156544,0.0482780705074
"Muskegon County, Michigan",2015,171483,39.1,73354,8864,64490,42829,2.65906342069,0.0516902550107
"Muskingum County, Ohio",2009,85099,38.8,35643,3238,32405,39582,2.62610708224,0.0380498008202
"Muskingum County, Ohio",2012,85996,39.6,37887,3901,33986,40398,2.53033602071,0.0453625750035
"Muskingum County, Ohio",2015,86016,40.3,37854,3593,34261,41130,2.51060973118,0.0417712983631
"Muskogee County, Oklahoma",2009,70698,37.5,30974,4122,26852,35169,2.63287650827,0.0583043367563
"Muskogee County, Oklahoma",2012,70635,38,30937,3886,27051,37748,2.61117888433,0.055015219084
"Muskogee County, Oklahoma",2015,70224,37.8,30920,4571,26349,39984,2.66514858249,0.0650917065391
"Musselshell County, Montana",2009,4413,48,2335,541,1794,33000,2.45986622074,0.122592340811
"Musselshell County, Montana",2012,4597,48.2,2617,646,1971,43079,2.33231861999,0.140526430281
"Musselshell County, Montana",2015,4790,48.5,2708,757,1951,39517,2.45515120451,0.158037578288
"Nacogdoches County, Texas",2009,62608,27.7,26796,4129,22667,32487,2.76207702828,0.0659500383338
"Nacogdoches County, Texas",2012,64647,29.7,27467,4220,23247,35641,2.78087495161,0.06527758442
"Nacogdoches County, Texas",2015,65531,30.2,27858,3970,23888,39538,2.74326021433,0.060582014619
"Naguabo Municipio, Puerto Rico",2009,24279,33.5,9549,1564,7985,15493,3.04057608015,0.0644178096297
"Naguabo Municipio, Puerto Rico",2012,26761,34.2,10400,1947,8453,16706,3.16585827517,0.0727551287321
"Naguabo Municipio, Puerto Rico",2015,26804,36.1,11555,2758,8797,18704,3.04694782312,0.102895090285
"Nance County, Nebraska",2009,3552,45.2,1656,250,1406,40729,2.52631578947,0.0703828828829
"Nance County, Nebraska",2012,3730,44.9,1809,263,1546,40714,2.4126778784,0.070509383378
"Nance County, Nebraska",2015,3639,45.9,1824,276,1548,42500,2.3507751938,0.075845012366
"Nantucket County, Massachusetts",2009,11013,37.7,10470,6977,3493,80020,3.15287718294,0.633524017071
"Nantucket County, Massachusetts",2012,10194,38.8,11571,7629,3942,83546,2.58599695586,0.748381400824
"Nantucket County, Massachusetts",2015,10556,39.5,11763,7840,3923,84057,2.69079785878,0.742705570292
"Napa County, California",2009,132173,39.3,53041,4947,48094,68416,2.74822223146,0.0374282190765
"Napa County, California",2012,136644,39.6,54639,5430,49209,69571,2.77680912028,0.0397382980592
"Napa County, California",2015,140295,40.3,55180,5686,49494,71379,2.83458601043,0.0405288855626
"Naranjito Municipio, Puerto Rico",2009,29946,33.3,9408,1187,8221,14270,3.642622552,0.0396380150938
"Naranjito Municipio, Puerto Rico",2012,30385,35.2,9873,1739,8134,16007,3.73555446275,0.0572321869343
"Naranjito Municipio, Puerto Rico",2015,29751,37,10676,2044,8632,17423,3.44659406858,0.0687035729891
"Nash County, North Carolina",2009,92814,39,41053,4451,36602,42909,2.53576307306,0.0479561273084
"Nash County, North Carolina",2012,95545,40.3,42258,4622,37636,43757,2.53865979381,0.0483751112041
"Nash County, North Carolina",2015,94722,41,42387,5676,36711,42713,2.58020756721,0.0599227212263
"Nassau County, Florida",2009,67977,41.6,32615,6530,26085,57907,2.60598044853,0.0960619032908
"Nassau County, Florida",2012,73303,43.1,34950,7487,27463,57163,2.66915486291,0.102137702413
"Nassau County, Florida",2015,75880,44.2,35681,7375,28306,54116,2.68070373772,0.0971929362151
"Nassau County, New York",2009,1354141,40.7,458626,22862,435764,92450,3.10751002836,0.0168830276906
"Nassau County, New York",2012,1338712,41.2,467418,24549,442869,97049,3.02281713103,0.018337775414
"Nassau County, New York",2015,1354612,41.3,467256,26616,440640,99465,3.07419208424,0.0196484306945
"Natchitoches Parish, Louisiana",2009,38976,30.6,18370,3500,14870,28411,2.62111634163,0.0897988505747
"Natchitoches Parish, Louisiana",2012,39434,33.3,18607,3491,15116,32649,2.60875893093,0.0885276664807
"Natchitoches Parish, Louisiana",2015,39330,33.8,18720,4264,14456,31345,2.72066961815,0.108415967455
"Natrona County, Wyoming",2009,71817,36.3,31505,3508,27997,50382,2.56516769654,0.0488463734213
"Natrona County, Wyoming",2012,75876,36.7,33952,3546,30406,55786,2.49542853384,0.0467341451842
"Natrona County, Wyoming",2015,80011,36,35316,3185,32131,56871,2.49014969967,0.0398070265339
"Navajo County, Arizona",2009,110458,32.8,53655,19032,34623,38197,3.19030702134,0.172300784008
"Navajo County, Arizona",2012,107415,34.8,56910,22043,34867,37683,3.0807066854,0.205213424568
"Navajo County, Arizona",2015,107656,35.7,57414,23285,34129,35921,3.15438483401,0.216290778034
"Navarro County, Texas",2009,48847,35.4,19129,2766,16363,39555,2.98521053597,0.0566257907343
"Navarro County, Texas",2012,47739,37.1,20238,2797,17441,41511,2.73717103377,0.058589413268
"Navarro County, Texas",2015,48118,38.2,20431,2954,17477,41505,2.75321851576,0.0613907477451
"Nelson County, Kentucky",2009,42342,36.7,17991,1757,16234,47012,2.60822964149,0.041495441878
"Nelson County, Kentucky",2012,43500,37.5,18118,1570,16548,43722,2.6287164612,0.036091954023
"Nelson County, Kentucky",2015,44564,37.9,18443,1626,16817,49298,2.64993756318,0.0364868503725
"Nelson County, North Dakota",2009,3234,50.4,2019,522,1497,36336,2.16032064128,0.161410018553
"Nelson County, North Dakota",2012,3115,51.4,1933,440,1493,43622,2.086403215,0.141252006421
"Nelson County, North Dakota",2015,3048,52.8,1931,409,1522,51085,2.00262812089,0.134186351706
"Nelson County, Virginia",2009,15204,45.6,9570,3044,6526,44326,2.32975789151,0.200210470929
"Nelson County, Virginia",2012,15000,47.7,9934,3519,6415,48888,2.33826968044,0.2346
"Nelson County, Virginia",2015,14858,48.4,10017,3678,6339,47118,2.34390282379,0.247543410957
"Nemaha County, Kansas",2009,10118,42.5,4451,555,3896,46265,2.59702258727,0.0548527376952
"Nemaha County, Kansas",2012,10170,42.4,4560,514,4046,46901,2.51359367276,0.050540806293
"Nemaha County, Kansas",2015,10159,41.6,4571,332,4239,48653,2.39655579146,0.0326803819274
"Nemaha County, Nebraska",2009,6980,42.8,3549,551,2998,41852,2.32821881254,0.0789398280802
"Nemaha County, Nebraska",2012,7224,41.5,3496,444,3052,41929,2.36697247706,0.0614617940199
"Nemaha County, Nebraska",2015,7168,39.1,3498,621,2877,49656,2.49148418491,0.0866350446429
"Neosho County, Kansas",2009,16153,39.8,7201,770,6431,36226,2.51174000933,0.0476691636229
"Neosho County, Kansas",2012,16501,40.2,7526,889,6637,40829,2.48621365075,0.0538755226956
"Neosho County, Kansas",2015,16423,40,7653,1190,6463,43195,2.54107999381,0.0724593557815
"Neshoba County, Mississippi",2009,29949,35.1,12679,1989,10690,33445,2.80159027128,0.0664129019333
"Neshoba County, Mississippi",2012,29682,35.3,12371,1757,10614,37893,2.79649519503,0.0591941243851
"Neshoba County, Mississippi",2015,29553,35.8,12367,1629,10738,35645,2.75218848948,0.0551213074815
"Ness County, Kansas",2009,2949,48.3,1738,396,1342,42500,2.19746646796,0.134282807731
"Ness County, Kansas",2012,3102,50.9,1738,388,1350,47870,2.29777777778,0.125080593166
"Ness County, Kansas",2015,3077,49.2,1741,358,1383,44904,2.22487346349,0.116347091323
"Nevada County, Arkansas",2009,9324,40,5762,1167,4595,32969,2.02916213275,0.125160875161
"Nevada County, Arkansas",2012,9003,39.6,4618,841,3777,35578,2.38363780778,0.0934133066756
"Nevada County, Arkansas",2015,8793,41.8,4553,1081,3472,30691,2.53254608295,0.12293870124
"Nevada County, California",2009,97063,46.5,49626,10084,39542,58186,2.45468109858,0.103891287102
"Nevada County, California",2012,98521,48,52467,10841,41626,57382,2.36681401047,0.110037453944
"Nevada County, California",2015,98570,49,53017,12024,40993,56521,2.40455687556,0.121984376585
"New Castle County, Delaware",2009,527774,36.3,212163,17026,195137,63160,2.70463315517,0.0322600203875
"New Castle County, Delaware",2012,539665,37,217357,16739,200618,64670,2.69001286026,0.0310173904181
"New Castle County, Delaware",2015,549643,37.5,219421,17153,202268,65476,2.71739968754,0.0312075292508
"New Hanover County, North Carolina",2009,189463,36.9,97235,15079,82156,47644,2.30613710502,0.0795880989956
"New Hanover County, North Carolina",2012,203276,37.4,101402,16219,85183,50420,2.38634469319,0.0797880713906
"New Hanover County, North Carolina",2015,213091,37.8,104141,15738,88403,50088,2.41044987161,0.0738557705393
"New Haven County, Connecticut",2009,843532,38.1,349066,26314,322752,61234,2.61356087646,0.0311950228326
"New Haven County, Connecticut",2012,860995,39.1,361393,31437,329956,62234,2.60942368073,0.0365124071568
"New Haven County, Connecticut",2015,862224,39.8,362351,36323,326028,61640,2.64463174942,0.0421271038616
"New Kent County, Virginia",2009,17137,41.2,6838,404,6434,69478,2.6635063724,0.0235747213631
"New Kent County, Virginia",2012,18460,42,7318,599,6719,70978,2.74743265367,0.0324485373781
"New Kent County, Virginia",2015,19560,43.1,7736,437,7299,73041,2.67981915331,0.0223415132924
"New London County, Connecticut",2009,266183,39.3,116395,11927,104468,65120,2.54798598614,0.0448075196387
"New London County, Connecticut",2012,273723,40.3,120752,13935,106817,68310,2.56254154301,0.0509091307636
"New London County, Connecticut",2015,273185,40.7,121258,14763,106495,66233,2.56523780459,0.0540403023592
"New Madrid County, Missouri",2009,17723,39.8,8956,874,8082,32015,2.19289779757,0.0493144501495
"New Madrid County, Missouri",2012,18780,39.7,8572,1055,7517,35174,2.49833710257,0.0561767838126
"New Madrid County, Missouri",2015,18411,40.5,8529,1282,7247,33630,2.54049951704,0.069632285047
"New York County, New York",2009,1620962,36.6,845057,102571,742486,66818,2.18315496858,0.0632778559892
"New York County, New York",2012,1596735,36.4,846819,108688,738131,68370,2.16321357591,0.0680689031054
"New York County, New York",2015,1629507,36.6,862289,111870,750419,72871,2.17146287607,0.0686526661131
"Newaygo County, Michigan",2009,49114,39.1,24912,5881,19031,43278,2.58073669276,0.119741825142
"Newaygo County, Michigan",2012,48517,40.7,25025,6547,18478,43180,2.62566295054,0.134942391327
"Newaygo County, Michigan",2015,48029,42.4,24972,6633,18339,43693,2.61895414145,0.138104062129
"Newberry County, South Carolina",2009,37992,38.5,17703,3648,14055,41080,2.70309498399,0.0960202147821
"Newberry County, South Carolina",2012,37432,39.9,17887,3711,14176,42005,2.64051918736,0.0991397734559
"Newberry County, South Carolina",2015,37690,40.9,17954,3667,14287,40127,2.63806257437,0.0972937118599
"Newport County, Rhode Island",2009,81693,42.8,40907,6811,34096,65269,2.39597020178,0.0833731164237
"Newport County, Rhode Island",2012,82503,43.5,41724,6995,34729,69826,2.37562267845,0.0847847957044
"Newport County, Rhode Island",2015,82663,43.9,41856,7008,34848,69526,2.37210169881,0.0847779538609
"Newport News city, Virginia",2009,192635,31.9,79655,5426,74229,48124,2.59514475475,0.0281672593246
"Newport News city, Virginia",2012,180831,32.3,76479,7012,69467,50744,2.60312090633,0.0387765372088
"Newport News city, Virginia",2015,181323,32.8,77175,8102,69073,50077,2.62509229366,0.0446826933152
"Newton County, Arkansas",2009,8311,44,4521,994,3527,28166,2.35639353558,0.119600529419
"Newton County, Arkansas",2012,8286,46.6,4662,1102,3560,27790,2.32752808989,0.132995413951
"Newton County, Arkansas",2015,8052,47.7,4679,1369,3310,34536,2.43262839879,0.17001987084
"Newton County, Georgia",2009,94076,32.9,36241,3960,32281,52743,2.91428394412,0.0420936264297
"Newton County, Georgia",2012,100047,34.6,38275,4629,33646,51336,2.97351839743,0.0462682539207
"Newton County, Georgia",2015,102645,35.8,38364,3723,34641,49179,2.9631073006,0.0362706415315
"Newton County, Indiana",2009,13974,41.3,6076,513,5563,53028,2.51195398166,0.0367110347789
"Newton County, Indiana",2012,14199,42.8,6023,685,5338,49816,2.65998501311,0.0482428340024
"Newton County, Indiana",2015,14057,43,6040,639,5401,46895,2.60266617293,0.0454577790425
"Newton County, Mississippi",2009,22403,36.2,9739,1622,8117,35527,2.76000985586,0.0724010177208
"Newton County, Mississippi",2012,21687,37.8,9397,1420,7977,35907,2.71869123731,0.0654770138793
"Newton County, Mississippi",2015,21663,37.7,9373,1362,8011,37045,2.70415678442,0.0628721783686
"Newton County, Missouri",2009,55694,38,23150,2406,20744,41661,2.68482452757,0.0432003447409
"Newton County, Missouri",2012,58314,39.1,24259,2406,21853,42644,2.6684665721,0.041259388826
"Newton County, Missouri",2015,58777,39.7,24340,2244,22096,43290,2.66007422158,0.0381781989554
"Newton County, Texas",2009,13827,40.4,7519,2046,5473,36611,2.52640233875,0.147971360382
"Newton County, Texas",2012,14372,40.4,7160,1975,5185,38574,2.77184185149,0.137419983301
"Newton County, Texas",2015,14231,41.6,7147,2322,4825,38144,2.94943005181,0.16316492165
"Nez Perce County, Idaho",2009,38691,40.2,16844,1007,15837,42919,2.44307634022,0.0260267245613
"Nez Perce County, Idaho",2012,39226,41,17391,1281,16110,45587,2.43488516449,0.0326569112323
"Nez Perce County, Idaho",2015,39779,41.6,17443,1347,16096,48160,2.47135934394,0.0338620880364
"Niagara County, New York",2009,214613,41,98112,10258,87854,45749,2.44283697953,0.0477976637016
"Niagara County, New York",2012,215869,41.8,99065,10523,88542,47736,2.43804070385,0.0487471568405
"Niagara County, New York",2015,214150,42.6,99170,11363,87807,49449,2.43887161616,0.0530609385944
"Nicholas County, Kentucky",2009,6921,38.7,3165,443,2722,36389,2.54261572373,0.0640080913163
"Nicholas County, Kentucky",2012,7092,39.4,3249,518,2731,41832,2.59685097034,0.0730400451213
"Nicholas County, Kentucky",2015,7075,41.8,3254,430,2824,36097,2.50531161473,0.060777385159
"Nicholas County, West Virginia",2009,26084,42.4,12984,2737,10247,38064,2.54552551966,0.104930225426
"Nicholas County, West Virginia",2012,26201,43.9,13058,2692,10366,38780,2.52759019873,0.10274417007
"Nicholas County, West Virginia",2015,25930,43.4,13031,2244,10787,39171,2.40381941226,0.0865406864636
"Nicollet County, Minnesota",2009,31694,33.6,12674,595,12079,55355,2.62389270635,0.0187732693885
"Nicollet County, Minnesota",2012,32689,33.3,12908,745,12163,59490,2.68757707802,0.0227905411606
"Nicollet County, Minnesota",2015,33086,35.7,13131,502,12629,58640,2.61984321799,0.0151725805477
"Niobrara County, Wyoming",2009,2306,45.9,1313,342,971,43580,2.37487126674,0.148308759757
"Niobrara County, Wyoming",2012,2478,44.5,1338,325,1013,39107,2.4461994077,0.131154156578
"Niobrara County, Wyoming",2015,2516,43,1321,276,1045,40398,2.40765550239,0.109697933227
"Noble County, Indiana",2009,47729,35.8,19716,2180,17536,46744,2.72177235401,0.0456745374929
"Noble County, Indiana",2012,47547,37.1,20106,2400,17706,46360,2.68536089461,0.0504763707489
"Noble County, Indiana",2015,47546,37.9,20155,2054,18101,49331,2.62670570687,0.043200269213
"Noble County, Ohio",2009,14242,35.7,5691,1079,4612,42961,3.0880312229,0.0757618312035
"Noble County, Ohio",2012,14643,44.5,6020,1216,4804,39544,3.04808492923,0.0830430922625
"Noble County, Ohio",2015,14508,50.2,6036,1150,4886,41708,2.96930004093,0.0792666115247
"Noble County, Oklahoma",2009,11011,39.4,5212,681,4531,37609,2.43014787023,0.0618472436654
"Noble County, Oklahoma",2012,11540,40.1,5339,703,4636,43980,2.48921484038,0.0609185441941
"Noble County, Oklahoma",2015,11506,40.7,5329,659,4670,48285,2.46381156317,0.0572744654963
"Nobles County, Minnesota",2009,20278,38.7,8592,433,8159,42042,2.48535359725,0.02135319065
"Nobles County, Minnesota",2012,21349,36.7,8534,597,7937,47539,2.68980723195,0.0279638390557
"Nobles County, Minnesota",2015,21687,36.6,8569,727,7842,50625,2.76549349656,0.0335223866833
"Nodaway County, Missouri",2009,22058,28.1,9517,1198,8319,36510,2.65152061546,0.0543113609575
"Nodaway County, Missouri",2012,23305,28.1,9535,900,8635,37815,2.69889982629,0.0386183222484
"Nodaway County, Missouri",2015,23186,28.3,9614,955,8659,35854,2.67767640605,0.0411886483223
"Nolan County, Texas",2009,14719,37.7,7116,1171,5945,37481,2.47586206897,0.0795570351247
"Nolan County, Texas",2012,15104,38.2,7147,1438,5709,37671,2.64564722368,0.0952065677966
"Nolan County, Texas",2015,15061,37.9,7123,1524,5599,37102,2.68994463297,0.1011885001
"Nome Census Area, Alaska",2009,9339,27.1,3686,1106,2580,55766,3.61976744186,0.118428097227
"Nome Census Area, Alaska",2012,9580,28,3979,1207,2772,51472,3.45598845599,0.125991649269
"Nome Census Area, Alaska",2015,9854,27.8,4025,1100,2925,48868,3.36888888889,0.111629795007
"Norfolk County, Massachusetts",2009,657506,40.1,264383,12217,252166,80127,2.60743319877,0.0185808190344
"Norfolk County, Massachusetts",2012,672078,40.6,270235,13097,257138,84087,2.61368603629,0.0194873214121
"Norfolk County, Massachusetts",2015,687721,40.9,272397,12852,259545,88262,2.64971777534,0.0186878109001
"Norfolk city, Virginia",2009,236071,29.2,95398,10071,85327,41739,2.76666236947,0.0426608943919
"Norfolk city, Virginia",2012,243056,29.6,95093,9846,85247,44164,2.85119710958,0.0405091830689
"Norfolk city, Virginia",2015,245452,30,96121,9076,87045,44480,2.81982882417,0.0369766797582
"Norman County, Minnesota",2009,6629,45.1,3499,561,2938,39709,2.25629680054,0.0846281490421
"Norman County, Minnesota",2012,6796,45.1,3422,640,2782,45000,2.44284687275,0.0941730429665
"Norman County, Minnesota",2015,6692,45.4,3409,681,2728,50377,2.45307917889,0.101763299462
"North Slope Borough, Alaska",2009,6716,26,2708,659,2049,66556,3.27769643729,0.0981238832638
"North Slope Borough, Alaska",2012,9317,34.2,2527,536,1991,76679,4.67955801105,0.0575292476119
"North Slope Borough, Alaska",2015,9667,33.9,2520,558,1962,72576,4.92711518858,0.0577221475122
"Northampton County, North Carolina",2009,20611,44.4,10943,2984,7959,29349,2.58964694057,0.144777060793
"Northampton County, North Carolina",2012,21959,45.4,11637,3147,8490,30911,2.58645465253,0.143312537001
"Northampton County, North Carolina",2015,21011,47.1,11567,2937,8630,30429,2.43464658169,0.139783922707
"Northampton County, Pennsylvania",2009,293610,39.8,116731,6836,109895,59070,2.67173210792,0.023282585743
"Northampton County, Pennsylvania",2012,297519,40.9,120254,8012,112242,59551,2.65069225424,0.0269293725779
"Northampton County, Pennsylvania",2015,299616,41.8,120997,8070,112927,60972,2.65318302974,0.0269344761294
"Northampton County, Virginia",2009,13422,43.6,7466,2208,5258,36450,2.552681628,0.164506034868
"Northampton County, Virginia",2012,12408,47.3,7307,2282,5025,34304,2.46925373134,0.183913604126
"Northampton County, Virginia",2015,12184,48.3,7323,2075,5248,35055,2.32164634146,0.17030531845
"Northumberland County, Pennsylvania",2009,91286,42.7,43899,5252,38647,38518,2.36204621316,0.0575334662489
"Northumberland County, Pennsylvania",2012,94441,43.2,45039,5819,39220,40963,2.40798062213,0.0616151883186
"Northumberland County, Pennsylvania",2015,94006,43.8,44965,5590,39375,42406,2.38745396825,0.0594642895134
"Northumberland County, Virginia",2009,12890,52.7,9242,3502,5740,50522,2.2456445993,0.271683475562
"Northumberland County, Virginia",2012,12389,53.5,9011,3454,5557,51911,2.22944034551,0.278795705868
"Northumberland County, Virginia",2015,12304,55.1,9096,3235,5861,51885,2.09930046067,0.262922626788
"Northwest Arctic Borough, Alaska",2009,7430,25.3,2575,837,1738,57885,4.2750287687,0.11265141319
"Northwest Arctic Borough, Alaska",2012,7601,25.7,2694,864,1830,60870,4.15355191257,0.113669254046
"Northwest Arctic Borough, Alaska",2015,7732,26.1,2711,808,1903,63648,4.06305832895,0.104500775996
"Norton County, Kansas",2009,5456,42.6,2654,474,2180,34840,2.50275229358,0.0868768328446
"Norton County, Kansas",2012,5658,43.4,2552,273,2279,42776,2.48266783677,0.0482502651113
"Norton County, Kansas",2015,5590,44,2535,416,2119,47852,2.63803680982,0.0744186046512
"Norton city, Virginia",2009,3688,41.3,1884,142,1742,32500,2.11710677382,0.0385032537961
"Norton city, Virginia",2012,3971,39.8,1860,159,1701,38983,2.33450911229,0.0400402921179
"Norton city, Virginia",2015,4007,39.3,1917,134,1783,27731,2.24733595064,0.0334414774145
"Nottoway County, Virginia",2009,15790,41.4,6805,1007,5798,40776,2.7233528803,0.0637745408486
"Nottoway County, Virginia",2012,15875,43,6661,1157,5504,38209,2.88426598837,0.0728818897638
"Nottoway County, Virginia",2015,15711,41.5,6699,1110,5589,36284,2.81105743425,0.0706511361466
"Nowata County, Oklahoma",2009,10646,39.7,4866,742,4124,35893,2.5814742968,0.0696975389818
"Nowata County, Oklahoma",2012,10627,41.5,4833,780,4053,38990,2.62200838885,0.0733979486214
"Nowata County, Oklahoma",2015,10555,41.4,4817,771,4046,39875,2.60874938211,0.0730459497868
"Noxubee County, Mississippi",2009,11814,35.3,5493,1108,4385,22974,2.69418472064,0.0937870323345
"Noxubee County, Mississippi",2012,11511,36.5,5193,1020,4173,22652,2.75844716032,0.0886108939275
"Noxubee County, Mississippi",2015,11143,36.8,5166,1099,4067,26677,2.73985738874,0.0986269406802
"Nuckolls County, Nebraska",2009,4506,47.3,2574,401,2173,32076,2.07363092499,0.0889924545051
"Nuckolls County, Nebraska",2012,4490,49.3,2464,395,2069,33875,2.17013049783,0.0879732739421
"Nuckolls County, Nebraska",2015,4391,49.2,2444,376,2068,40488,2.12330754352,0.0856296971077
"Nueces County, Texas",2009,319703,34.1,133321,16425,116896,42356,2.73493532713,0.051375808172
"Nueces County, Texas",2012,340568,35,140935,18630,122305,46499,2.78457953477,0.0547027319067
"Nueces County, Texas",2015,352060,34.9,144416,17516,126900,50337,2.77431048069,0.0497528830313
"Nye County, Nevada",2009,42934,47.4,16563,2630,13933,42192,3.08146127898,0.0612568127824
"Nye County, Nevada",2012,43801,48.8,21974,3700,18274,39150,2.39690270329,0.0844729572384
"Nye County, Nevada",2015,42625,50.8,21903,4476,17427,41712,2.44591725483,0.105008797654
"O'Brien County, Iowa",2009,14062,44.4,6687,652,6035,43024,2.33007456504,0.0463660930166
"O'Brien County, Iowa",2012,14302,44.4,6634,496,6138,45194,2.33007494298,0.0346804642707
"O'Brien County, Iowa",2015,14092,44,6632,628,6004,55227,2.34710193205,0.0445642917968
"Oakland County, Michigan",2009,1203288,39.1,523653,44277,479376,67292,2.51011314709,0.0367966771047
"Oakland County, Michigan",2012,1207097,40.2,527464,44486,482978,65637,2.49927947029,0.0368537076971
"Oakland County, Michigan",2015,1229503,40.8,531609,38120,493489,67465,2.49144965744,0.0310043977119
"Obion County, Tennessee",2009,31610,40.4,14987,1788,13199,37581,2.39487839988,0.0565643783613
"Obion County, Tennessee",2012,31721,41.2,14665,2154,12511,40516,2.53544880505,0.0679045427319
"Obion County, Tennessee",2015,31129,42.1,14611,1946,12665,40281,2.45787603632,0.0625140544187
"Ocean County, New Jersey",2009,565428,42.5,272815,52159,220656,59939,2.56248640418,0.0922469350651
"Ocean County, New Jersey",2012,575961,42.7,278113,55143,222970,61038,2.58313225995,0.0957408574539
"Ocean County, New Jersey",2015,583450,42.8,279989,57495,222494,61994,2.6223179052,0.0985431485132
"Oceana County, Michigan",2009,27808,38.7,15995,5815,10180,39725,2.73163064833,0.209112485616
"Oceana County, Michigan",2012,26636,42,15949,6295,9654,39667,2.75906360058,0.236334284427
"Oceana County, Michigan",2015,26229,42.3,15927,6105,9822,41617,2.67043372022,0.232757634679
"Ochiltree County, Texas",2009,9454,31.6,3844,507,3337,48662,2.83308360803,0.0536280939285
"Ochiltree County, Texas",2012,10314,31.1,4048,316,3732,50881,2.76366559486,0.0306379678107
"Ochiltree County, Texas",2015,10642,31.7,4049,353,3696,51517,2.87932900433,0.0331704566811
"Oconee County, Georgia",2009,31422,37.5,12356,1020,11336,69959,2.77187720536,0.0324613328241
"Oconee County, Georgia",2012,32814,39.1,12419,1180,11239,77571,2.91965477356,0.0359602608643
"Oconee County, Georgia",2015,34400,39.7,12847,967,11880,72182,2.89562289562,0.0281104651163
"Oconee County, South Carolina",2009,70507,42.4,37395,7593,29802,41095,2.36584792967,0.107691434893
"Oconee County, South Carolina",2012,74038,43.2,38617,8317,30300,41854,2.44349834983,0.112334206759
"Oconee County, South Carolina",2015,74949,44.3,39020,8464,30556,41237,2.45284068595,0.112930125819
"Oconto County, Wisconsin",2009,37278,42.7,22495,6411,16084,48372,2.31770703805,0.171978110414
"Oconto County, Wisconsin",2012,37632,43.8,23486,7453,16033,50763,2.34715898459,0.198049532313
"Oconto County, Wisconsin",2015,37476,45.4,23705,8219,15486,52765,2.41999225107,0.219313694098
"Ogemaw County, Michigan",2009,21359,46.5,16256,7779,8477,35081,2.51964138256,0.364202443935
"Ogemaw County, Michigan",2012,21674,47.5,16041,7551,8490,35320,2.55288574794,0.348389775768
"Ogemaw County, Michigan",2015,21222,49,16023,6589,9434,36063,2.24952300191,0.310479690887
"Oglala Lakota County, South Dakota",2015,14153,25.1,3578,645,2933,26369,4.82543470849,0.0455733766693
"Ogle County, Illinois",2009,54841,39.3,21970,1753,20217,55479,2.71261809368,0.0319651355737
"Ogle County, Illinois",2012,53378,40.9,22539,1811,20728,55590,2.57516402933,0.0339278354378
"Ogle County, Illinois",2015,52397,41.5,22583,1852,20731,54849,2.52747093724,0.0353455350497
"Oglethorpe County, Georgia",2009,13927,40.2,6216,1485,4731,44465,2.9437751004,0.106627414375
"Oglethorpe County, Georgia",2012,14745,41.4,6461,1480,4981,42428,2.96024894599,0.100373007799
"Oglethorpe County, Georgia",2015,14688,42.4,6487,945,5542,44226,2.65030674847,0.0643382352941
"Ohio County, Indiana",2009,5871,39.8,2698,301,2397,49661,2.44931163955,0.0512689490717
"Ohio County, Indiana",2012,6093,43.9,2776,325,2451,49591,2.48592411261,0.0533398982439
"Ohio County, Indiana",2015,6033,46,2799,410,2389,48780,2.52532440352,0.0679595557766
"Ohio County, Kentucky",2009,23498,38.6,10448,1391,9057,35587,2.59445732583,0.059196527364
"Ohio County, Kentucky",2012,23975,39,10233,1514,8719,38286,2.74974194288,0.0631491136601
"Ohio County, Kentucky",2015,24065,40.2,10228,1415,8813,40189,2.73062521275,0.0587990858093
"Ohio County, West Virginia",2009,44365,43.1,22220,2423,19797,37862,2.24099611052,0.0546151245351
"Ohio County, West Virginia",2012,44307,43.2,21243,2735,18508,40652,2.39393775665,0.0617283950617
"Ohio County, West Virginia",2015,43637,43.3,21097,2689,18408,40569,2.37054541504,0.0616220180122
"Okaloosa County, Florida",2009,180955,36.8,91943,17929,74014,53741,2.44487529386,0.0990798817386
"Okaloosa County, Florida",2012,183400,37.7,92577,20277,72300,54118,2.53665283541,0.110561613959
"Okaloosa County, Florida",2015,192237,36.8,94238,19354,74884,55880,2.56713049517,0.100677809163
"Okanogan County, Washington",2009,39706,41.8,20357,5311,15046,38299,2.63897381364,0.133758122198
"Okanogan County, Washington",2012,40959,42.2,22145,6405,15740,40924,2.60222363405,0.156375888083
"Okanogan County, Washington",2015,41332,42.6,22410,5791,16619,40730,2.48703291413,0.140109358366
"Okeechobee County, Florida",2009,39936,37.3,16758,3992,12766,38643,3.1283095723,0.0999599358974
"Okeechobee County, Florida",2012,39779,39,18379,5010,13369,34289,2.97546562944,0.125945850826
"Okeechobee County, Florida",2015,39255,39.9,18278,5232,13046,35405,3.00896826614,0.13328238441
"Okfuskee County, Oklahoma",2009,11134,39.4,5335,1030,4305,31335,2.58629500581,0.092509430573
"Okfuskee County, Oklahoma",2012,12203,40.3,5294,1076,4218,34258,2.89307728781,0.0881750389249
"Okfuskee County, Oklahoma",2015,12248,39.6,5297,1249,4048,36216,3.0256916996,0.101975832789
"Oklahoma County, Oklahoma",2009,700244,33.9,319326,36672,282654,41862,2.47738931697,0.0523703166325
"Oklahoma County, Oklahoma",2012,721088,34.3,320354,37186,283168,45082,2.54650242965,0.0515692952871
"Oklahoma County, Oklahoma",2015,754480,34.2,326985,35595,291390,47437,2.58924465493,0.0471781889513
"Okmulgee County, Oklahoma",2009,39230,37.2,17839,2404,15435,35615,2.54162617428,0.061279632934
"Okmulgee County, Oklahoma",2012,39770,38.7,17898,2669,15229,39142,2.61146496815,0.0671108876037
"Okmulgee County, Oklahoma",2015,39446,39.2,17825,2803,15022,38843,2.62588203968,0.0710591694975
"Oktibbeha County, Mississippi",2009,43630,24.3,19914,2629,17285,26449,2.52415389066,0.0602567041027
"Oktibbeha County, Mississippi",2012,47486,25.2,20935,2453,18482,29430,2.56931068066,0.0516573305816
"Oktibbeha County, Mississippi",2015,49048,25,21217,3734,17483,32485,2.80546816908,0.0761295057902
"Oldham County, Kentucky",2009,56194,38.6,20168,1024,19144,78460,2.93533221897,0.0182225860412
"Oldham County, Kentucky",2012,60357,39.2,20699,1253,19446,83164,3.10382597964,0.0207598124493
"Oldham County, Kentucky",2015,63037,39.6,21089,1383,19706,85452,3.19887343956,0.0219394958516
"Oldham County, Texas",2009,2089,40.9,958,186,772,48214,2.70595854922,0.0890378171374
"Oldham County, Texas",2012,2048,39.3,914,187,727,50993,2.81705639615,0.09130859375
"Oldham County, Texas",2015,2071,32.4,835,195,640,50893,3.2359375,0.0941574118783
"Oliver County, North Dakota",2009,1624,49.1,859,130,729,61607,2.22770919067,0.0800492610837
"Oliver County, North Dakota",2012,1875,44,891,128,763,62768,2.45740498034,0.0682666666667
"Oliver County, North Dakota",2015,1819,48.5,975,183,792,60278,2.29671717172,0.100604727872
"Olmsted County, Minnesota",2009,139585,35.7,58929,3830,55099,64840,2.5333490626,0.0274384783465
"Olmsted County, Minnesota",2012,144507,36.3,60508,3668,56840,66667,2.54234693878,0.0253828534258
"Olmsted County, Minnesota",2015,148736,36.7,61433,3534,57899,68023,2.56888720012,0.0237602194492
"Oneida County, Idaho",2009,4148,38.4,1847,276,1571,43912,2.64035646085,0.0665380906461
"Oneida County, Idaho",2012,4236,39.7,1908,334,1574,44298,2.69123252859,0.0788479697828
"Oneida County, Idaho",2015,4245,39,1929,347,1582,41338,2.68331226296,0.0817432273263
"Oneida County, New York",2009,231029,40.3,103749,11205,92544,45433,2.49642332296,0.0485004047111
"Oneida County, New York",2012,234336,40.9,104037,12537,91500,49148,2.56104918033,0.053500102417
"Oneida County, New York",2015,233558,41.2,104006,13162,90844,48246,2.57097882084,0.0563543102784
"Oneida County, Wisconsin",2009,36257,46.9,28994,11878,17116,44977,2.11831035289,0.327605703726
"Oneida County, Wisconsin",2012,36029,48.2,30083,13857,16226,44181,2.22044866264,0.384606844486
"Oneida County, Wisconsin",2015,35653,49.9,30329,15285,15044,46516,2.36991491625,0.4287156761
"Onondaga County, New York",2009,453846,38.4,202258,18777,183481,50129,2.47353131932,0.0413730648722
"Onondaga County, New York",2012,466179,38.7,202570,17534,185036,53593,2.5193962256,0.037612161852
"Onondaga County, New York",2015,468304,38.8,203956,19315,184641,55092,2.53629475577,0.0412445761727
"Onslow County, North Carolina",2009,165181,23.9,65345,9576,55769,41725,2.96187846295,0.0579727692652
"Onslow County, North Carolina",2012,176461,25.8,69024,9950,59074,45812,2.98711785219,0.0563863969942
"Onslow County, North Carolina",2015,183753,26.1,74206,12021,62185,46335,2.95494090215,0.0654193400924
"Ontario County, New York",2009,104205,41.5,45483,4014,41469,55300,2.51284091731,0.0385202245574
"Ontario County, New York",2012,107728,42.3,48080,4258,43822,56455,2.45830861211,0.039525471558
"Ontario County, New York",2015,109192,43.1,49418,5166,44252,57416,2.46750429359,0.0473111583266
"Ontonagon County, Michigan",2009,6907,51.2,5628,2227,3401,34140,2.03087327257,0.322426523816
"Ontonagon County, Michigan",2012,6703,53.1,5670,2337,3333,33769,2.01110111011,0.348649858272
"Ontonagon County, Michigan",2015,6298,55.6,5652,2568,3084,34459,2.04215304799,0.407748491585
"Orange County, California",2009,2976831,35.3,1028490,54489,974001,73738,3.05629152331,0.0183043646079
"Orange County, California",2012,3021840,36.2,1049031,58765,990266,75566,3.05154372664,0.0194467609139
"Orange County, California",2015,3116069,37.1,1064642,55289,1009353,76509,3.08719447012,0.0177431886136
"Orange County, Florida",2009,1062344,33.2,448215,56407,391808,50352,2.71138925188,0.0530967370268
"Orange County, Florida",2012,1153795,33.7,487014,75889,411125,48429,2.80643356643,0.06577338262
"Orange County, Florida",2015,1229039,34.4,501513,67194,434319,47943,2.82980712334,0.0546719835579
"Orange County, Indiana",2009,19536,39,8793,1205,7588,35667,2.5745914602,0.061680999181
"Orange County, Indiana",2012,19828,39.8,9141,1504,7637,37410,2.59630745057,0.0758523300383
"Orange County, Indiana",2015,19725,40.9,9123,1475,7648,39812,2.57910564854,0.0747782002535
"Orange County, New York",2009,376548,36,133932,10583,123349,69255,3.05270411596,0.0281053145947
"Orange County, New York",2012,372951,36.7,137168,11988,125180,70712,2.97931778239,0.0321436328097
"Orange County, New York",2015,375384,36.8,139103,13833,125270,70848,2.99659934541,0.0368502653283
"Orange County, North Carolina",2009,124503,32.2,54779,4769,50010,49836,2.48956208758,0.0383042978884
"Orange County, North Carolina",2012,133958,33.3,55605,4442,51163,55241,2.61825928894,0.0331596470536
"Orange County, North Carolina",2015,138644,33.3,56297,4417,51880,59290,2.67239784117,0.031858573036
"Orange County, Texas",2009,82521,37.8,35919,3129,32790,45608,2.51665141812,0.0379176209692
"Orange County, Texas",2012,82306,38.7,35348,4243,31105,48864,2.6460697637,0.0515515272277
"Orange County, Texas",2015,83217,38.1,35952,3898,32054,49763,2.59615024646,0.0468413905813
"Orange County, Vermont",2009,28977,42.3,13853,2439,11414,51011,2.53872437358,0.0841702039549
"Orange County, Vermont",2012,28980,43.5,14815,2991,11824,53627,2.45094722598,0.103209109731
"Orange County, Vermont",2015,28929,45,14889,2741,12148,53869,2.38137965097,0.0947492135919
"Orange County, Virginia",2009,32140,41.8,14099,1527,12572,55416,2.5564747057,0.0475108898569
"Orange County, Virginia",2012,33625,42.7,14614,1997,12617,59501,2.66505508441,0.0593903345725
"Orange County, Virginia",2015,34596,42.6,14789,1979,12810,65166,2.70070257611,0.0572031448722
"Orangeburg County, South Carolina",2009,90387,37,41498,7104,34394,32132,2.62798743967,0.0785953732285
"Orangeburg County, South Carolina",2012,92229,37.9,42386,7796,34590,33661,2.66634865568,0.0845287274068
"Orangeburg County, South Carolina",2015,90575,38.7,42237,8827,33410,34218,2.71101466627,0.0974551476677
"Oregon County, Missouri",2009,10321,43.8,5158,848,4310,24803,2.39466357309,0.0821625811452
"Oregon County, Missouri",2012,10885,45.1,5454,916,4538,26926,2.39863375937,0.0841525034451
"Oregon County, Missouri",2015,10979,45.8,5438,1071,4367,29851,2.51408289444,0.0975498679297
"Orleans County, New York",2009,42380,39.7,17591,2348,15243,46418,2.78029259332,0.0554034922133
"Orleans County, New York",2012,42995,40.9,18365,2494,15871,50113,2.70902904669,0.0580067449703
"Orleans County, New York",2015,42204,42.2,18498,2482,16016,46359,2.63511488511,0.0588095915079
"Orleans County, Vermont",2009,27265,42.8,15716,5184,10532,40605,2.58877706039,0.190133871264
"Orleans County, Vermont",2012,27198,43.9,16181,5190,10991,41618,2.47457010281,0.190822854622
"Orleans County, Vermont",2015,27146,44.8,16486,5286,11200,42831,2.42375,0.194724821336
"Orleans Parish, Louisiana",2009,328669,36.7,154266,40331,113935,36258,2.88470619213,0.12271008218
"Orleans Parish, Louisiana",2012,341407,34.9,186987,43136,143851,36681,2.37333768969,0.126347731593
"Orleans Parish, Louisiana",2015,376738,35.4,191951,38811,153140,36792,2.46008880763,0.103018543391
"Orocovis Municipio, Puerto Rico",2009,24782,32,7657,1146,6511,13395,3.80617416679,0.0462432410621
"Orocovis Municipio, Puerto Rico",2012,23386,34.5,8253,1360,6893,14296,3.39271724938,0.0581544513812
"Orocovis Municipio, Puerto Rico",2015,22595,36.5,8485,1628,6857,14110,3.2951728161,0.0720513387918
"Osage County, Kansas",2009,16386,41.4,7472,706,6766,47500,2.42181495714,0.0430855608446
"Osage County, Kansas",2012,16300,42.6,7500,943,6557,50243,2.48589293884,0.0578527607362
"Osage County, Kansas",2015,16080,42.6,7501,996,6505,49915,2.47194465796,0.0619402985075
"Osage County, Missouri",2009,13421,38.9,6121,997,5124,42210,2.61924277908,0.0742865658297
"Osage County, Missouri",2012,13857,39.2,6544,1320,5224,51006,2.65256508423,0.0952587140074
"Osage County, Missouri",2015,13758,39.8,6559,1416,5143,52693,2.67509235855,0.102921936328
"Osage County, Oklahoma",2009,45082,40.1,20172,2819,17353,41630,2.59793695615,0.0625304999778
"Osage County, Oklahoma",2012,47650,41.6,21128,2606,18522,42536,2.57261634813,0.0546904512067
"Osage County, Oklahoma",2015,48054,41.9,21381,3110,18271,45443,2.63006950906,0.0647188579515
"Osborne County, Kansas",2009,3885,47.9,2429,590,1839,33521,2.11256117455,0.151866151866
"Osborne County, Kansas",2012,3852,47.6,2216,491,1725,38561,2.23304347826,0.127466251298
"Osborne County, Kansas",2015,3782,48.5,2198,434,1764,40216,2.14399092971,0.114754098361
"Osceola County, Florida",2009,254739,34.9,114547,24822,89725,46315,2.83910838674,0.097440910108
"Osceola County, Florida",2012,272355,35.4,127764,35545,92219,44887,2.9533501773,0.130509812561
"Osceola County, Florida",2015,300870,35.7,132185,39847,92338,44254,3.25835517338,0.132439259481
"Osceola County, Iowa",2009,6486,41.9,3008,291,2717,38691,2.38719175561,0.0448658649399
"Osceola County, Iowa",2012,6413,43.3,2984,321,2663,45951,2.4081862561,0.0500545766412
"Osceola County, Iowa",2015,6211,44.5,2974,304,2670,49448,2.32621722846,0.0489454194172
"Osceola County, Michigan",2009,23069,40.7,13562,4648,8914,37326,2.58795153691,0.201482508995
"Osceola County, Michigan",2012,23486,41.7,13598,4634,8964,37825,2.62003569835,0.19730903517
"Osceola County, Michigan",2015,23234,42.5,13552,4795,8757,38999,2.65319173233,0.206378583111
"Oscoda County, Michigan",2009,8921,48.9,9117,5154,3963,33028,2.25107241988,0.577737921758
"Oscoda County, Michigan",2012,8709,49.8,9106,5264,3842,33942,2.26678813118,0.604432196578
"Oscoda County, Michigan",2015,8444,51.3,9106,5420,3686,33021,2.2908301682,0.641875888205
"Oswego County, New York",2009,121588,37.8,54166,7600,46566,45071,2.61108963622,0.0625061683719
"Oswego County, New York",2012,122055,38.6,53631,7878,45753,47288,2.66769392171,0.0645446724837
"Oswego County, New York",2015,121183,39.2,53656,8356,45300,47860,2.6751214128,0.0689535660943
"Otero County, Colorado",2009,18833,41.3,8927,1180,7747,32149,2.43100555054,0.062655976212
"Otero County, Colorado",2012,18791,40.6,8960,1321,7639,31860,2.45987694724,0.0702996115162
"Otero County, Colorado",2015,18572,39.7,8920,1466,7454,32311,2.49154816206,0.0789360327375
"Otero County, New Mexico",2009,63206,35.6,30707,6230,24477,38262,2.58226089799,0.0985665917793
"Otero County, New Mexico",2012,64176,36.1,30946,6831,24115,39054,2.66124818578,0.106441660434
"Otero County, New Mexico",2015,65318,35.6,30967,7299,23668,39775,2.75976001352,0.111745613766
"Otoe County, Nebraska",2009,15389,42.4,6948,576,6372,46160,2.41509730069,0.0374293326402
"Otoe County, Nebraska",2012,15729,42.7,7035,596,6439,50917,2.44277061656,0.0378917922309
"Otoe County, Nebraska",2015,15842,41.8,7053,606,6447,50275,2.45726694587,0.0382527458654
"Otsego County, Michigan",2009,23932,41,14798,5075,9723,44790,2.46138023244,0.212059167642
"Otsego County, Michigan",2012,24175,42.7,14749,4942,9807,47140,2.46507596615,0.204426059979
"Otsego County, Michigan",2015,24141,44.2,14758,4802,9956,48917,2.42476898353,0.198914709416
"Otsego County, New York",2009,62086,39.9,30646,5375,25271,44057,2.45680819912,0.0865734626164
"Otsego County, New York",2012,62147,40.4,30737,6196,24541,46358,2.53237439387,0.0996991005197
"Otsego County, New York",2015,61399,41.6,30665,7029,23636,48588,2.59768996446,0.114480691868
"Ottawa County, Kansas",2009,5985,43,2862,515,2347,47350,2.55006391138,0.0860484544695
"Ottawa County, Kansas",2012,6099,42.3,2774,361,2413,53497,2.52755905512,0.0591900311526
"Ottawa County, Kansas",2015,6048,42.2,2769,276,2493,52479,2.42599277978,0.0456349206349
"Ottawa County, Michigan",2009,258564,34,100107,8253,91854,57126,2.81494545692,0.0319185965564
"Ottawa County, Michigan",2012,264835,34.6,102490,8101,94389,55760,2.80578245346,0.030588857213
"Ottawa County, Michigan",2015,273136,34.7,103847,7564,96283,58989,2.83680400486,0.0276931638451
"Ottawa County, Ohio",2009,41132,44.4,27148,9287,17861,53277,2.30289457477,0.22578527667
"Ottawa County, Ohio",2012,41445,46.5,27887,10199,17688,53850,2.34311397558,0.246085173121
"Ottawa County, Ohio",2015,41162,47.3,27967,10633,17334,53914,2.37463943694,0.258320781303
"Ottawa County, Oklahoma",2009,32148,38.3,15313,2247,13066,34160,2.46043165468,0.0698954833893
"Ottawa County, Oklahoma",2012,31940,38.7,14116,1979,12137,36280,2.63162231194,0.0619599248591
"Ottawa County, Oklahoma",2015,32085,38.5,14067,2006,12061,36347,2.66022717851,0.0625214274583
"Otter Tail County, Minnesota",2009,56912,45.1,35585,11264,24321,42821,2.34003536039,0.197919595164
"Otter Tail County, Minnesota",2012,57381,46,35593,11199,24394,47579,2.35225875215,0.19516913264
"Otter Tail County, Minnesota",2015,57511,46.7,35615,11573,24042,52365,2.39210548207,0.201231068839
"Ouachita County, Arkansas",2009,26016,42,13730,2711,11019,30167,2.36101279608,0.104205104551
"Ouachita County, Arkansas",2012,25894,42.6,13135,2209,10926,32032,2.36994325462,0.0853093380706
"Ouachita County, Arkansas",2015,25044,42.7,13089,2537,10552,31293,2.37338893101,0.101301708992
"Ouachita Parish, Louisiana",2009,150025,33.1,63931,8252,55679,38568,2.69446290343,0.0550041659723
"Ouachita Parish, Louisiana",2012,153752,34.2,64626,7387,57239,38899,2.68614056849,0.0480449034809
"Ouachita Parish, Louisiana",2015,155769,34.7,65803,8113,57690,37754,2.70010400416,0.0520835339509
"Ouray County, Colorado",2009,4519,45.8,2401,715,1686,58836,2.6803084223,0.15822084532
"Ouray County, Colorado",2012,4445,52.4,2920,1034,1886,66474,2.35683987275,0.232620922385
"Ouray County, Colorado",2015,4580,52.9,3084,1104,1980,61624,2.31313131313,0.241048034934
"Outagamie County, Wisconsin",2009,173607,36.6,71256,3149,68107,55763,2.54903313903,0.0181386695237
"Outagamie County, Wisconsin",2012,176777,37.3,73240,3844,69396,57584,2.54736584241,0.0217449102542
"Outagamie County, Wisconsin",2015,180430,37.8,74583,4078,70505,58765,2.55910928303,0.022601562933
"Overton County, Tennessee",2009,20816,40.6,9645,997,8648,33323,2.40703052729,0.0478958493467
"Overton County, Tennessee",2012,22040,41.3,10256,1388,8868,34119,2.48534055029,0.0629764065336
"Overton County, Tennessee",2015,22100,42.2,10263,1370,8893,35287,2.48510064095,0.0619909502262
"Owen County, Indiana",2009,22371,40.7,10510,1860,8650,42465,2.58624277457,0.0831433552367
"Owen County, Indiana",2012,21583,42.7,10094,1453,8641,42707,2.49774331675,0.0673215030348
"Owen County, Indiana",2015,21192,43.9,9995,1442,8553,43948,2.47772711329,0.0680445451114
"Owen County, Kentucky",2009,11295,38.5,5641,926,4715,43481,2.39554612937,0.0819831783975
"Owen County, Kentucky",2012,10870,40.6,5639,1061,4578,41719,2.374399301,0.0976080956762
"Owen County, Kentucky",2015,10711,41.7,5645,1522,4123,41934,2.59786563182,0.142096909719
"Owsley County, Kentucky",2009,4648,40.6,2314,636,1678,18869,2.76996424315,0.136833046472
"Owsley County, Kentucky",2012,4764,43.9,2164,522,1642,19624,2.90133982948,0.109571788413
"Owsley County, Kentucky",2015,4616,43,2259,486,1773,20985,2.60349689791,0.105285961872
"Owyhee County, Idaho",2009,10995,36.3,4810,800,4010,31660,2.74189526185,0.0727603456116
"Owyhee County, Idaho",2012,11479,35.8,4791,910,3881,33626,2.95774284978,0.079275198188
"Owyhee County, Idaho",2015,11364,37.5,4771,842,3929,33440,2.89233901756,0.0740936290039
"Oxford County, Maine",2009,56414,43.3,34553,11754,22799,40055,2.47440677223,0.208352536604
"Oxford County, Maine",2012,57814,44.4,36012,12888,23124,41434,2.50017298045,0.222921783651
"Oxford County, Maine",2015,57421,45.7,36264,14497,21767,40630,2.63798410438,0.252468609045
"Ozark County, Missouri",2009,9360,47.5,5361,1580,3781,33264,2.4755355726,0.168803418803
"Ozark County, Missouri",2012,9672,49.5,5635,1492,4143,32126,2.33454018827,0.154259718776
"Ozark County, Missouri",2015,9537,50.7,5627,1394,4233,31399,2.25301204819,0.146167557932
"Ozaukee County, Wisconsin",2009,85554,42.3,35608,1953,33655,74237,2.54208884267,0.0228276877761
"Ozaukee County, Wisconsin",2012,86429,43,36252,2159,34093,75854,2.53509518083,0.0249800414213
"Ozaukee County, Wisconsin",2015,87273,43.8,36586,2043,34543,76433,2.52650319891,0.0234093018459
"Pacific County, Washington",2009,21341,49.6,14649,5151,9498,39045,2.24689408296,0.241366383956
"Pacific County, Washington",2012,20945,50.7,15538,6175,9363,40873,2.2369966891,0.294819766054
"Pacific County, Washington",2015,20645,51.7,15700,6600,9100,37684,2.26868131868,0.319689997578
"Page County, Iowa",2009,15749,43.2,7286,827,6459,41213,2.4383031429,0.0525112705569
"Page County, Iowa",2012,15902,43.8,7186,802,6384,41803,2.49091478697,0.0504339076846
"Page County, Iowa",2015,15660,43.5,7185,891,6294,43912,2.48808388942,0.0568965517241
"Page County, Virginia",2009,24026,41.7,11389,1769,9620,42359,2.49750519751,0.0736285690502
"Page County, Virginia",2012,24038,43,11577,2108,9469,43745,2.53859964093,0.0876944837341
"Page County, Virginia",2015,23843,44.1,11636,2264,9372,43895,2.54406743491,0.0949544939815
"Palm Beach County, Florida",2009,1268601,42.5,634413,125893,508520,53538,2.49469244081,0.0992376641671
"Palm Beach County, Florida",2012,1324085,43.5,663599,139708,523891,52806,2.52740550992,0.1055128636
"Palm Beach County, Florida",2015,1378806,44.1,671317,136712,534605,53363,2.57911168059,0.0991524550952
"Palo Alto County, Iowa",2009,9405,42.1,4717,669,4048,39555,2.32336956522,0.0711323763955
"Palo Alto County, Iowa",2012,9402,42.8,4633,589,4044,40500,2.32492581602,0.0626462454797
"Palo Alto County, Iowa",2015,9208,42.9,4611,634,3977,47113,2.31531305004,0.0688531711555
"Palo Pinto County, Texas",2009,27451,39.2,14537,4063,10474,39300,2.62087072752,0.148009179993
"Palo Pinto County, Texas",2012,28010,40.3,15207,4651,10556,43041,2.65346722243,0.166047840057
"Palo Pinto County, Texas",2015,27921,41.2,15296,4734,10562,39516,2.6435334217,0.169549801225
"Pamlico County, North Carolina",2009,12470,46.5,7353,1948,5405,37936,2.30712303423,0.156214915798
"Pamlico County, North Carolina",2012,13145,48,7534,2311,5223,43825,2.51675282405,0.175808292126
"Pamlico County, North Carolina",2015,12982,49.8,7569,2332,5237,43444,2.47890013366,0.179633338469
"Panola County, Mississippi",2009,35148,34.4,14678,2274,12404,35355,2.83360206385,0.0646978490953
"Panola County, Mississippi",2012,34675,36,14703,2625,12078,36147,2.87092233814,0.0757029560202
"Panola County, Mississippi",2015,34373,36.5,14726,2593,12133,36555,2.83301739059,0.0754371163413
"Panola County, Texas",2009,23107,40.3,11018,2304,8714,41309,2.65170989213,0.0997100445752
"Panola County, Texas",2012,23814,39.3,10934,2064,8870,50508,2.68478015784,0.0866717057193
"Panola County, Texas",2015,23900,38,10968,2045,8923,50119,2.67847136613,0.0855648535565
"Park County, Colorado",2009,16788,44.1,13042,6053,6989,60186,2.4020603806,0.360555158447
"Park County, Colorado",2012,16168,47,13923,6926,6997,62594,2.31070458768,0.428377041069
"Park County, Colorado",2015,16189,49.4,14134,6815,7319,56969,2.21191419593,0.420964852678
"Park County, Montana",2009,15935,43.2,8481,1858,6623,39730,2.40600936132,0.116598682146
"Park County, Montana",2012,15655,45.9,9329,2790,6539,40781,2.39409695672,0.178217821782
"Park County, Montana",2015,15708,46.6,9367,2574,6793,43932,2.31238039158,0.163865546218
"Park County, Wyoming",2009,27193,43.8,13097,1265,11832,43851,2.29825895876,0.0465193248262
"Park County, Wyoming",2012,28203,43.7,13548,1592,11956,51449,2.35889929742,0.0564478956139
"Park County, Wyoming",2015,28985,43.6,13823,2001,11822,56363,2.45178480799,0.0690357081249
"Parke County, Indiana",2009,17094,41,7880,1542,6338,37962,2.69706532029,0.0902070902071
"Parke County, Indiana",2012,17251,41.1,8077,2038,6039,45489,2.85659877463,0.118138078952
"Parke County, Indiana",2015,17107,41.8,8062,2067,5995,40781,2.85354462052,0.120827731338
"Parker County, Texas",2009,108324,37.6,38345,3290,35055,61415,3.09011553273,0.0303718474207
"Parker County, Texas",2012,116820,38.9,46173,4533,41640,65299,2.80547550432,0.0388032871084
"Parker County, Texas",2015,121418,39.6,47437,4656,42781,67288,2.83812907599,0.038346867845
"Parmer County, Texas",2009,9398,34.8,3783,499,3284,36698,2.86175395859,0.0530964034901
"Parmer County, Texas",2012,10172,32.2,3797,498,3299,44925,3.08335859351,0.0489579237122
"Parmer County, Texas",2015,10004,32.5,3807,583,3224,45326,3.10297766749,0.0582766893243
"Pasco County, Florida",2009,453933,42.8,216187,37237,178950,43690,2.53664710813,0.0820319298222
"Pasco County, Florida",2012,465276,43.8,228583,45876,182707,43787,2.54656909697,0.0985995409176
"Pasco County, Florida",2015,479288,44.4,231612,45294,186318,45064,2.57241919729,0.0945026789738
"Pasquotank County, North Carolina",2009,40334,34.9,16006,1665,14341,44319,2.81249564187,0.0412803094164
"Pasquotank County, North Carolina",2012,40551,36.3,16734,2226,14508,46032,2.79507857734,0.05489383739
"Pasquotank County, North Carolina",2015,40018,37.4,16865,2417,14448,45378,2.76979512735,0.0603978209806
"Passaic County, New Jersey",2009,488793,36,171984,12368,159616,54888,3.06230578388,0.025303144685
"Passaic County, New Jersey",2012,500168,36.2,175830,13765,162065,57540,3.08621849258,0.027520753027
"Passaic County, New Jersey",2015,507574,36.5,176433,15115,161318,59739,3.14641887452,0.0297789090852
"Patillas Municipio, Puerto Rico",2009,20001,36.5,7856,1449,6407,13780,3.12174184486,0.0724463776811
"Patillas Municipio, Puerto Rico",2012,19225,38.3,8229,2056,6173,14777,3.11436902641,0.106944083225
"Patillas Municipio, Puerto Rico",2015,18441,41.7,8838,2402,6436,13284,2.86528899938,0.130253240063
"Patrick County, Virginia",2009,18755,44.4,10458,2827,7631,36895,2.45773817324,0.15073313783
"Patrick County, Virginia",2012,18513,46.1,10094,2575,7519,35599,2.46216252161,0.139091449252
"Patrick County, Virginia",2015,18264,48,10085,2295,7790,33982,2.34454428755,0.125657030223
"Paulding County, Georgia",2009,125780,32.5,49060,3880,45180,60138,2.78397521027,0.0308475115281
"Paulding County, Georgia",2012,141846,34,52104,4246,47858,63190,2.963893184,0.0299338719456
"Paulding County, Georgia",2015,147400,35.1,52914,3804,49110,60109,3.00142537161,0.0258073270014
"Paulding County, Ohio",2009,19186,40.1,8859,1107,7752,45716,2.47497420021,0.0576983216929
"Paulding County, Ohio",2012,19522,40.5,8755,1055,7700,44099,2.53532467532,0.054041594099
"Paulding County, Ohio",2015,19165,41,8692,993,7699,45550,2.48928432264,0.0518132011479
"Pawnee County, Kansas",2009,6394,42.3,2954,542,2412,38725,2.65091210614,0.0847669690335
"Pawnee County, Kansas",2012,6945,42,3157,645,2512,44106,2.76472929936,0.0928725701944
"Pawnee County, Kansas",2015,6911,43.1,3165,613,2552,43250,2.70807210031,0.0886991752279
"Pawnee County, Nebraska",2009,2682,48,1487,241,1246,41471,2.15248796148,0.0898583146905
"Pawnee County, Nebraska",2012,2753,49.3,1571,262,1309,43634,2.10313216196,0.0951689066473
"Pawnee County, Nebraska",2015,2726,49.1,1593,332,1261,41161,2.16177636796,0.121790168745
"Pawnee County, Oklahoma",2009,16440,41.6,7755,1570,6185,40963,2.658043654,0.095498783455
"Pawnee County, Oklahoma",2012,16573,41.7,7746,1380,6366,43152,2.60336160855,0.0832679659687
"Pawnee County, Oklahoma",2015,16499,41.4,7738,1460,6278,45765,2.62806626314,0.088490211528
"Payette County, Idaho",2009,22534,36.7,8854,656,8198,44480,2.7487191998,0.0291115647466
"Payette County, Idaho",2012,22614,38,8943,739,8204,42747,2.75646026329,0.0326788714955
"Payette County, Idaho",2015,22700,38.5,9024,877,8147,44257,2.78630170615,0.0386343612335
"Payne County, Oklahoma",2009,78534,26.1,32923,5085,27838,34255,2.82110783821,0.0647490258996
"Payne County, Oklahoma",2012,77125,27.2,33912,4089,29823,36762,2.58609127184,0.053017828201
"Payne County, Oklahoma",2015,79423,27.2,34700,4536,30164,37667,2.6330393847,0.057111919721
"Peach County, Georgia",2009,26019,34.1,10584,1886,8698,43391,2.99137732812,0.0724854913717
"Peach County, Georgia",2012,27531,33.9,11031,1637,9394,41488,2.93070044709,0.0594602448149
"Peach County, Georgia",2015,27086,34.7,11223,1282,9941,41588,2.72467558596,0.0473307243594
"Pearl River County, Mississippi",2009,56113,37.8,24649,3184,21465,38458,2.61416259026,0.056742644307
"Pearl River County, Mississippi",2012,55886,39.2,24068,3549,20519,41940,2.72362200887,0.063504276563
"Pearl River County, Mississippi",2015,55196,40.7,24423,3817,20606,40976,2.67863729011,0.0691535618523
"Pecos County, Texas",2009,15901,34,6545,1192,5353,34466,2.97048384084,0.0749638387523
"Pecos County, Texas",2012,15510,36.1,5630,885,4745,43529,3.26870389884,0.0570599613153
"Pecos County, Texas",2015,15807,35.8,5592,1253,4339,50305,3.64300530076,0.0792686784336
"Pembina County, North Dakota",2009,7607,45.6,4067,678,3389,45457,2.24461493066,0.0891284343368
"Pembina County, North Dakota",2012,7383,47.1,3872,531,3341,50422,2.20981741993,0.0719219829338
"Pembina County, North Dakota",2015,7206,47.2,3871,586,3285,53504,2.19360730594,0.0813211212878
"Pemiscot County, Missouri",2009,18586,36.1,9002,1395,7607,28290,2.44327593006,0.0750564941354
"Pemiscot County, Missouri",2012,18288,36.9,8198,1201,6997,30194,2.61369158211,0.0656714785652
"Pemiscot County, Missouri",2015,17837,37.6,8115,1140,6975,29238,2.55727598566,0.0639120928407
"Pend Oreille County, Washington",2009,12736,46,7133,2032,5101,36864,2.49676534013,0.159547738693
"Pend Oreille County, Washington",2012,12976,47.6,7884,2450,5434,37582,2.38792786161,0.188810110974
"Pend Oreille County, Washington",2015,12968,49.3,7995,2599,5396,40599,2.40326167532,0.200416409624
"Pender County, North Carolina",2009,49408,40.5,25018,5289,19729,42760,2.50433372193,0.10704744171
"Pender County, North Carolina",2012,52447,41.2,26670,6453,20217,44071,2.59420289855,0.123038496005
"Pender County, North Carolina",2015,55166,42.1,27071,6941,20130,44828,2.74048683557,0.125820251604
"Pendleton County, Kentucky",2009,14951,37,6013,862,5151,44343,2.9025431955,0.0576550063541
"Pendleton County, Kentucky",2012,14771,39.4,6319,842,5477,48761,2.69691436918,0.0570035881118
"Pendleton County, Kentucky",2015,14514,41.5,6323,967,5356,48353,2.70985810306,0.0666253272702
"Pendleton County, West Virginia",2009,7577,47.3,5381,1664,3717,35705,2.03847188593,0.219611983635
"Pendleton County, West Virginia",2012,7666,47.6,5153,1798,3355,34087,2.28494783905,0.234542134099
"Pendleton County, West Virginia",2015,7402,49.1,5161,2066,3095,36953,2.3915993538,0.27911375304
"Pennington County, Minnesota",2009,13750,39,6300,507,5793,44015,2.37355428966,0.0368727272727
"Pennington County, Minnesota",2012,13950,39.5,6297,514,5783,47880,2.41224278056,0.0368458781362
"Pennington County, Minnesota",2015,14110,39.1,6331,411,5920,47127,2.38344594595,0.0291282778172
"Pennington County, South Dakota",2009,96903,35.9,42261,3876,38385,46288,2.5245017585,0.0399987616482
"Pennington County, South Dakota",2012,101240,36.7,44969,4426,40543,50253,2.49710184249,0.043717898064
"Pennington County, South Dakota",2015,106085,37.1,46206,4536,41670,50890,2.54583633309,0.0427581656219
"Penobscot County, Maine",2009,148501,39.1,70798,9503,61295,42366,2.42272616037,0.0639928350651
"Penobscot County, Maine",2012,153742,40,73671,10997,62674,43382,2.45304272904,0.0715289250823
"Penobscot County, Maine",2015,153437,41.3,74196,12223,61973,44271,2.47586852339,0.0796613593853
"Peoria County, Illinois",2009,183474,36,82247,7593,74654,47702,2.45765799555,0.0413846103535
"Peoria County, Illinois",2012,186399,36.7,83043,7196,75847,50925,2.45756588922,0.0386053573249
"Peoria County, Illinois",2015,187112,36.8,83476,7343,76133,51147,2.4576990267,0.039243875326
"Pepin County, Wisconsin",2009,7361,41.8,3355,432,2923,48991,2.51830311324,0.0586876783046
"Pepin County, Wisconsin",2012,7458,43.8,3558,541,3017,49544,2.47199204508,0.0725395548404
"Pepin County, Wisconsin",2015,7372,45.2,3609,655,2954,49516,2.49559918754,0.0888497015735
"Perkins County, Nebraska",2009,2771,44.4,1405,172,1233,46151,2.24736415247,0.0620714543486
"Perkins County, Nebraska",2012,2947,45.1,1437,218,1219,53299,2.41755537326,0.0739735324058
"Perkins County, Nebraska",2015,2924,44.1,1451,208,1243,55893,2.35237329043,0.0711354309166
"Perkins County, South Dakota",2009,2877,47.1,1808,466,1342,34495,2.14381520119,0.161974278763
"Perkins County, South Dakota",2012,2890,49.5,1773,466,1307,37521,2.21117061974,0.16124567474
"Perkins County, South Dakota",2015,2981,49.9,1775,469,1306,39773,2.28254211332,0.157329755116
"Perquimans County, North Carolina",2009,12367,45.6,6745,1632,5113,37798,2.41873655388,0.131964098003
"Perquimans County, North Carolina",2012,13414,46.3,6985,1582,5403,42410,2.48269479919,0.11793648427
"Perquimans County, North Carolina",2015,13498,47.8,7030,1530,5500,44329,2.45418181818,0.113350125945
"Perry County, Alabama",2009,10689,36.4,5562,1073,4489,26270,2.38115393183,0.100383571896
"Perry County, Alabama",2012,10525,37,4764,1255,3509,31008,2.99943003705,0.119239904988
"Perry County, Alabama",2015,10038,36.3,4711,1261,3450,24537,2.90956521739,0.125622633991
"Perry County, Arkansas",2009,10294,40.7,4955,895,4060,44921,2.5354679803,0.0869438507869
"Perry County, Arkansas",2012,10413,42.1,4901,903,3998,42738,2.60455227614,0.0867185249208
"Perry County, Arkansas",2015,10300,43.1,4904,1057,3847,42346,2.67741096959,0.102621359223
"Perry County, Illinois",2009,22542,39,9796,1122,8674,39031,2.59880101453,0.0497737556561
"Perry County, Illinois",2012,22287,39.7,9440,1304,8136,42013,2.73930678466,0.0585094449679
"Perry County, Illinois",2015,21810,40.8,9454,1429,8025,42478,2.71775700935,0.0655204034846
"Perry County, Indiana",2009,18872,39.7,8535,987,7548,43918,2.50026497085,0.0522997032641
"Perry County, Indiana",2012,19408,41.3,8494,995,7499,47132,2.58807841045,0.0512675185491
"Perry County, Indiana",2015,19414,41.4,8519,1237,7282,47470,2.66602581708,0.0637169053261
"Perry County, Kentucky",2009,29135,38.1,13486,2250,11236,31151,2.59300462798,0.0772267032778
"Perry County, Kentucky",2012,28617,41.2,12822,1791,11031,32676,2.59423443024,0.0625851766433
"Perry County, Kentucky",2015,28041,41.4,12775,1695,11080,32667,2.53077617329,0.0604472023109
"Perry County, Mississippi",2009,12087,38.8,5309,587,4722,34423,2.55972045743,0.0485645735087
"Perry County, Mississippi",2012,12217,39.4,5505,876,4629,35942,2.63923093541,0.0717033641647
"Perry County, Mississippi",2015,12187,40.1,5520,1128,4392,34045,2.77481785064,0.0925576433905
"Perry County, Missouri",2009,18638,38.9,8205,788,7417,45863,2.51287582581,0.042279214508
"Perry County, Missouri",2012,18986,39.5,8556,975,7581,45553,2.50441894209,0.0513536289898
"Perry County, Missouri",2015,19100,39.7,8605,1210,7395,51499,2.58282623394,0.0633507853403
"Perry County, Ohio",2009,35080,37.4,14218,1540,12678,42299,2.7669979492,0.0438996579247
"Perry County, Ohio",2012,36086,38.3,15151,1463,13688,42222,2.63632378726,0.0405420384637
"Perry County, Ohio",2015,36025,40,15161,1381,13780,42017,2.61429608128,0.0383344899375
"Perry County, Pennsylvania",2009,45048,40.1,19815,2348,17467,51497,2.57903475125,0.0521221807849
"Perry County, Pennsylvania",2012,45791,41,20378,2218,18160,56205,2.521530837,0.0484374658776
"Perry County, Pennsylvania",2015,45677,42.1,20513,2428,18085,57177,2.52568426873,0.0531558552444
"Perry County, Tennessee",2009,7694,42.5,4350,1373,2977,32021,2.58448102116,0.178450740837
"Perry County, Tennessee",2012,7856,43.1,4573,1310,3263,32101,2.40760036776,0.166751527495
"Perry County, Tennessee",2015,7864,43.7,4574,1348,3226,31425,2.43769373838,0.171414038657
"Pershing County, Nevada",2009,6329,39,2404,479,1925,53042,3.28779220779,0.0756833623005
"Pershing County, Nevada",2012,6707,39.9,2456,394,2062,51094,3.25266731329,0.058744595199
"Pershing County, Nevada",2015,6722,41.3,2418,335,2083,45230,3.22707633221,0.0498363582267
"Person County, North Carolina",2009,37301,40.6,17048,2138,14910,44381,2.50174379611,0.0573174981904
"Person County, North Carolina",2012,39322,41.5,18138,2762,15376,43292,2.55736212279,0.0702405777936
"Person County, North Carolina",2015,39262,42.4,18183,2800,15383,42105,2.55229799129,0.0713157760685
"Petersburg Borough, Alaska",2015,3221,40.4,1738,454,1284,67935,2.50856697819,0.140950015523
"Petersburg Census Area, Alaska",2009,3862,42.6,2167,517,1650,61115,2.34060606061,0.133868461937
"Petersburg Census Area, Alaska",2012,3822,42.2,2149,478,1671,61696,2.28725314183,0.12506541078
"Petersburg city, Virginia",2009,32845,38.5,15946,3560,12386,35874,2.65178427257,0.108387882478
"Petersburg city, Virginia",2012,32226,39.8,16325,4089,12236,35126,2.63370382478,0.126885123813
"Petersburg city, Virginia",2015,32123,39.5,16464,3661,12803,31798,2.50902132313,0.11396818479
"Petroleum County, Montana",2009,512,45.5,271,51,220,38833,2.32727272727,0.099609375
"Petroleum County, Montana",2012,566,47.6,343,95,248,40682,2.28225806452,0.167844522968
"Petroleum County, Montana",2015,443,48.9,309,117,192,43750,2.30729166667,0.264108352144
"Pettis County, Missouri",2009,40789,36.7,17418,1825,15593,36510,2.61585326749,0.0447424550737
"Pettis County, Missouri",2012,42044,37.3,18216,1915,16301,38543,2.5792282682,0.045547521644
"Pettis County, Missouri",2015,42215,37.5,18203,2072,16131,39928,2.61701072469,0.0490820798294
"Peñuelas Municipio, Puerto Rico",2009,29284,31.2,8391,1108,7283,14771,4.02087052039,0.0378363611528
"Peñuelas Municipio, Puerto Rico",2012,24193,33.4,8587,1183,7404,15541,3.26755807672,0.048898441698
"Peñuelas Municipio, Puerto Rico",2015,22770,35.1,8861,1218,7643,15497,2.97919665053,0.0534914361001
"Phelps County, Missouri",2009,42249,36.1,19137,2424,16713,37322,2.52791240352,0.0573741390329
"Phelps County, Missouri",2012,44825,34,19562,2947,16615,41388,2.69786337647,0.0657445621863
"Phelps County, Missouri",2015,45029,34.4,19714,3042,16672,41618,2.70087571977,0.0675564636123
"Phelps County, Nebraska",2009,9188,42.8,4272,517,3755,43602,2.44687083888,0.0562690465825
"Phelps County, Nebraska",2012,9184,43.9,4187,312,3875,47871,2.37006451613,0.0339721254355
"Phelps County, Nebraska",2015,9216,42,4197,469,3728,50404,2.47210300429,0.0508897569444
"Philadelphia County, Pennsylvania",2009,1531112,34.2,661299,94602,566697,36669,2.70181772623,0.0617864663068
"Philadelphia County, Pennsylvania",2012,1525811,33.5,669244,88735,580509,37016,2.62840197137,0.0581559577169
"Philadelphia County, Pennsylvania",2015,1555072,33.7,670229,89179,581050,38253,2.67631357026,0.0573471839246
"Phillips County, Arkansas",2009,22002,34.8,10969,2064,8905,26336,2.47074677148,0.0938096536678
"Phillips County, Arkansas",2012,21646,37.3,10170,1861,8309,27219,2.60512697075,0.085974313961
"Phillips County, Arkansas",2015,20391,37.8,10136,2001,8135,26844,2.5065765212,0.0981315286156
"Phillips County, Colorado",2009,4479,40.7,2201,339,1862,39830,2.40547798067,0.0756865371735
"Phillips County, Colorado",2012,4380,40.8,1916,273,1643,45339,2.66585514303,0.0623287671233
"Phillips County, Colorado",2015,4371,43.7,1939,228,1711,43639,2.55464640561,0.0521619766644
"Phillips County, Kansas",2009,5329,46.5,3122,767,2355,43750,2.26284501062,0.143929442672
"Phillips County, Kansas",2012,5579,45.7,3063,652,2411,42838,2.31397760265,0.116866822011
"Phillips County, Kansas",2015,5501,44.7,3044,695,2349,44170,2.34184759472,0.126340665334
"Phillips County, Montana",2009,3959,48.2,2426,596,1830,37080,2.16338797814,0.150543066431
"Phillips County, Montana",2012,4203,48.4,2342,547,1795,41214,2.34150417827,0.130145134428
"Phillips County, Montana",2015,4167,47.9,2315,507,1808,36071,2.30475663717,0.121670266379
"Piatt County, Illinois",2009,16499,42.7,7236,654,6582,55603,2.50668489821,0.0396387659858
"Piatt County, Illinois",2012,16679,42.8,7285,857,6428,62125,2.59474175482,0.0513819773368
"Piatt County, Illinois",2015,16495,43.3,7321,676,6645,66261,2.48231753198,0.0409821157927
"Pickaway County, Ohio",2009,53864,37.9,19796,1911,17885,48985,3.0116857702,0.0354782414971
"Pickaway County, Ohio",2012,55795,38.4,21181,1985,19196,53750,2.90659512398,0.0355766645757
"Pickaway County, Ohio",2015,56515,39.1,21182,1722,19460,57439,2.90416238438,0.0304697867823
"Pickens County, Alabama",2009,19528,40,9829,1603,8226,27150,2.37393629954,0.08208725932
"Pickens County, Alabama",2012,19646,41.4,9485,1463,8022,28762,2.44901520818,0.0744680851064
"Pickens County, Alabama",2015,19856,42.4,9447,1803,7644,30330,2.59759288331,0.0908037872683
"Pickens County, Georgia",2009,30021,41.2,13849,1946,11903,50145,2.52213727632,0.0648212917624
"Pickens County, Georgia",2012,29445,41.7,13689,2375,11314,50829,2.60252784161,0.0806588554933
"Pickens County, Georgia",2015,29740,44.7,13680,2394,11286,54123,2.63512316144,0.0804976462677
"Pickens County, South Carolina",2009,116092,35.1,51230,6629,44601,41969,2.60290128024,0.0571012645144
"Pickens County, South Carolina",2012,119167,34.8,51239,7012,44227,41947,2.69444004793,0.0588417934495
"Pickens County, South Carolina",2015,120124,35.4,51731,7085,44646,41459,2.69058818259,0.0589807199227
"Pickett County, Tennessee",2009,4803,40.3,2898,838,2060,24757,2.33155339806,0.174474286904
"Pickett County, Tennessee",2012,5108,47.3,3399,959,2440,34255,2.09344262295,0.187744714174
"Pickett County, Tennessee",2015,5097,49.4,3461,1238,2223,36773,2.29284750337,0.242887973318
"Pierce County, Georgia",2009,17830,37.4,7589,851,6738,35137,2.64618581181,0.047728547392
"Pierce County, Georgia",2012,18631,38.6,7956,888,7068,39326,2.63596491228,0.0476624979872
"Pierce County, Georgia",2015,18934,39,7964,1074,6890,40247,2.74804063861,0.0567233548115
"Pierce County, Nebraska",2009,7293,41.5,3294,352,2942,46579,2.47892590075,0.0482654600302
"Pierce County, Nebraska",2012,7231,41.9,3222,287,2935,52096,2.46371379898,0.0396902226525
"Pierce County, Nebraska",2015,7184,41.3,3224,284,2940,54482,2.44353741497,0.0395322939866
"Pierce County, North Dakota",2009,4101,47.6,2039,292,1747,34668,2.34745277619,0.0712021458181
"Pierce County, North Dakota",2012,4378,47.4,2216,303,1913,45851,2.28855201255,0.0692096847876
"Pierce County, North Dakota",2015,4395,46.9,2282,264,2018,42563,2.17789890981,0.0600682593857
"Pierce County, Washington",2009,774339,35.2,315240,23917,291323,56773,2.65800846483,0.0308869887737
"Pierce County, Washington",2012,798528,35.7,325640,26306,299334,59105,2.66768225461,0.0329431153322
"Pierce County, Washington",2015,821952,35.8,331369,27783,303586,59953,2.70747662936,0.0338012438683
"Pierce County, Wisconsin",2009,39708,33.9,15522,984,14538,59421,2.73132480396,0.0247809005742
"Pierce County, Wisconsin",2012,40842,34.6,16131,1156,14975,61153,2.72734557596,0.0283041966603
"Pierce County, Wisconsin",2015,40799,35.9,16220,1043,15177,61611,2.6882124267,0.0255643520675
"Pike County, Alabama",2009,30136,32.5,14895,2033,12862,28065,2.34302596797,0.0674608441731
"Pike County, Alabama",2012,32750,31.3,15272,2285,12987,31702,2.52175252175,0.0697709923664
"Pike County, Alabama",2015,33155,31.3,15619,2833,12786,32825,2.59307054591,0.0854471422108
"Pike County, Arkansas",2009,10763,39.7,5822,1477,4345,33024,2.47710011507,0.137229397008
"Pike County, Arkansas",2012,11261,39.8,5595,1242,4353,32087,2.58695152768,0.110292158778
"Pike County, Arkansas",2015,11087,41.4,5578,1223,4355,33097,2.54580941447,0.110309371336
"Pike County, Georgia",2009,17012,37.5,6670,656,6014,52579,2.82873295643,0.0385610157536
"Pike County, Georgia",2012,17765,38.3,6800,671,6129,56658,2.89851525534,0.0377708978328
"Pike County, Georgia",2015,17812,38.9,6821,804,6017,51338,2.96027920891,0.0451381091399
"Pike County, Illinois",2009,16484,42,8278,1453,6825,40648,2.41523809524,0.0881460810483
"Pike County, Illinois",2012,16436,42,7966,1356,6610,40445,2.48653555219,0.0825018252616
"Pike County, Illinois",2015,16144,42.6,7941,1264,6677,40588,2.41785232889,0.0782953419227
"Pike County, Indiana",2009,12496,41.3,6014,475,5539,39685,2.25600288861,0.0380121638924
"Pike County, Indiana",2012,12849,42.8,5754,482,5272,40760,2.437215478,0.0375126468986
"Pike County, Indiana",2015,12687,43.4,5755,761,4994,44399,2.54044853825,0.0599826594151
"Pike County, Kentucky",2009,65524,39.5,33013,4091,28922,32271,2.26554180209,0.0624351382699
"Pike County, Kentucky",2012,64887,40.5,30442,3620,26822,33227,2.41917082992,0.0557892952363
"Pike County, Kentucky",2015,63434,41.1,30309,4185,26124,33183,2.4281886388,0.0659740832992
"Pike County, Mississippi",2009,39606,36.1,17559,2876,14683,29981,2.69740516243,0.0726152603141
"Pike County, Mississippi",2012,40300,37.1,17863,2996,14867,35212,2.71070155378,0.0743424317618
"Pike County, Mississippi",2015,40075,36.7,17898,3129,14769,31677,2.71345385605,0.0780786026201
"Pike County, Missouri",2009,18514,39.3,7744,1150,6594,42969,2.80770397331,0.0621151560981
"Pike County, Missouri",2012,18574,39.8,7851,1245,6606,40812,2.81168634575,0.067029180575
"Pike County, Missouri",2015,18517,39.5,7829,1262,6567,41750,2.81970458352,0.0681535885943
"Pike County, Ohio",2009,27855,37.9,12446,1549,10897,35412,2.55620813068,0.0556094058517
"Pike County, Ohio",2012,28652,39.8,12475,1745,10730,39735,2.67027027027,0.060903252827
"Pike County, Ohio",2015,28396,40.8,12530,1590,10940,40283,2.59561243144,0.0559938019439
"Pike County, Pennsylvania",2009,58335,41.8,39928,16988,22940,56447,2.54293809939,0.291214536728
"Pike County, Pennsylvania",2012,57437,43.8,38455,16475,21980,58474,2.61314831665,0.28683601163
"Pike County, Pennsylvania",2015,56632,46,38513,17434,21079,60180,2.68665496466,0.307847153553
"Pima County, Arizona",2009,990213,36.8,419647,49383,370264,45885,2.67434317136,0.0498710883416
"Pima County, Arizona",2012,981048,37.7,441175,58361,382814,46443,2.56272759094,0.0594884246235
"Pima County, Arizona",2015,998537,38,446769,57111,389658,46162,2.5625984838,0.0571946758107
"Pinal County, Arizona",2009,296113,35.3,133597,25252,108345,49301,2.73305644008,0.0852782552607
"Pinal County, Arizona",2012,368374,35.8,158891,36145,122746,50164,3.00110797908,0.0981203885182
"Pinal County, Arizona",2015,389772,37.6,163490,35891,127599,49477,3.0546634378,0.0920820377041
"Pine County, Minnesota",2009,28175,41.4,16651,5686,10965,43618,2.56953944368,0.20181011535
"Pine County, Minnesota",2012,29564,42.4,17247,5280,11967,44291,2.47046043286,0.17859558923
"Pine County, Minnesota",2015,29218,43.7,17228,5867,11361,44549,2.57178065311,0.200800876172
"Pinellas County, Florida",2009,915003,44.7,499682,92341,407341,44838,2.24628259861,0.100918794802
"Pinellas County, Florida",2012,917389,46.3,503181,101740,401441,46051,2.28523992318,0.110901700369
"Pinellas County, Florida",2015,931477,47.1,503658,101005,402653,45819,2.31334921136,0.108435312949
"Pipestone County, Minnesota",2009,9303,43.4,4530,490,4040,38357,2.30272277228,0.0526711813394
"Pipestone County, Minnesota",2012,9536,42.6,4483,604,3879,44817,2.45836555813,0.0633389261745
"Pipestone County, Minnesota",2015,9354,42.3,4458,478,3980,46990,2.35025125628,0.051101133205
"Piscataquis County, Maine",2009,17079,46.3,14244,6593,7651,33944,2.23225722128,0.386029627027
"Piscataquis County, Maine",2012,17432,48.1,15296,7531,7765,36606,2.24494526722,0.432021569527
"Piscataquis County, Maine",2015,17156,49.8,15390,7861,7529,37495,2.27865586399,0.458207041268
"Pitkin County, Colorado",2009,15314,41.9,11220,4068,7152,62318,2.14121923937,0.265639284315
"Pitkin County, Colorado",2012,17000,43,12869,5522,7347,68621,2.31386960664,0.324823529412
"Pitkin County, Colorado",2015,17420,43.4,13027,5457,7570,71196,2.30118890357,0.313260619977
"Pitt County, North Carolina",2009,151931,30.5,71848,8687,63161,36732,2.40545589842,0.0571772712613
"Pitt County, North Carolina",2012,167951,30.9,74990,9510,65480,40452,2.56492058644,0.0566236580908
"Pitt County, North Carolina",2015,173798,31.5,76269,8767,67502,41119,2.57470889751,0.0504436184536
"Pittsburg County, Oklahoma",2009,44514,40.9,22520,4232,18288,38521,2.43405511811,0.0950712135508
"Pittsburg County, Oklahoma",2012,45570,41.2,22662,4050,18612,41206,2.44842037395,0.0888742593812
"Pittsburg County, Oklahoma",2015,44961,40.7,22838,4751,18087,42576,2.48581854371,0.105669357888
"Pittsylvania County, Virginia",2009,61156,42.4,29885,4158,25727,39765,2.37711353831,0.0679900582118
"Pittsylvania County, Virginia",2012,63318,44.3,31227,4978,26249,42229,2.41220617928,0.0786190340819
"Pittsylvania County, Virginia",2015,62794,45.5,31366,5162,26204,41824,2.39635170203,0.0822053062394
"Piute County, Utah",2009,1516,41.5,780,260,520,37000,2.91538461538,0.171503957784
"Piute County, Utah",2012,1699,42.2,855,297,558,37273,3.04480286738,0.174808711006
"Piute County, Utah",2015,1865,42.9,916,359,557,35980,3.34829443447,0.192493297587
"Placer County, California",2009,332059,39.8,143928,18882,125046,73550,2.65549477792,0.0568633887351
"Placer County, California",2012,350074,40.2,152513,20738,131775,73356,2.65660405995,0.0592389037746
"Placer County, California",2015,366280,41,156401,20945,135456,73948,2.70405150012,0.0571830293764
"Plaquemines Parish, Louisiana",2009,22655,36.3,9282,1812,7470,50610,3.0327978581,0.0799823438535
"Plaquemines Parish, Louisiana",2012,23220,36.6,9568,1109,8459,57386,2.74500531978,0.0477605512489
"Plaquemines Parish, Louisiana",2015,23599,36.5,9813,1199,8614,50314,2.73960993731,0.0508072375948
"Platte County, Missouri",2009,87461,37.5,37493,2809,34684,65383,2.52165263522,0.0321171722253
"Platte County, Missouri",2012,89567,38.5,39099,2995,36104,67419,2.48080545092,0.0334386548617
"Platte County, Missouri",2015,93394,38.3,39876,2320,37556,68254,2.4867930557,0.0248409962096
"Platte County, Nebraska",2009,31771,38.6,13319,772,12547,48359,2.53215908185,0.0242988889239
"Platte County, Nebraska",2012,32195,38.7,13403,936,12467,51395,2.58241758242,0.0290728373971
"Platte County, Nebraska",2015,32642,38,13541,834,12707,56318,2.56882033525,0.0255499050303
"Platte County, Wyoming",2009,8344,45.7,4706,871,3835,38954,2.17574967405,0.104386385427
"Platte County, Wyoming",2012,8677,47.8,4664,1002,3662,44917,2.36947023484,0.115477699666
"Platte County, Wyoming",2015,8750,47.9,4691,933,3758,38500,2.32836615221,0.106628571429
"Pleasants County, West Virginia",2009,7459,41.2,3270,673,2597,40093,2.87216018483,0.0902265719265
"Pleasants County, West Virginia",2012,7630,42.1,3386,660,2726,42300,2.798972854,0.086500655308
"Pleasants County, West Virginia",2015,7636,43.6,3382,489,2893,44288,2.63947459385,0.0640387637507
"Plumas County, California",2009,20550,48.7,14875,4825,10050,44727,2.0447761194,0.234793187348
"Plumas County, California",2012,19926,49.4,15542,6433,9109,45358,2.18750686135,0.322844524742
"Plumas County, California",2015,18966,51.3,15674,7457,8217,47333,2.30814165754,0.393177264579
"Plymouth County, Iowa",2009,24356,40.7,10491,730,9761,54226,2.49523614384,0.0299720808014
"Plymouth County, Iowa",2012,24911,42.5,10553,671,9882,58916,2.52084598259,0.0269358917747
"Plymouth County, Iowa",2015,24853,41.8,10624,629,9995,57130,2.48654327164,0.0253088158371
"Plymouth County, Massachusetts",2009,492313,40,192541,18253,174288,72904,2.82470967594,0.0370760065243
"Plymouth County, Massachusetts",2012,495407,41.1,199885,20022,179863,74722,2.7543574832,0.0404152545281
"Plymouth County, Massachusetts",2015,503681,42.1,201930,20505,181425,75459,2.77624913876,0.0407102908388
"Pocahontas County, Iowa",2009,7574,46.8,3993,523,3470,41119,2.18270893372,0.0690520200687
"Pocahontas County, Iowa",2012,7307,47.3,3808,481,3327,42138,2.19627291855,0.0658272889011
"Pocahontas County, Iowa",2015,7127,47.3,3763,566,3197,45069,2.22927744761,0.0794163041953
"Pocahontas County, West Virginia",2009,8599,45.5,7921,4321,3600,32237,2.38861111111,0.502500290731
"Pocahontas County, West Virginia",2012,8750,47.5,8788,5005,3783,32381,2.3129791171,0.572
"Pocahontas County, West Virginia",2015,8697,48.4,8841,5104,3737,36827,2.32726786192,0.5868690353
"Poinsett County, Arkansas",2009,24865,38.2,11556,1393,10163,31894,2.44662009249,0.0560225216167
"Poinsett County, Arkansas",2012,24506,39.6,10957,1628,9329,31743,2.62686247186,0.0664327103566
"Poinsett County, Arkansas",2015,24210,40.2,10920,1634,9286,33070,2.60715054921,0.067492771582
"Pointe Coupee Parish, Louisiana",2009,22326,40.4,11084,2323,8761,37832,2.54833923068,0.104049090746
"Pointe Coupee Parish, Louisiana",2012,22821,42.5,11136,2194,8942,45196,2.55211362111,0.096139520617
"Pointe Coupee Parish, Louisiana",2015,22498,42.6,11257,2531,8726,43825,2.57827183131,0.11249888879
"Polk County, Arkansas",2009,20140,42.5,9678,1799,7879,33274,2.55616194949,0.0893247269116
"Polk County, Arkansas",2012,20535,43.4,10003,1953,8050,33479,2.55093167702,0.0951059167275
"Polk County, Arkansas",2015,20364,43.1,10038,2127,7911,33702,2.57413727721,0.104449027696
"Polk County, Florida",2009,566657,38.7,274964,50665,224299,44043,2.52634652852,0.0894103487648
"Polk County, Florida",2012,604562,39.8,280954,58873,222081,43606,2.72225899559,0.0973812446035
"Polk County, Florida",2015,626676,40.3,282248,60867,221381,43162,2.83075783378,0.0971267449208
"Polk County, Georgia",2009,41414,35.8,16941,1990,14951,39968,2.76998194101,0.0480513835901
"Polk County, Georgia",2012,41350,36.9,16919,2286,14633,38861,2.82580468803,0.0552841596131
"Polk County, Georgia",2015,41215,37.2,16930,2236,14694,37853,2.80488634817,0.0542520926847
"Polk County, Iowa",2009,415949,34.6,182122,11809,170313,55915,2.44226218785,0.0283904997969
"Polk County, Iowa",2012,431811,34.7,183029,11802,171227,58096,2.52186279033,0.0273314019328
"Polk County, Iowa",2015,452369,35,189320,12271,177049,60061,2.555049732,0.0271260851208
"Polk County, Minnesota",2009,30693,40.3,14677,2168,12509,45076,2.45367335518,0.0706349982081
"Polk County, Minnesota",2012,31426,40.3,14613,2044,12569,49859,2.50027846288,0.0650416852288
"Polk County, Minnesota",2015,31547,38.9,14693,1970,12723,53326,2.4795252692,0.0624465083843
"Polk County, Missouri",2009,29983,36.1,12133,1130,11003,36633,2.72498409525,0.0376880232132
"Polk County, Missouri",2012,31035,38.1,13242,1417,11825,38852,2.6245243129,0.0456581279201
"Polk County, Missouri",2015,31107,37.5,13331,1579,11752,41130,2.64695371001,0.0507602790369
"Polk County, Nebraska",2009,5164,44.9,2778,548,2230,44104,2.31569506726,0.106119287374
"Polk County, Nebraska",2012,5371,45.1,2724,499,2225,52012,2.41393258427,0.0929063489108
"Polk County, Nebraska",2015,5271,45.4,2723,544,2179,57312,2.41899954107,0.103206222728
"Polk County, North Carolina",2009,19107,48.8,10322,2070,8252,39246,2.31543868153,0.108337258596
"Polk County, North Carolina",2012,20386,49.5,11373,2604,8769,42762,2.32478047668,0.127734719906
"Polk County, North Carolina",2015,20327,50.9,11450,2749,8701,46528,2.33616825652,0.135238844886
"Polk County, Oregon",2009,74550,38,27379,1807,25572,50750,2.91529798217,0.0242387659289
"Polk County, Oregon",2012,75448,37.4,30190,2217,27973,52365,2.69717227326,0.0293844767257
"Polk County, Oregon",2015,77264,37.4,30651,2193,28458,52821,2.71501862394,0.0283832056326
"Polk County, Tennessee",2009,15735,42,8169,1490,6679,32589,2.35589160054,0.0946933587544
"Polk County, Tennessee",2012,16756,42.5,8057,1531,6526,37235,2.56757585044,0.0913702554309
"Polk County, Tennessee",2015,16687,44,8271,1526,6745,38925,2.47398072646,0.0914484329118
"Polk County, Texas",2009,46326,44.1,22767,5830,16937,32026,2.73519513491,0.1258472564
"Polk County, Texas",2012,45618,43.2,22774,5736,17038,37194,2.67742692804,0.125739839537
"Polk County, Texas",2015,46113,43.5,23624,6144,17480,39662,2.63804347826,0.133237915555
"Polk County, Wisconsin",2009,44147,41.5,24242,6190,18052,50444,2.44554619987,0.140213378032
"Polk County, Wisconsin",2012,44094,42.8,24230,5926,18304,49595,2.40898164336,0.134394702227
"Polk County, Wisconsin",2015,43572,44.1,24251,6257,17994,50714,2.42147382461,0.143601395392
"Ponce Municipio, Puerto Rico",2009,180312,34.8,65218,9004,56214,16774,3.20759953037,0.049935667066
"Ponce Municipio, Puerto Rico",2012,165602,36.6,66003,10301,55702,17459,2.97299917418,0.0622033550319
"Ponce Municipio, Puerto Rico",2015,156054,38.3,66939,11442,55497,16318,2.81193578031,0.0733207735784
"Pondera County, Montana",2009,5909,42.3,2824,365,2459,32790,2.4030093534,0.0617701810797
"Pondera County, Montana",2012,6147,42.9,2674,371,2303,39223,2.66912722536,0.0603546445421
"Pondera County, Montana",2015,6206,41.9,2637,341,2296,42264,2.70296167247,0.0549468256526
"Pontotoc County, Mississippi",2009,28775,35.7,11526,1612,9914,38909,2.90246116603,0.0560208514335
"Pontotoc County, Mississippi",2012,29962,36,12404,2442,9962,40260,3.00762899016,0.0815032374341
"Pontotoc County, Mississippi",2015,30517,37,12501,1959,10542,40645,2.8948017454,0.064193728086
"Pontotoc County, Oklahoma",2009,36388,34.8,16073,1562,14511,36446,2.50761491282,0.0429262394196
"Pontotoc County, Oklahoma",2012,37438,35.5,16558,1866,14692,40680,2.54818949088,0.0498424061114
"Pontotoc County, Oklahoma",2015,38055,35.3,16696,2105,14591,43261,2.60811459119,0.0553146761267
"Pope County, Arkansas",2009,58963,35.4,24673,2466,22207,38511,2.65515378034,0.041822838051
"Pope County, Arkansas",2012,61853,35.3,25555,2951,22604,40948,2.73637409308,0.0477098928104
"Pope County, Arkansas",2015,62830,35.2,25789,3144,22645,39810,2.7745639214,0.0500397899093
"Pope County, Illinois",2009,4071,45.9,2404,653,1751,39153,2.32495716733,0.160402849423
"Pope County, Illinois",2012,4399,47.9,2563,770,1793,39854,2.45343000558,0.175039781769
"Pope County, Illinois",2015,4331,47.7,2652,1059,1593,39223,2.71876961707,0.244516277996
"Pope County, Minnesota",2009,10979,45.2,6398,1567,4831,47001,2.27261436556,0.142727024319
"Pope County, Minnesota",2012,10978,45.8,6439,1682,4757,51148,2.3077569897,0.153215521953
"Pope County, Minnesota",2015,10948,46.5,6495,1686,4809,52785,2.27656477438,0.154000730727
"Poquoson city, Virginia",2009,11775,42.4,4678,234,4444,84688,2.649639964,0.019872611465
"Poquoson city, Virginia",2012,12110,43.3,4731,139,4592,85033,2.63719512195,0.0114781172585
"Poquoson city, Virginia",2015,12077,43.8,4751,109,4642,83735,2.60168031021,0.00902542022025
"Portage County, Ohio",2009,156001,37,65173,5038,60135,50079,2.5941797622,0.0322946647778
"Portage County, Ohio",2012,161178,37.4,67422,6406,61016,51969,2.64156942441,0.0397448783333
"Portage County, Ohio",2015,161897,37.6,67897,6842,61055,52552,2.65165834084,0.0422614378278
"Portage County, Wisconsin",2009,68434,35,29146,2201,26945,50978,2.53976619039,0.0321623754274
"Portage County, Wisconsin",2012,70027,35.8,30020,2038,27982,51422,2.5025730827,0.0291030602482
"Portage County, Wisconsin",2015,70432,36.2,30287,2519,27768,51613,2.53644482858,0.0357649931849
"Porter County, Indiana",2009,160073,37.8,65302,3998,61304,60797,2.6111346731,0.0249761046523
"Porter County, Indiana",2012,164386,38.5,66208,4896,61312,62457,2.68113909186,0.0297835582106
"Porter County, Indiana",2015,166570,39.2,66786,4683,62103,63926,2.68215706166,0.0281143062977
"Portsmouth city, Virginia",2009,100674,33.3,42893,3799,39094,44410,2.57517777664,0.0377356616405
"Portsmouth city, Virginia",2012,95786,35.3,40888,4100,36788,46269,2.603729477,0.0428037500261
"Portsmouth city, Virginia",2015,96135,34.9,40987,4230,36757,45676,2.61542019207,0.0440006241223
"Posey County, Indiana",2009,26244,40.8,11706,1260,10446,57775,2.51234922458,0.0480109739369
"Posey County, Indiana",2012,25840,41.6,11246,1183,10063,57777,2.56782271688,0.0457817337461
"Posey County, Indiana",2015,25567,42.5,11301,1203,10098,58101,2.53188750248,0.0470528415536
"Pottawatomie County, Kansas",2009,19391,37,8292,684,7608,51716,2.54876445846,0.0352740962302
"Pottawatomie County, Kansas",2012,21620,35.1,8622,714,7908,56775,2.73394031361,0.0330249768733
"Pottawatomie County, Kansas",2015,22625,34.7,8918,726,8192,60216,2.76184082031,0.0320883977901
"Pottawatomie County, Oklahoma",2009,68955,36.6,28747,3888,24859,38836,2.77384448288,0.0563845986513
"Pottawatomie County, Oklahoma",2012,69676,37.3,29166,3674,25492,42467,2.73324964695,0.0527297778288
"Pottawatomie County, Oklahoma",2015,71136,37.6,29538,3542,25996,44688,2.73642098784,0.0497919478183
"Pottawattamie County, Iowa",2009,89627,38.3,39464,2820,36644,49192,2.44588472874,0.0314637330269
"Pottawattamie County, Iowa",2012,92793,38.5,39350,2878,36472,49941,2.54422570739,0.0310152705484
"Pottawattamie County, Iowa",2015,93213,39.2,39532,2849,36683,51976,2.54104080909,0.0305644062523
"Potter County, Pennsylvania",2009,17142,43.2,12698,5698,7000,37044,2.44885714286,0.332399953331
"Potter County, Pennsylvania",2012,17466,44.8,12927,5870,7057,40970,2.47498937225,0.336081529829
"Potter County, Pennsylvania",2015,17377,45.8,12848,6179,6669,40654,2.60563802669,0.355584968637
"Potter County, South Dakota",2009,2149,50.6,1723,674,1049,38345,2.04861773117,0.313634248488
"Potter County, South Dakota",2012,2327,50.2,1582,591,991,45511,2.34813319879,0.253975075204
"Potter County, South Dakota",2015,2307,52.5,1557,501,1056,46081,2.18465909091,0.217165149545
"Potter County, Texas",2009,120797,32.2,48398,5694,42704,34827,2.828704571,0.0471369322086
"Potter County, Texas",2012,121099,32.8,47462,5032,42430,37848,2.85408908791,0.0415527791311
"Potter County, Texas",2015,122352,33.3,48557,5330,43227,38159,2.83045318898,0.0435628350987
"Powder River County, Montana",2009,1668,42.9,989,270,719,39489,2.31988873435,0.161870503597
"Powder River County, Montana",2012,1639,47.4,1014,320,694,42500,2.36167146974,0.19524100061
"Powder River County, Montana",2015,1703,52,1021,265,756,46346,2.25264550265,0.155607751028
"Powell County, Kentucky",2009,13589,40.5,5846,820,5026,30442,2.70374054914,0.0603429244242
"Powell County, Kentucky",2012,12638,37.9,5608,930,4678,27555,2.7015818726,0.0735875929736
"Powell County, Kentucky",2015,12447,38.4,5596,829,4767,29736,2.61107614852,0.0666023941512
"Powell County, Montana",2009,7057,42.7,2933,536,2397,40329,2.94409678765,0.0759529545132
"Powell County, Montana",2012,7067,45.4,3094,688,2406,40765,2.93724023275,0.097353898401
"Powell County, Montana",2015,6975,45.4,3090,710,2380,40000,2.93067226891,0.101792114695
"Power County, Idaho",2009,7689,34.5,3001,300,2701,37455,2.84672343576,0.0390167772142
"Power County, Idaho",2012,7717,34,2952,399,2553,41950,3.02271837054,0.0517040300635
"Power County, Idaho",2015,7731,34.2,2944,381,2563,44779,3.01638704643,0.0492821109818
"Poweshiek County, Iowa",2009,18564,41.2,9070,1354,7716,50202,2.40590979782,0.0729368670545
"Poweshiek County, Iowa",2012,18888,41.3,8940,1351,7589,50703,2.48886546317,0.0715268953833
"Poweshiek County, Iowa",2015,18705,40.9,8968,1617,7351,51006,2.54455176167,0.0864474739374
"Powhatan County, Virginia",2009,27334,39,8435,311,8124,75118,3.36459871984,0.0113777712739
"Powhatan County, Virginia",2012,28003,42.1,10040,611,9429,76495,2.96988015696,0.0218190908117
"Powhatan County, Virginia",2015,28207,43.7,10272,542,9730,77896,2.89897225077,0.0192150884532
"Prairie County, Arkansas",2009,8776,43.1,4988,1120,3868,32176,2.26887280248,0.127620783956
"Prairie County, Arkansas",2012,8659,44.6,4526,756,3770,35806,2.29681697613,0.0873080032336
"Prairie County, Arkansas",2015,8402,45.4,4497,671,3826,35833,2.19602718244,0.0798619376339
"Prairie County, Montana",2009,1004,55.9,719,211,508,36618,1.97637795276,0.21015936255
"Prairie County, Montana",2012,1193,56.3,653,129,524,34875,2.27671755725,0.108130762783
"Prairie County, Montana",2015,1372,51.9,673,126,547,42383,2.50822669104,0.0918367346939
"Pratt County, Kansas",2009,9379,44.2,4751,697,4054,43545,2.31351751357,0.0743149589508
"Pratt County, Kansas",2012,9670,40.5,4529,503,4026,43880,2.40188772976,0.0520165460186
"Pratt County, Kansas",2015,9739,39.1,4485,583,3902,49550,2.4958995387,0.0598624088715
"Preble County, Ohio",2009,41689,40.6,17992,1464,16528,48743,2.52232575024,0.035117177193
"Preble County, Ohio",2012,42240,41,17869,1473,16396,48899,2.57623810686,0.0348721590909
"Preble County, Ohio",2015,41682,41.9,17851,1727,16124,47818,2.58509054825,0.041432752747
"Prentiss County, Mississippi",2009,25594,38,11259,1556,9703,29250,2.63774090487,0.0607954989451
"Prentiss County, Mississippi",2012,25384,38.7,11063,1390,9673,33294,2.62421172335,0.0547589032461
"Prentiss County, Mississippi",2015,25380,39.2,11073,1345,9728,32945,2.60896381579,0.0529944838455
"Presidio County, Texas",2009,7536,39.2,4125,1325,2800,29492,2.69142857143,0.175822717622
"Presidio County, Texas",2012,7678,39,3843,1189,2654,29400,2.89299171063,0.154858035947
"Presidio County, Texas",2015,7304,41,3952,1318,2634,32132,2.77296886864,0.180449069003
"Presque Isle County, Michigan",2009,13742,49.6,10628,4153,6475,37536,2.12231660232,0.302212196187
"Presque Isle County, Michigan",2012,13368,51.6,10441,4318,6123,39109,2.18324350808,0.323010173549
"Presque Isle County, Michigan",2015,13037,53.2,10414,4415,5999,41213,2.17319553259,0.33865153026
"Preston County, West Virginia",2009,30178,41.5,13934,1988,11946,37142,2.52620123891,0.0658758035655
"Preston County, West Virginia",2012,33471,41.7,15028,2248,12780,45538,2.61901408451,0.0671626183861
"Preston County, West Virginia",2015,33809,42.3,15060,2588,12472,45064,2.71079217447,0.076547664823
"Price County, Wisconsin",2009,14564,46.8,9879,2939,6940,40542,2.09855907781,0.201798956331
"Price County, Wisconsin",2012,14141,48.8,10799,3909,6890,42206,2.05239477504,0.276430238314
"Price County, Wisconsin",2015,13800,50.5,10975,4275,6700,43137,2.05970149254,0.309782608696
"Prince Edward County, Virginia",2009,21581,31.4,8435,1793,6642,36242,3.24917193616,0.0830823409481
"Prince Edward County, Virginia",2012,23017,33.4,9127,1900,7227,36743,3.18486232185,0.082547682148
"Prince Edward County, Virginia",2015,23022,32.1,9269,1860,7409,41697,3.10730193009,0.0807922856398
"Prince George County, Virginia",2009,36364,33.8,12215,1340,10875,66049,3.34381609195,0.0368496315037
"Prince George County, Virginia",2012,36013,37.6,12059,1248,10811,63031,3.33114420498,0.0346541526671
"Prince George County, Virginia",2015,37380,37.1,12192,1090,11102,61857,3.36696090794,0.0291599785982
"Prince George's County, Maryland",2009,834986,34.8,319039,21102,297937,70753,2.80255893024,0.0252722800143
"Prince George's County, Maryland",2012,865443,35,327803,25120,302683,73568,2.85923887367,0.0290255972953
"Prince George's County, Maryland",2015,892816,35.8,329897,24287,305610,74260,2.92142272831,0.0272026935001
"Prince William County, Virginia",2009,360910,33,132612,8855,123757,88850,2.91627948318,0.0245352026821
"Prince William County, Virginia",2012,404011,33.5,137592,7949,129643,96160,3.11633485803,0.0196752068632
"Prince William County, Virginia",2015,437271,34,142786,5992,136794,98657,3.19656563884,0.0137031726321
"Prince of Wales-Hyder Census Area, Alaska",2009,5572,37.9,3138,819,2319,45889,2.40275981026,0.146984924623
"Prince of Wales-Hyder Census Area, Alaska",2012,5603,39,2987,696,2291,45774,2.44565691838,0.124219168303
"Prince of Wales-Hyder Census Area, Alaska",2015,6376,39.7,3334,1066,2268,48523,2.81128747795,0.167189460477
"Providence County, Rhode Island",2009,629400,36.4,256413,22867,233546,49130,2.69497229668,0.0363314267556
"Providence County, Rhode Island",2012,627414,37,264255,25732,238523,49213,2.630413,0.0410127921914
"Providence County, Rhode Island",2015,630459,37.1,263890,25606,238284,49743,2.64583018583,0.0406148536225
"Prowers County, Colorado",2009,13206,35.5,6111,1068,5043,35166,2.61867935753,0.0808723307587
"Prowers County, Colorado",2012,12539,36.7,5935,940,4995,33671,2.51031031031,0.0749661057501
"Prowers County, Colorado",2015,12235,37.6,5899,1043,4856,40179,2.51956342669,0.0852472415202
"Pueblo County, Colorado",2009,153814,38,66822,7015,59807,40805,2.57183941679,0.0456070318697
"Pueblo County, Colorado",2012,159072,38.8,69366,7276,62090,41820,2.56195844742,0.0457402937035
"Pueblo County, Colorado",2015,161519,38.8,69959,7071,62888,41286,2.56835962346,0.0437781313654
"Pulaski County, Arkansas",2009,375518,35.5,174286,18655,155631,44370,2.4128740418,0.0496780447275
"Pulaski County, Arkansas",2012,383185,36,176158,20642,155516,46102,2.46395869235,0.0538695408223
"Pulaski County, Arkansas",2015,390463,36.4,179916,25676,154240,46140,2.53152878631,0.0657578310877
"Pulaski County, Georgia",2009,9778,41.3,4382,781,3601,32053,2.71535684532,0.0798731847003
"Pulaski County, Georgia",2012,11801,43.3,5201,904,4297,34659,2.74633465208,0.0766036776544
"Pulaski County, Georgia",2015,11590,41.3,4844,897,3947,38750,2.93640739802,0.0773943054357
"Pulaski County, Illinois",2009,6430,39.7,3448,616,2832,28775,2.27048022599,0.095800933126
"Pulaski County, Illinois",2012,6107,43.5,3166,752,2414,31795,2.52982601491,0.123137383331
"Pulaski County, Illinois",2015,5871,43.5,3139,805,2334,31980,2.51542416452,0.137114631238
"Pulaski County, Indiana",2009,13739,41.3,6281,1078,5203,46141,2.64059196617,0.0784627702162
"Pulaski County, Indiana",2012,13395,41.6,6074,1003,5071,43506,2.64149083021,0.0748786860769
"Pulaski County, Indiana",2015,13047,41.3,6043,859,5184,43836,2.51678240741,0.0658388901663
"Pulaski County, Kentucky",2009,59937,40.4,27980,4297,23683,32434,2.53080268547,0.071691943207
"Pulaski County, Kentucky",2012,63045,40.9,31205,4830,26375,32788,2.39033175355,0.0766119438496
"Pulaski County, Kentucky",2015,63635,42,31267,5674,25593,34790,2.48642206853,0.0891647678165
"Pulaski County, Missouri",2009,44684,26.6,16466,2056,14410,42476,3.10090215128,0.0460119953451
"Pulaski County, Missouri",2012,51620,26.6,17820,2102,15718,47251,3.28413284133,0.0407206509105
"Pulaski County, Missouri",2015,53443,26.8,18382,2947,15435,47931,3.46245545837,0.055142862489
"Pulaski County, Virginia",2009,34910,42.7,17196,2498,14698,38234,2.37515308205,0.0715554282441
"Pulaski County, Virginia",2012,34869,44.2,17225,2351,14874,43072,2.34429205325,0.0674237861711
"Pulaski County, Virginia",2015,34528,45.2,17256,2637,14619,47495,2.36185785621,0.0763727988879
"Pushmataha County, Oklahoma",2009,11618,41.5,6018,1259,4759,27536,2.4412691742,0.108366328112
"Pushmataha County, Oklahoma",2012,11449,44.4,6107,1256,4851,28587,2.36013193156,0.109703904271
"Pushmataha County, Oklahoma",2015,11226,44.8,6122,1373,4749,32445,2.36386607707,0.122305362551
"Putnam County, Florida",2009,73250,41.4,35699,7706,27993,33711,2.61672560997,0.105201365188
"Putnam County, Florida",2012,74224,43.2,37208,8444,28764,34429,2.58044778195,0.113763742186
"Putnam County, Florida",2015,72696,44.1,36824,9141,27683,31715,2.62601596648,0.125742819412
"Putnam County, Georgia",2009,20145,42.8,12367,3988,8379,41297,2.40422484783,0.197964755522
"Putnam County, Georgia",2012,21184,44.8,12764,4049,8715,40115,2.43075157774,0.191134818731
"Putnam County, Georgia",2015,21247,45.6,12748,4286,8462,44299,2.51087213425,0.201722596131
"Putnam County, Illinois",2009,5977,43.8,3125,601,2524,54528,2.36806656101,0.100552116446
"Putnam County, Illinois",2012,5968,44.6,3083,630,2453,54467,2.43293925805,0.105563002681
"Putnam County, Illinois",2015,5822,46,3106,653,2453,56358,2.37342030167,0.112160769495
"Putnam County, Indiana",2009,36993,36.6,14451,1768,12683,49821,2.91673894189,0.0477928256697
"Putnam County, Indiana",2012,37995,38,14697,2204,12493,50480,3.04130312975,0.0580076325832
"Putnam County, Indiana",2015,37650,37.5,14774,2125,12649,51355,2.97651988299,0.0564409030544
"Putnam County, Missouri",2009,4906,41.2,2891,612,2279,33992,2.152698552,0.124745209947
"Putnam County, Missouri",2012,4976,45.2,2976,652,2324,35233,2.14113597246,0.131028938907
"Putnam County, Missouri",2015,4895,46.4,2962,766,2196,36346,2.22905282332,0.156486210419
"Putnam County, New York",2009,99111,40.2,36464,2600,33864,88036,2.92673635719,0.0262332132659
"Putnam County, New York",2012,99702,41.7,38135,3047,35088,95259,2.84148426813,0.0305610719945
"Putnam County, New York",2015,99488,42.8,38289,4199,34090,96148,2.91839249047,0.0422060952075
"Putnam County, Ohio",2009,34529,37.9,13465,771,12694,55630,2.72010398614,0.0223290567349
"Putnam County, Ohio",2012,34445,38.8,13734,651,13083,60693,2.63280593136,0.0188996951662
"Putnam County, Ohio",2015,34184,39.7,13768,719,13049,60524,2.6196643421,0.0210332319214
"Putnam County, Tennessee",2009,69938,35.4,30279,3507,26772,34705,2.61235619304,0.0501444136235
"Putnam County, Tennessee",2012,72172,35.9,31837,3548,28289,34107,2.55123899749,0.0491603391897
"Putnam County, Tennessee",2015,73810,36.1,32648,2927,29721,35343,2.48342922513,0.0396558731879
"Putnam County, West Virginia",2009,54881,40.1,23456,2174,21282,51186,2.57875199699,0.039612980813
"Putnam County, West Virginia",2012,55660,41.2,23426,2296,21130,56081,2.63416942735,0.0412504491556
"Putnam County, West Virginia",2015,56596,41,23699,1992,21707,56774,2.60726954439,0.0351968336985
"Quay County, New Mexico",2009,9007,45.1,5691,1839,3852,29797,2.33826583593,0.20417453092
"Quay County, New Mexico",2012,8956,45.5,5567,2058,3509,33039,2.55229410088,0.229790084859
"Quay County, New Mexico",2015,8698,45.7,5551,2204,3347,29113,2.59874514491,0.253391584272
"Quebradillas Municipio, Puerto Rico",2009,27878,34,8854,1194,7660,12045,3.63942558747,0.0428294712677
"Quebradillas Municipio, Puerto Rico",2012,25874,36.9,9592,1059,8533,14255,3.0322278214,0.0409291180335
"Quebradillas Municipio, Puerto Rico",2015,25205,39.1,10380,1337,9043,15806,2.7872387482,0.0530450307479
"Queen Anne's County, Maryland",2009,46653,41.3,19426,2257,17169,78615,2.71728114625,0.04837845369
"Queen Anne's County, Maryland",2012,47894,42.2,20157,2992,17165,86013,2.790212642,0.0624712907671
"Queen Anne's County, Maryland",2015,48600,43.5,20577,3055,17522,85963,2.77365597535,0.0628600823045
"Queens County, New York",2009,2278860,37.4,836112,56336,779776,54870,2.92245465364,0.0247211324961
"Queens County, New York",2012,2235008,37.3,836722,60411,776311,56780,2.87901111797,0.0270294334517
"Queens County, New York",2015,2301139,37.7,844189,63545,780644,57720,2.9477444264,0.0276145856465
"Quitman County, Georgia",2009,2647,36.4,1920,846,1074,30985,2.46461824953,0.31960710238
"Quitman County, Georgia",2012,2542,40.4,1892,913,979,32750,2.59652706844,0.359166011015
"Quitman County, Georgia",2015,2326,49.2,2090,1075,1015,31487,2.29162561576,0.462166809974
"Quitman County, Mississippi",2009,8821,34.5,3986,554,3432,24491,2.57022144522,0.0628046706723
"Quitman County, Mississippi",2012,8171,38.5,3606,451,3155,23115,2.58985736926,0.0551952025456
"Quitman County, Mississippi",2015,7761,38.5,3588,535,3053,24583,2.54208974779,0.0689344156681
"Rabun County, Georgia",2009,16464,43.9,12609,5309,7300,34308,2.25534246575,0.322461127308
"Rabun County, Georgia",2012,16297,45.4,12337,5479,6858,32995,2.37634878973,0.336196846045
"Rabun County, Georgia",2015,16266,47.8,12441,5652,6789,35211,2.39593460009,0.347473257101
"Racine County, Wisconsin",2009,199147,37.9,80409,5434,74975,54203,2.65617872624,0.0272863763953
"Racine County, Wisconsin",2012,195024,39,82069,6294,75775,54900,2.57372484329,0.0322729510214
"Racine County, Wisconsin",2015,194895,39.7,82261,7078,75183,55584,2.59227484937,0.0363169912004
"Radford city, Virginia",2009,16062,21.8,6414,831,5583,29589,2.87694787749,0.0517370190512
"Radford city, Virginia",2012,16511,21.9,6443,819,5624,29757,2.93581081081,0.0496032947732
"Radford city, Virginia",2015,17057,22.3,6507,1030,5477,29912,3.11429614753,0.0603857653749
"Rains County, Texas",2009,11104,43.7,4825,1042,3783,40873,2.93523658472,0.0938400576369
"Rains County, Texas",2012,10976,45.9,5250,994,4256,45099,2.57894736842,0.0905612244898
"Rains County, Texas",2015,11037,47.6,5282,1081,4201,48448,2.62723161152,0.0979432816889
"Raleigh County, West Virginia",2009,78686,40.6,37048,4827,32221,38023,2.44207194066,0.0613450931551
"Raleigh County, West Virginia",2012,78852,40.7,35968,4468,31500,39325,2.50323809524,0.0566631157104
"Raleigh County, West Virginia",2015,78493,41.6,36000,4726,31274,41032,2.5098484364,0.0602091906285
"Ralls County, Missouri",2009,9691,42.3,4740,969,3771,46875,2.56987536462,0.0999896811475
"Ralls County, Missouri",2012,10198,44.2,5144,1023,4121,50145,2.47464207717,0.100313787017
"Ralls County, Missouri",2015,10243,45.1,5137,1116,4021,47345,2.54737627456,0.108952455335
"Ramsey County, Minnesota",2009,500436,35.1,214720,13496,201224,52329,2.48695980599,0.0269684834824
"Ramsey County, Minnesota",2012,510885,34.6,217316,12529,204787,53152,2.49471401993,0.0245241101226
"Ramsey County, Minnesota",2015,527411,34.6,218024,11167,206857,56104,2.54964057296,0.0211732406036
"Ramsey County, North Dakota",2009,11254,42.5,5812,912,4900,43009,2.29673469388,0.0810378532077
"Ramsey County, North Dakota",2012,11450,42.3,5648,767,4881,46119,2.34583077238,0.0669868995633
"Ramsey County, North Dakota",2015,11566,42.5,5747,731,5016,50841,2.30582137161,0.0632024900571
"Randall County, Texas",2009,112802,34.6,46104,3666,42438,54311,2.65804232056,0.0324994237691
"Randall County, Texas",2012,121090,35.3,51482,4170,47312,57509,2.55939296584,0.0344371954744
"Randall County, Texas",2015,126782,35.4,52988,4218,48770,60972,2.59958991183,0.0332697070562
"Randolph County, Alabama",2009,22504,40.3,10618,2784,7834,35137,2.87260658667,0.123711340206
"Randolph County, Alabama",2012,22843,40.7,11910,3109,8801,35074,2.59550051131,0.136102963709
"Randolph County, Alabama",2015,22648,42.8,11940,3025,8915,36924,2.54043746495,0.133565877782
"Randolph County, Arkansas",2009,18058,41,8797,1307,7490,28427,2.41094793057,0.0723778934544
"Randolph County, Arkansas",2012,17992,41.3,8518,1244,7274,32539,2.47346714325,0.0691418408181
"Randolph County, Arkansas",2015,17695,42.9,8521,1186,7335,34044,2.4124062713,0.0670245832156
"Randolph County, Georgia",2009,7259,36.5,3427,933,2494,28193,2.91058540497,0.128530100565
"Randolph County, Georgia",2012,7596,39.2,3933,1100,2833,32688,2.68125661843,0.144813059505
"Randolph County, Georgia",2015,7315,39.2,3667,873,2794,28377,2.61811023622,0.119343814081
"Randolph County, Illinois",2009,32851,40,13737,1644,12093,43395,2.7165302241,0.0500441386868
"Randolph County, Illinois",2012,33353,41.2,13718,1898,11820,48383,2.8217428088,0.0569064252091
"Randolph County, Illinois",2015,33069,41.7,13762,1867,11895,48158,2.78007566204,0.0564577096374
"Randolph County, Indiana",2009,25914,40.5,12085,1387,10698,40993,2.42232192933,0.0535231920969
"Randolph County, Indiana",2012,26101,41.2,11743,1419,10324,40910,2.52818674932,0.0543657331137
"Randolph County, Indiana",2015,25596,42.2,11657,1128,10529,40810,2.43100009498,0.0440693858415
"Randolph County, Missouri",2009,25528,37.6,11118,1584,9534,34827,2.67757499476,0.0620495142589
"Randolph County, Missouri",2012,25388,37.9,10725,1747,8978,38067,2.82780129205,0.0688120371829
"Randolph County, Missouri",2015,25135,38.4,10671,2221,8450,37832,2.97455621302,0.0883628406604
"Randolph County, North Carolina",2009,139443,38.7,59828,5590,54238,39642,2.57094656883,0.0400880646572
"Randolph County, North Carolina",2012,141568,39.6,61014,5982,55032,41575,2.57246692833,0.0422553119349
"Randolph County, North Carolina",2015,142370,40.5,61221,6714,54507,41947,2.61195809713,0.0471588115474
"Randolph County, West Virginia",2009,28377,41.9,13995,2734,11261,34103,2.51993606252,0.0963456320259
"Randolph County, West Virginia",2012,29361,43.6,14189,2951,11238,37350,2.61265349706,0.100507475903
"Randolph County, West Virginia",2015,29365,43.2,14173,2610,11563,39457,2.53956585661,0.0888813213009
"Rankin County, Mississippi",2009,137817,35.1,54545,3690,50855,53240,2.70999901681,0.0267746359303
"Rankin County, Mississippi",2012,142136,36.2,56535,3665,52870,57593,2.68840552298,0.0257851635054
"Rankin County, Mississippi",2015,146761,36.9,57764,3964,53800,58801,2.72789962825,0.0270099004504
"Ransom County, North Dakota",2009,5670,42.6,2739,307,2432,43944,2.33141447368,0.0541446208113
"Ransom County, North Dakota",2012,5498,44.5,2661,363,2298,47866,2.39251523064,0.0660240087304
"Ransom County, North Dakota",2015,5453,44.5,2670,318,2352,56500,2.31845238095,0.0583165230149
"Rapides Parish, Louisiana",2009,132128,36.4,56185,6757,49428,39456,2.67314072995,0.0511398038266
"Rapides Parish, Louisiana",2012,131655,37.4,55849,8408,47441,40946,2.77513121562,0.0638638866735
"Rapides Parish, Louisiana",2015,132225,37.4,56740,9066,47674,40734,2.7735243529,0.0685649461146
"Rappahannock County, Virginia",2009,7171,45.3,3722,646,3076,58500,2.33127438231,0.0900850648445
"Rappahannock County, Virginia",2012,7440,48,3872,596,3276,57837,2.27106227106,0.0801075268817
"Rappahannock County, Virginia",2015,7431,49.1,3936,663,3273,57210,2.27039413382,0.0892208316512
"Ravalli County, Montana",2009,40060,44.1,16535,2074,14461,42654,2.77020952908,0.0517723414878
"Ravalli County, Montana",2012,40311,46.3,19440,2783,16657,40525,2.42006363691,0.069038227779
"Ravalli County, Montana",2015,40823,47.6,19566,2917,16649,39480,2.45197909784,0.0714548171374
"Rawlins County, Kansas",2009,2517,50.4,1577,345,1232,34444,2.04301948052,0.137067938021
"Rawlins County, Kansas",2012,2555,50.8,1463,244,1219,40896,2.09598031173,0.0954990215264
"Rawlins County, Kansas",2015,2545,50.9,1458,246,1212,41579,2.0998349835,0.0966601178782
"Ray County, Missouri",2009,23507,38.9,10164,869,9295,51556,2.52899408284,0.0369677117454
"Ray County, Missouri",2012,23422,40,9989,931,9058,52656,2.5857805255,0.0397489539749
"Ray County, Missouri",2015,23031,41.5,9966,1320,8646,52526,2.66377515614,0.0573140549694
"Reagan County, Texas",2009,2982,32.6,1462,262,1200,51619,2.485,0.0878604963112
"Reagan County, Texas",2012,3384,34.4,1438,266,1172,55968,2.88737201365,0.0786052009456
"Reagan County, Texas",2015,3598,35.9,1419,202,1217,52181,2.95645028759,0.0561423012785
"Real County, Texas",2009,2966,49,2156,1012,1144,29796,2.59265734266,0.341200269724
"Real County, Texas",2012,3326,51.8,2568,1350,1218,31713,2.73070607553,0.405892964522
"Real County, Texas",2015,3356,54.1,2725,1501,1224,36523,2.74183006536,0.44725864124
"Red Lake County, Minnesota",2009,4157,42.8,1945,219,1726,45833,2.40845886443,0.0526822227568
"Red Lake County, Minnesota",2012,4100,41.6,1952,261,1691,48750,2.42460082791,0.0636585365854
"Red Lake County, Minnesota",2015,4061,42.3,1946,285,1661,50332,2.44491270319,0.0701797586801
"Red River County, Texas",2009,13076,43.7,7150,1853,5297,38053,2.46856711346,0.141710003059
"Red River County, Texas",2012,12795,44.5,6848,1903,4945,34430,2.58746208291,0.148729972646
"Red River County, Texas",2015,12567,44.6,6848,1652,5196,31563,2.41859122402,0.131455399061
"Red River Parish, Louisiana",2009,9117,35.7,4209,1000,3209,32242,2.84107198504,0.109685203466
"Red River Parish, Louisiana",2012,9068,38.3,4131,906,3225,36591,2.81178294574,0.0999117776798
"Red River Parish, Louisiana",2015,8838,39.8,4132,698,3434,38000,2.57367501456,0.0789771441503
"Red Willow County, Nebraska",2009,10755,42.6,5354,679,4675,39674,2.30053475936,0.0631334263133
"Red Willow County, Nebraska",2012,11013,42.4,5272,473,4799,45206,2.29485309439,0.0429492418051
"Red Willow County, Nebraska",2015,10946,41.8,5279,628,4651,42931,2.35347237153,0.0573725561849
"Redwood County, Minnesota",2009,15625,43,7317,754,6563,44034,2.38077098888,0.048256
"Redwood County, Minnesota",2012,16006,42.6,7257,695,6562,46071,2.43919536727,0.0434212170436
"Redwood County, Minnesota",2015,15723,43.2,7249,942,6307,47211,2.49294434755,0.0599122304904
"Reeves County, Texas",2009,11100,38.2,5119,1208,3911,33569,2.83814881105,0.108828828829
"Reeves County, Texas",2012,13606,36.4,4658,1184,3474,39577,3.91652274036,0.0870204321623
"Reeves County, Texas",2015,14179,35.6,4631,915,3716,43540,3.81566200215,0.0645320544467
"Refugio County, Texas",2009,7364,43.1,3741,944,2797,39914,2.63282087951,0.128191200435
"Refugio County, Texas",2012,7352,43.7,3726,942,2784,42589,2.6408045977,0.128128400435
"Refugio County, Texas",2015,7277,42.7,3727,974,2753,44240,2.64329822012,0.13384636526
"Reno County, Kansas",2009,63214,39.9,28206,2195,26011,41365,2.43027949714,0.0347233207834
"Reno County, Kansas",2012,64346,40,28281,2329,25952,43649,2.47942355117,0.0361949460728
"Reno County, Kansas",2015,64058,39.5,28274,3177,25097,45288,2.5524166235,0.049595678916
"Rensselaer County, New York",2009,155043,39.1,68951,7740,61211,54221,2.53292708827,0.0499216346433
"Rensselaer County, New York",2012,159464,39.6,71366,7414,63952,58959,2.49349512134,0.0464932523955
"Rensselaer County, New York",2015,159900,39.8,71742,8295,63447,60709,2.52021372169,0.0518761726079
"Renville County, Minnesota",2009,16101,43,7484,783,6701,46588,2.40277570512,0.0486305198435
"Renville County, Minnesota",2012,15653,43.9,7363,945,6418,49800,2.43892178249,0.0603718137098
"Renville County, Minnesota",2015,15171,44.5,7330,989,6341,52149,2.39252483835,0.0651901654472
"Renville County, North Dakota",2009,2291,45.4,1476,394,1082,43137,2.11737523105,0.171977302488
"Renville County, North Dakota",2012,2468,45.8,1326,293,1033,57361,2.38915779284,0.118719611021
"Renville County, North Dakota",2015,2562,39.9,1253,233,1020,65125,2.51176470588,0.0909445745511
"Republic County, Kansas",2009,4922,50.1,2974,652,2322,36510,2.11972437554,0.132466477042
"Republic County, Kansas",2012,4965,50.8,2883,561,2322,41000,2.13824289406,0.112990936556
"Republic County, Kansas",2015,4806,50.9,2877,602,2275,40449,2.11252747253,0.125260091552
"Reynolds County, Missouri",2009,6367,44.6,3910,1061,2849,33052,2.23481923482,0.166640490027
"Reynolds County, Missouri",2012,6682,44.8,4029,1283,2746,33326,2.43335761107,0.192008380724
"Reynolds County, Missouri",2015,6578,46.6,4015,1354,2661,35648,2.47200300639,0.20583764062
"Rhea County, Tennessee",2009,30633,39.2,13777,2030,11747,34830,2.6077296331,0.0662684033559
"Rhea County, Tennessee",2012,31817,40,14334,2443,11891,36470,2.67572113363,0.0767828519345
"Rhea County, Tennessee",2015,32394,40.5,14406,1861,12545,36146,2.58222399362,0.057448910292
"Rice County, Kansas",2009,10152,37.7,4634,550,4084,43592,2.48579823702,0.0541765169425
"Rice County, Kansas",2012,10077,38.7,4545,681,3864,45703,2.60791925466,0.0675796367967
"Rice County, Kansas",2015,10014,37.9,4548,667,3881,48460,2.58026281886,0.0666067505492
"Rice County, Minnesota",2009,61865,34.5,23480,1975,21505,57754,2.87677284352,0.0319243514103
"Rice County, Minnesota",2012,64171,34.9,24414,1982,22432,60438,2.86069008559,0.0308862258653
"Rice County, Minnesota",2015,64886,36.4,24531,1999,22532,59598,2.87972661104,0.0308078784329
"Rich County, Utah",2009,2067,40.1,3147,2364,783,50899,2.6398467433,1.14368650218
"Rich County, Utah",2012,2264,33,2901,2193,708,49803,3.19774011299,0.968639575972
"Rich County, Utah",2015,2292,34.7,2876,2236,640,50781,3.58125,0.975567190227
"Richardson County, Nebraska",2009,8358,45.8,4574,603,3971,36698,2.10475950642,0.0721464465183
"Richardson County, Nebraska",2012,8355,47.7,4405,623,3782,38977,2.20914859863,0.074566128067
"Richardson County, Nebraska",2015,8201,47,4382,621,3761,42750,2.1805370912,0.0757224728692
"Richland County, Illinois",2009,15621,40.9,7745,780,6965,39068,2.24278535535,0.0499327827924
"Richland County, Illinois",2012,16181,43.6,7524,866,6658,43240,2.43030940222,0.0535195599778
"Richland County, Illinois",2015,16127,42.4,7492,989,6503,44127,2.47993233892,0.0613257270416
"Richland County, Montana",2009,9128,42.8,4389,446,3943,49553,2.31498858737,0.0488606485539
"Richland County, Montana",2012,9961,40.5,4629,443,4186,56050,2.37959866221,0.0444734464411
"Richland County, Montana",2015,11132,38,4916,495,4421,65084,2.51798235693,0.0444664031621
"Richland County, North Dakota",2009,16563,38.7,7695,1018,6677,45403,2.48060506215,0.0614622954779
"Richland County, North Dakota",2012,16295,39.9,7511,1049,6462,51272,2.52166511916,0.0643755753299
"Richland County, North Dakota",2015,16317,38.9,7619,998,6621,55390,2.46443135478,0.0611632040203
"Richland County, Ohio",2009,125791,39.8,54947,5352,49595,42233,2.53636455288,0.0425467640769
"Richland County, Ohio",2012,124286,41,54563,5927,48636,42894,2.55543219015,0.0476883961186
"Richland County, Ohio",2015,122312,41.3,54353,6250,48103,41877,2.54271043386,0.0510988292236
"Richland County, South Carolina",2009,359144,32.6,153045,15766,137279,47969,2.61616124826,0.0438988260976
"Richland County, South Carolina",2012,384596,32.8,161660,18448,143212,48420,2.68550121498,0.0479672175478
"Richland County, South Carolina",2015,397899,32.7,165671,20602,145069,49131,2.74282582771,0.0517769584744
"Richland County, Wisconsin",2009,17991,42.2,8649,1131,7518,43422,2.39305666401,0.0628647657162
"Richland County, Wisconsin",2012,18020,42.9,8856,1465,7391,44821,2.43810039237,0.0812985571587
"Richland County, Wisconsin",2015,17746,44.1,8848,1301,7547,44810,2.35139790645,0.0733122957286
"Richland Parish, Louisiana",2009,20415,37.2,8904,1200,7704,35610,2.64992211838,0.0587803085966
"Richland Parish, Louisiana",2012,20785,38.2,8655,1249,7406,39493,2.80650823656,0.060091412076
"Richland Parish, Louisiana",2015,20777,38,8786,1167,7619,36421,2.72699829374,0.056167877942
"Richmond County, Georgia",2009,198079,32.5,86835,11443,75392,37339,2.62732120119,0.0577698796945
"Richmond County, Georgia",2012,200337,33.1,86420,13146,73274,38952,2.73408030133,0.0656194312583
"Richmond County, Georgia",2015,201291,33.3,86939,15215,71724,37424,2.80646645474,0.075587085364
"Richmond County, New York",2009,483168,38.1,178237,11454,166783,71206,2.89698590384,0.0237060401351
"Richmond County, New York",2012,468374,38.6,176730,13055,163675,73496,2.86160989766,0.0278730245488
"Richmond County, New York",2015,472481,39.3,178136,12352,165784,73197,2.84997949139,0.0261428501887
"Richmond County, North Carolina",2009,45947,37,21939,3679,18260,29403,2.51626506024,0.0800705160293
"Richmond County, North Carolina",2012,46608,38.9,20807,2957,17850,31726,2.61109243697,0.063444043941
"Richmond County, North Carolina",2015,46046,39.9,20943,2482,18461,32687,2.49423108174,0.05390261912
"Richmond County, Virginia",2009,9070,42.3,3782,793,2989,42212,3.03445968551,0.0874310915105
"Richmond County, Virginia",2012,9234,43.2,3843,1089,2754,48958,3.35294117647,0.117933723197
"Richmond County, Virginia",2015,8989,43.7,3886,1011,2875,47288,3.12660869565,0.112470797642
"Richmond city, Virginia",2009,200976,33.8,94131,12901,81230,37735,2.47415979318,0.0641917442879
"Richmond city, Virginia",2012,205348,32.2,98318,14543,83775,39445,2.45118472098,0.0708212400413
"Richmond city, Virginia",2015,213735,32.9,99449,12225,87224,40758,2.45041502339,0.0571969962804
"Riley County, Kansas",2009,69706,23.3,26136,2172,23964,37225,2.90877983642,0.0311594410811
"Riley County, Kansas",2012,71927,24.3,28278,2567,25711,43364,2.79751857182,0.0356889624202
"Riley County, Kansas",2015,75022,24.7,29557,3090,26467,44437,2.83454868327,0.0411879182107
"Rincón Municipio, Puerto Rico",2009,16381,40.1,7285,2060,5225,15232,3.13511961722,0.125755448385
"Rincón Municipio, Puerto Rico",2012,15182,41.2,8445,2969,5476,16548,2.77246165084,0.195560532209
"Rincón Municipio, Puerto Rico",2015,14841,42.6,9512,4075,5437,16755,2.72963031083,0.274577184826
"Ringgold County, Iowa",2009,5062,45.6,2885,708,2177,42367,2.32521819017,0.139865665745
"Ringgold County, Iowa",2012,5123,45.4,2633,590,2043,43655,2.50758688204,0.115166894398
"Ringgold County, Iowa",2015,5061,46.3,2602,572,2030,47042,2.49310344828,0.113021142067
"Rio Arriba County, New Mexico",2009,40674,37.2,18294,4408,13886,42514,2.92913726055,0.108373899789
"Rio Arriba County, New Mexico",2012,40201,39.1,19559,4600,14959,40791,2.68741226018,0.114425014303
"Rio Arriba County, New Mexico",2015,39949,40.1,19564,5834,13730,36098,2.90961398398,0.14603619615
"Rio Blanco County, Colorado",2009,6183,37.2,3085,459,2626,54812,2.35453160701,0.0742358078603
"Rio Blanco County, Colorado",2012,6728,36.8,3164,624,2540,58393,2.64881889764,0.0927467300832
"Rio Blanco County, Colorado",2015,6712,36.4,3342,860,2482,61842,2.7042707494,0.128128724672
"Rio Grande County, Colorado",2009,11743,40.3,6651,2991,3660,39683,3.20846994536,0.254704930597
"Rio Grande County, Colorado",2012,11925,41.8,6644,2300,4344,38329,2.74516574586,0.1928721174
"Rio Grande County, Colorado",2015,11745,40.9,6618,2001,4617,39672,2.54385964912,0.17037037037
"Ripley County, Indiana",2009,27378,38.4,11797,1103,10694,47397,2.56012717412,0.0402878223391
"Ripley County, Indiana",2012,28702,39.2,11956,1262,10694,49031,2.68393491678,0.0439690613895
"Ripley County, Indiana",2015,28612,40.4,12081,1160,10921,51170,2.61990660196,0.0405424297498
"Ripley County, Missouri",2009,13523,41,6660,1083,5577,29289,2.42478034786,0.0800857797826
"Ripley County, Missouri",2012,14070,41.9,6599,1145,5454,31431,2.5797579758,0.0813788201848
"Ripley County, Missouri",2015,13990,41.6,6550,1127,5423,32444,2.5797529043,0.0805575411008
"Ritchie County, West Virginia",2009,10306,42.7,5678,1586,4092,35211,2.51857282502,0.153890937318
"Ritchie County, West Virginia",2012,10391,44.4,5835,1715,4120,35634,2.52208737864,0.165046675007
"Ritchie County, West Virginia",2015,10140,45.2,5816,1874,3942,37636,2.57229832572,0.184812623274
"Riverside County, California",2009,2036304,33.1,749255,104070,645185,58155,3.1561552113,0.0511073002852
"Riverside County, California",2012,2192982,33.7,799360,122742,676618,57096,3.24109320178,0.0559703636418
"Riverside County, California",2015,2298032,34.5,815322,116090,699232,56603,3.28650862661,0.0505171381425
"Roane County, Tennessee",2009,53186,43,24702,3039,21663,41740,2.45515394913,0.0571390967548
"Roane County, Tennessee",2012,54027,44.9,25635,3167,22468,43017,2.40461990386,0.0586188387288
"Roane County, Tennessee",2015,53162,46.1,25604,3717,21887,40854,2.42893041532,0.0699183627403
"Roane County, West Virginia",2009,15123,41.6,7759,1610,6149,27155,2.45942429663,0.106460358394
"Roane County, West Virginia",2012,14884,43.3,7379,1562,5817,27174,2.55870723741,0.104944907283
"Roane County, West Virginia",2015,14636,44.2,7379,1507,5872,31813,2.49250681199,0.102965291063
"Roanoke County, Virginia",2009,89905,41.8,39410,2081,37329,57800,2.408449195,0.0231466548023
"Roanoke County, Virginia",2012,92432,42.9,40047,2171,37876,61686,2.44038441229,0.0234875367838
"Roanoke County, Virginia",2015,93633,43.5,40439,2275,38164,60519,2.45343779478,0.0242969893093
"Roanoke city, Virginia",2009,93271,39,46319,4132,42187,35811,2.21089435134,0.0443010153209
"Roanoke city, Virginia",2012,96742,38.4,47320,4676,42644,38265,2.26859581653,0.0483347460255
"Roanoke city, Virginia",2015,98736,38,47321,5082,42239,39930,2.33755533985,0.0514705882353
"Roberts County, South Dakota",2009,9932,39.4,4947,1093,3854,35462,2.5770627919,0.110048328635
"Roberts County, South Dakota",2012,10158,39.7,4909,1294,3615,42893,2.80995850622,0.127387280961
"Roberts County, South Dakota",2015,10318,39.2,4921,1269,3652,48614,2.82530120482,0.122988951347
"Roberts County, Texas",2009,913,43.2,454,81,373,59097,2.44772117962,0.0887185104053
"Roberts County, Texas",2012,992,41.9,448,101,347,64688,2.85878962536,0.101814516129
"Roberts County, Texas",2015,931,37.6,404,54,350,63889,2.66,0.0580021482277
"Robertson County, Kentucky",2009,2234,38.3,1022,197,825,30647,2.70787878788,0.0881826320501
"Robertson County, Kentucky",2012,2251,38.6,1028,204,824,29136,2.7317961165,0.0906263882719
"Robertson County, Kentucky",2015,2208,46.7,1103,173,930,31741,2.37419354839,0.0783514492754
"Robertson County, Tennessee",2009,63521,36.4,24984,1760,23224,50160,2.73514467792,0.027707372365
"Robertson County, Tennessee",2012,66143,37.7,26082,1977,24105,52588,2.74395353661,0.0298897842553
"Robertson County, Tennessee",2015,67426,38.6,26352,1711,24641,53151,2.73633375269,0.0253759677276
"Robertson County, Texas",2009,15830,39.4,8227,2061,6166,37941,2.56730457347,0.130195830701
"Robertson County, Texas",2012,16596,40.7,8469,2480,5989,40711,2.77108031391,0.149433598457
"Robertson County, Texas",2015,16532,40.9,8507,2442,6065,46501,2.72580379225,0.147713525284
"Robeson County, North Carolina",2009,127686,33.4,50357,6827,43530,28426,2.93328738801,0.0534670989772
"Robeson County, North Carolina",2012,133920,34.3,52620,7631,44989,30167,2.97672764454,0.0569817801673
"Robeson County, North Carolina",2015,134871,35.2,52454,6681,45773,30608,2.94651869006,0.0495362235025
"Rock County, Minnesota",2009,9444,42,4268,323,3945,45826,2.39391634981,0.0342016094875
"Rock County, Minnesota",2012,9620,41.4,4268,301,3967,45660,2.42500630199,0.031288981289
"Rock County, Minnesota",2015,9563,41.1,4267,338,3929,51496,2.43395265971,0.0353445571473
"Rock County, Nebraska",2009,1494,50.2,1000,297,703,34620,2.12517780939,0.198795180723
"Rock County, Nebraska",2012,1540,49.4,951,290,661,41619,2.32980332829,0.188311688312
"Rock County, Nebraska",2015,1401,52,916,226,690,48456,2.03043478261,0.161313347609
"Rock County, Wisconsin",2009,158829,37.3,67970,5570,62400,49894,2.54533653846,0.0350691624326
"Rock County, Wisconsin",2012,160356,38.3,68369,5363,63006,50316,2.54509094372,0.0334443363516
"Rock County, Wisconsin",2015,160727,38.9,68332,4487,63845,50324,2.51745633957,0.0279169025739
"Rock Island County, Illinois",2009,146670,39.1,65520,5220,60300,45585,2.43233830846,0.035590100225
"Rock Island County, Illinois",2012,147504,40.1,65772,5102,60670,48205,2.43125103016,0.0345888925046
"Rock Island County, Illinois",2015,147161,40,65791,5400,60391,48817,2.43680349721,0.0366945046582
"Rockbridge County, Virginia",2009,21311,44.1,10896,1619,9277,43311,2.29718659049,0.0759701562573
"Rockbridge County, Virginia",2012,22357,46.8,11137,2044,9093,45859,2.45870449797,0.0914255043163
"Rockbridge County, Virginia",2015,22444,48.3,11231,1912,9319,48901,2.40841291984,0.0851898057387
"Rockcastle County, Kentucky",2009,16560,39.4,7766,1277,6489,25643,2.5520110957,0.07711352657
"Rockcastle County, Kentucky",2012,17090,41.3,7705,1208,6497,28178,2.63044482069,0.0706846108836
"Rockcastle County, Kentucky",2015,16942,41.8,7686,1065,6621,31555,2.55882797161,0.0628615275646
"Rockdale County, Georgia",2009,81444,35.7,30802,3143,27659,55681,2.94457500271,0.0385909336477
"Rockdale County, Georgia",2012,85008,37.2,33148,4008,29140,54704,2.91722717914,0.0471485036702
"Rockdale County, Georgia",2015,86901,37.5,33319,3696,29623,50455,2.9335651352,0.0425311561432
"Rockingham County, New Hampshire",2009,296680,40.5,123357,10145,113212,74842,2.62057025757,0.0341950923554
"Rockingham County, New Hampshire",2012,295872,42.3,126644,11092,115552,77939,2.56050955414,0.0374891845122
"Rockingham County, New Hampshire",2015,299006,43.5,127994,9899,118095,81198,2.53191074982,0.0331063590697
"Rockingham County, North Carolina",2009,92007,41,42863,5298,37565,38160,2.44927459071,0.0575825752388
"Rockingham County, North Carolina",2012,93264,42.2,43639,5795,37844,38004,2.46443293521,0.0621354434723
"Rockingham County, North Carolina",2015,92300,43.6,43621,6038,37583,38126,2.45589761328,0.0654171180932
"Rockingham County, Virginia",2009,73570,39,31327,2415,28912,51232,2.54461815163,0.0328258801142
"Rockingham County, Virginia",2012,76353,40.3,33578,3962,29616,51721,2.57809967585,0.0518905609472
"Rockingham County, Virginia",2015,77785,41.5,34269,4644,29625,53744,2.62565400844,0.059703027576
"Rockland County, New York",2009,297298,37.5,98610,4456,94154,82368,3.15757163795,0.0149883282094
"Rockland County, New York",2012,312011,36.8,103816,5415,98401,86020,3.17081127224,0.0173551573502
"Rockland County, New York",2015,320688,36.3,104442,5636,98806,84855,3.2456328563,0.0175747143641
"Rockwall County, Texas",2009,72814,34.9,24608,1495,23113,80193,3.15034828884,0.0205317658692
"Rockwall County, Texas",2012,78749,35.8,27947,1806,26141,82725,3.01247083126,0.022933624554
"Rockwall County, Texas",2015,85536,36.9,30038,1581,28457,87524,3.00579822188,0.0184834455668
"Roger Mills County, Oklahoma",2009,3310,43.6,1787,431,1356,50089,2.44100294985,0.130211480363
"Roger Mills County, Oklahoma",2012,3678,41.8,1901,575,1326,53952,2.77375565611,0.156334964655
"Roger Mills County, Oklahoma",2015,3780,40.6,1907,567,1340,50739,2.82089552239,0.15
"Rogers County, Oklahoma",2009,82890,37.7,31343,2361,28982,56438,2.86005106618,0.0284835323923
"Rogers County, Oklahoma",2012,87031,38.5,35007,2481,32526,58761,2.67573633401,0.0285070836828
"Rogers County, Oklahoma",2015,89190,38.8,36071,2713,33358,58139,2.67372144613,0.0304182083193
"Rolette County, North Dakota",2009,13672,29.1,5039,524,4515,30921,3.02812846069,0.0383265067291
"Rolette County, North Dakota",2012,14015,30.4,5382,634,4748,30641,2.95176916596,0.0452372458081
"Rolette County, North Dakota",2015,14498,30.3,5476,702,4774,33277,3.03686635945,0.0484204717892
"Rooks County, Kansas",2009,5131,43.9,2791,448,2343,38013,2.18992744345,0.087312414734
"Rooks County, Kansas",2012,5205,44.4,2770,392,2378,41123,2.18881412952,0.0753121998079
"Rooks County, Kansas",2015,5186,43.9,2757,551,2206,43558,2.3508612874,0.106247589664
"Roosevelt County, Montana",2009,10231,31.3,4033,643,3390,34731,3.01799410029,0.0628482064314
"Roosevelt County, Montana",2012,10477,30.9,4074,771,3303,40146,3.17196488041,0.0735897680634
"Roosevelt County, Montana",2015,11072,30.4,4067,1004,3063,32974,3.6147567744,0.0906791907514
"Roosevelt County, New Mexico",2009,18854,26.1,7973,1236,6737,32169,2.7985750334,0.0655563806089
"Roosevelt County, New Mexico",2012,19840,29.9,8171,1310,6861,39323,2.89170674829,0.0660282258065
"Roosevelt County, New Mexico",2015,19908,29.4,8294,1155,7139,35546,2.78862585796,0.0580168776371
"Roscommon County, Michigan",2009,25280,50.8,25014,13581,11433,34276,2.21114318202,0.537223101266
"Roscommon County, Michigan",2012,24447,53.3,24481,13058,11423,34765,2.14015582597,0.534135067697
"Roscommon County, Michigan",2015,24068,54.4,24374,12831,11543,35133,2.08507320454,0.533114508891
"Roseau County, Minnesota",2009,16012,39.4,7518,1228,6290,48974,2.54562798092,0.0766924806395
"Roseau County, Minnesota",2012,15665,40.3,7466,1086,6380,50620,2.45532915361,0.0693265240983
"Roseau County, Minnesota",2015,15615,41.2,7426,1108,6318,53199,2.47150997151,0.0709574127442
"Rosebud County, Montana",2009,9152,35,3951,747,3204,43269,2.85642946317,0.0816215034965
"Rosebud County, Montana",2012,9261,37.3,4075,790,3285,45977,2.81917808219,0.085303962855
"Rosebud County, Montana",2015,9352,36.9,4105,810,3295,51159,2.83823975721,0.0866124893071
"Ross County, Ohio",2009,75629,38.2,30407,3281,27126,41641,2.78806311288,0.043382829338
"Ross County, Ohio",2012,77741,39.8,32002,4036,27966,44089,2.77983980548,0.0519159774122
"Ross County, Ohio",2015,77334,40.6,31917,3648,28269,43345,2.73564682161,0.0471720071379
"Routt County, Colorado",2009,22356,37.3,14238,4506,9732,64046,2.29716399507,0.201556629093
"Routt County, Colorado",2012,23385,39.4,16131,6298,9833,65041,2.37821621072,0.26931793885
"Routt County, Colorado",2015,23606,40.1,16378,6947,9431,64963,2.50302194889,0.294289587393
"Rowan County, Kentucky",2009,22549,29.4,9476,1520,7956,30803,2.83421317245,0.0674087542685
"Rowan County, Kentucky",2012,23351,32,10054,1915,8139,33615,2.86902567883,0.0820093357886
"Rowan County, Kentucky",2015,23608,32.2,10107,1565,8542,36860,2.76375556076,0.0662910877669
"Rowan County, North Carolina",2009,137387,38.8,59437,6448,52989,45253,2.59274566419,0.0469331159426
"Rowan County, North Carolina",2012,138189,39.1,60116,7238,52878,41561,2.61335527062,0.0523775409041
"Rowan County, North Carolina",2015,138361,40.3,60167,8555,51612,43069,2.68079128885,0.0618310072925
"Runnels County, Texas",2009,10376,43.1,5442,1404,4038,37980,2.5695889054,0.135312259059
"Runnels County, Texas",2012,10473,43.1,5303,1327,3976,39115,2.63405432596,0.126706769789
"Runnels County, Texas",2015,10445,41.9,5268,1565,3703,41526,2.82068593033,0.14983245572
"Rush County, Indiana",2009,17425,39.8,7723,856,6867,45661,2.5374981797,0.04912482066
"Rush County, Indiana",2012,17349,40.3,7507,709,6798,46125,2.55207413945,0.0408669087555
"Rush County, Indiana",2015,16991,41.3,7479,537,6942,45121,2.44756554307,0.0316049673356
"Rush County, Kansas",2009,3203,48.4,1867,304,1563,38263,2.04926423544,0.0949110209179
"Rush County, Kansas",2012,3262,49,1811,295,1516,41306,2.15171503958,0.0904353157572
"Rush County, Kansas",2015,3184,48.8,1797,311,1486,38854,2.14266487214,0.097675879397
"Rusk County, Texas",2009,48444,39.3,20688,3067,17621,44071,2.74921968106,0.0633102138552
"Rusk County, Texas",2012,53211,39.3,21191,3131,18060,46220,2.94634551495,0.0588412170416
"Rusk County, Texas",2015,53457,38.5,21281,3528,17753,46173,3.01115304456,0.0659969695269
"Rusk County, Wisconsin",2009,14472,44.2,8149,1665,6484,37724,2.23195558297,0.115049751244
"Rusk County, Wisconsin",2012,14670,46.1,8849,2307,6542,38629,2.24243350657,0.157259713701
"Rusk County, Wisconsin",2015,14357,47.5,8950,2711,6239,39194,2.3011700593,0.18882774953
"Russell County, Alabama",2009,50029,37.1,25666,4166,21500,32064,2.32693023256,0.0832717024126
"Russell County, Alabama",2012,53938,35.6,24979,4075,20904,33591,2.58027171833,0.0755497052171
"Russell County, Alabama",2015,58302,34.8,26368,4127,22241,37049,2.62137493818,0.0707865939419
"Russell County, Kansas",2009,6685,45.3,3843,707,3136,37000,2.13169642857,0.105759162304
"Russell County, Kansas",2012,6926,47.1,3910,646,3264,40551,2.12193627451,0.0932717297141
"Russell County, Kansas",2015,6988,47.1,3892,653,3239,41102,2.15745600494,0.0934459072696
"Russell County, Kentucky",2009,17127,40.3,9346,2462,6884,29153,2.48794305636,0.143749635079
"Russell County, Kentucky",2012,17562,41.2,9947,2583,7364,29465,2.38484519283,0.147078920396
"Russell County, Kentucky",2015,17669,42.9,9942,2892,7050,30720,2.50624113475,0.163676495557
"Russell County, Virginia",2009,28921,42.9,13811,1663,12148,31770,2.38072110635,0.0575014695204
"Russell County, Virginia",2012,28773,42.9,13493,2353,11140,32637,2.5828545781,0.0817780558162
"Russell County, Virginia",2015,28245,43.8,13428,2383,11045,35045,2.5572657311,0.0843689148522
"Rutherford County, North Carolina",2009,63153,41.1,31886,5534,26352,34881,2.39651639344,0.0876284578722
"Rutherford County, North Carolina",2012,67446,42.1,33769,6357,27412,35941,2.46045527506,0.094253180322
"Rutherford County, North Carolina",2015,66865,43.3,33860,7434,26426,35630,2.53027321577,0.111179241756
"Rutherford County, Tennessee",2009,240181,32.1,97793,6665,91128,53063,2.63564436836,0.0277499052798
"Rutherford County, Tennessee",2012,263815,32.4,102934,7587,95347,55105,2.76689355722,0.0287587893031
"Rutherford County, Tennessee",2015,282558,32.9,107451,6790,100661,56219,2.80702556104,0.0240304645418
"Rutland County, Vermont",2009,63306,43,32974,6975,25999,46153,2.43493980538,0.11017912994
"Rutland County, Vermont",2012,61599,44.3,33743,7696,26047,48968,2.36491726494,0.124937093135
"Rutland County, Vermont",2015,60530,45.5,33742,8283,25459,49372,2.37754821478,0.136841235751
"Río Grande Municipio, Puerto Rico",2009,56294,34.5,21110,5019,16091,21430,3.49847740973,0.0891569261378
"Río Grande Municipio, Puerto Rico",2012,54203,36.9,22478,5610,16868,22491,3.21336258003,0.103499806284
"Río Grande Municipio, Puerto Rico",2015,53029,38.6,23311,6480,16831,22246,3.1506743509,0.122197288276
"Sabana Grande Municipio, Puerto Rico",2009,27572,36.1,10234,1503,8731,15943,3.15794296186,0.0545118235891
"Sabana Grande Municipio, Puerto Rico",2012,25216,38.5,10321,2851,7470,15958,3.37563587684,0.113063134518
"Sabana Grande Municipio, Puerto Rico",2015,24307,40.2,10663,3588,7075,14795,3.43561837456,0.14761179907
"Sabine County, Texas",2009,10177,49,8105,3821,4284,32139,2.37558356676,0.375454456127
"Sabine County, Texas",2012,10642,50.2,7997,3728,4269,33053,2.49285546967,0.350310092088
"Sabine County, Texas",2015,10440,50.4,8008,4213,3795,31307,2.75098814229,0.403544061303
"Sabine Parish, Louisiana",2009,23629,40.2,14647,4619,10028,34632,2.35630235341,0.195480130348
"Sabine Parish, Louisiana",2012,24265,40.9,14168,4945,9223,36914,2.63092269327,0.203791469194
"Sabine Parish, Louisiana",2015,24248,41.5,14344,5173,9171,38828,2.64398647912,0.213337182448
"Sac County, Iowa",2009,10311,45.9,5547,879,4668,40613,2.2088688946,0.0852487634565
"Sac County, Iowa",2012,10307,46.3,5436,1015,4421,46606,2.33137299254,0.0984767633647
"Sac County, Iowa",2015,10101,46.1,5409,1003,4406,49572,2.29255560599,0.0992970992971
"Sacramento County, California",2009,1375605,34.4,545330,41893,503437,56799,2.73242729478,0.0304542364996
"Sacramento County, California",2012,1422348,34.9,555536,43040,512496,55846,2.77533483188,0.0302598238968
"Sacramento County, California",2015,1465832,35.5,560271,37675,522596,55987,2.80490474477,0.0257021268467
"Sagadahoc County, Maine",2009,36511,41.2,17724,3254,14470,54986,2.52322045612,0.0891238256964
"Sagadahoc County, Maine",2012,35394,43.8,18276,3476,14800,55634,2.39148648649,0.0982087359439
"Sagadahoc County, Maine",2015,35092,45.2,18417,3012,15405,53298,2.27796170075,0.0858315285535
"Saginaw County, Michigan",2009,202814,38.6,88815,10477,78338,42244,2.58896065766,0.0516581695544
"Saginaw County, Michigan",2012,200017,39.6,86953,9527,77426,42828,2.58333118074,0.0476309513691
"Saginaw County, Michigan",2015,196479,40.3,86823,8898,77925,43042,2.52138594803,0.0452872826104
"Saguache County, Colorado",2009,6929,38.1,3772,1109,2663,29523,2.60195268494,0.160051955549
"Saguache County, Colorado",2012,6189,43.8,3844,1118,2726,32429,2.2703595011,0.180643076426
"Saguache County, Colorado",2015,6238,46.1,3904,1306,2598,33393,2.40107775212,0.209361974992
"Salem County, New Jersey",2009,65982,39.7,27459,2265,25194,59452,2.6189568945,0.0343275438756
"Salem County, New Jersey",2012,66007,40.9,27437,2487,24950,59336,2.64557114228,0.0376778220492
"Salem County, New Jersey",2015,65120,41.8,27619,3272,24347,61831,2.67466217604,0.0502457002457
"Salem city, Virginia",2009,25139,39.7,10717,905,9812,47746,2.56206685691,0.0359998408847
"Salem city, Virginia",2012,24792,39.8,10820,867,9953,47776,2.49090726414,0.0349709583737
"Salem city, Virginia",2015,25165,40.5,10851,806,10045,50068,2.50522648084,0.0320286111663
"Salinas Municipio, Puerto Rico",2009,32112,33.7,12146,2142,10004,13192,3.20991603359,0.0667040358744
"Salinas Municipio, Puerto Rico",2012,31019,34.9,13120,2512,10608,13386,2.92411387632,0.0809826235533
"Salinas Municipio, Puerto Rico",2015,30114,36.5,13970,2943,11027,15240,2.73093316405,0.0977286312014
"Saline County, Arkansas",2009,95000,38.1,40025,3197,36828,51082,2.57955903117,0.0336526315789
"Saline County, Arkansas",2012,107498,38.7,44877,3603,41274,53817,2.60449677763,0.03351690264
"Saline County, Arkansas",2015,113833,38.7,46355,4056,42299,55817,2.69115109104,0.0356311438686
"Saline County, Illinois",2009,25906,41.2,12857,1542,11315,33341,2.28952717631,0.0595228904501
"Saline County, Illinois",2012,24975,41.8,11740,1393,10347,37139,2.41374311395,0.0557757757758
"Saline County, Illinois",2015,24783,42.4,11644,1689,9955,38258,2.48950276243,0.0681515555018
"Saline County, Kansas",2009,54076,37.7,23603,1997,21606,43850,2.50282328983,0.0369295066203
"Saline County, Kansas",2012,55493,37.9,24096,2005,22091,47339,2.51201846906,0.0361306831492
"Saline County, Kansas",2015,55735,37.7,24192,1802,22390,47801,2.48928092899,0.032331569032
"Saline County, Missouri",2009,22749,37.8,10335,1309,9026,40556,2.52038555285,0.0575409908128
"Saline County, Missouri",2012,23232,38,10131,1320,8811,39090,2.63670411985,0.0568181818182
"Saline County, Missouri",2015,23334,38.2,10083,1239,8844,40101,2.63839891452,0.0530984829005
"Saline County, Nebraska",2009,13836,36.1,5768,776,4992,45893,2.77163461538,0.0560855738653
"Saline County, Nebraska",2012,14278,36,5770,744,5026,46434,2.84082769598,0.0521081383947
"Saline County, Nebraska",2015,14360,36.6,5784,680,5104,51738,2.81347962382,0.0473537604457
"Salt Lake County, Utah",2009,1000299,30.4,350794,21046,329748,56948,3.03352560137,0.021039709127
"Salt Lake County, Utah",2012,1032226,30.8,363923,22082,341841,59626,3.01960853145,0.0213926020077
"Salt Lake County, Utah",2015,1078958,31.8,372990,21098,351892,62117,3.06616234527,0.0195540512235
"Saluda County, South Carolina",2009,18947,38.4,8888,2404,6484,41510,2.92211597779,0.126880244894
"Saluda County, South Carolina",2012,19758,40.4,9255,2401,6854,39541,2.88269623577,0.121520396801
"Saluda County, South Carolina",2015,20000,41.2,9268,2209,7059,38827,2.83326250177,0.11045
"Sampson County, North Carolina",2009,62996,36.6,26400,3776,22624,34779,2.78447666195,0.0599403136707
"Sampson County, North Carolina",2012,63408,38.2,27170,3703,23467,37447,2.70200707376,0.058399571032
"Sampson County, North Carolina",2015,63873,39.2,27166,3886,23280,35490,2.74368556701,0.0608394783398
"San Augustine County, Texas",2009,8693,46.4,5608,1810,3798,26660,2.28883622959,0.208213505119
"San Augustine County, Texas",2012,8898,47.6,5350,1982,3368,27580,2.6419239905,0.222746684648
"San Augustine County, Texas",2015,8695,47.8,5348,2466,2882,28275,3.01700208189,0.283611270845
"San Benito County, California",2009,54752,33.5,17814,1143,16671,68567,3.28426609082,0.020875949737
"San Benito County, California",2012,55467,34.1,17876,1036,16840,63939,3.29376484561,0.0186777723692
"San Benito County, California",2015,57557,35,18038,840,17198,71077,3.34672636353,0.0145942283302
"San Bernardino County, California",2009,1986635,30.7,676158,87362,588796,55461,3.37406334282,0.0439748620154
"San Bernardino County, California",2012,2041029,31.7,698715,99017,599698,54750,3.40342805879,0.0485132744317
"San Bernardino County, California",2015,2094769,32.5,705962,91637,614325,53433,3.40987099662,0.0437456349602
"San Diego County, California",2009,2987543,34.5,1131045,85786,1045259,62901,2.85818443084,0.028714565782
"San Diego County, California",2012,3100500,34.7,1163884,96422,1067462,63373,2.90455304264,0.0310988550234
"San Diego County, California",2015,3223096,35.1,1180806,86649,1094157,64309,2.94573447869,0.0268837788263
"San Francisco County, California",2009,797271,38.2,358380,34195,324185,70040,2.45930872804,0.0428900587128
"San Francisco County, California",2012,807755,38.5,375861,35022,340839,73802,2.3699019185,0.0433572060835
"San Francisco County, California",2015,840763,38.5,383676,30389,353287,81294,2.37982999658,0.0361445496531
"San Germán Municipio, Puerto Rico",2009,37599,38.3,14285,2194,12091,14588,3.10966834836,0.0583526157611
"San Germán Municipio, Puerto Rico",2012,35441,39.7,14708,2776,11932,15470,2.97024807241,0.0783273609661
"San Germán Municipio, Puerto Rico",2015,34125,41.3,15530,3100,12430,14797,2.74537409493,0.0908424908425
"San Jacinto County, Texas",2009,24645,41.5,12138,3737,8401,42043,2.93357933579,0.151633191317
"San Jacinto County, Texas",2012,26482,43,13115,3877,9238,46413,2.86663780039,0.146401329205
"San Jacinto County, Texas",2015,27023,43.6,13136,3660,9476,43029,2.85173068805,0.135440180587
"San Joaquin County, California",2009,664641,32,225025,17358,207667,54540,3.20051332181,0.0261163545433
"San Joaquin County, California",2012,687036,32.6,233587,19955,213632,53895,3.21597887957,0.0290450573187
"San Joaquin County, California",2015,708554,33.5,236562,17489,219073,53274,3.23432828327,0.0246826635655
"San Juan County, Colorado",2009,686,45.5,758,399,359,44336,1.91086350975,0.581632653061
"San Juan County, Colorado",2012,747,37.9,755,377,378,37330,1.97619047619,0.5046854083
"San Juan County, Colorado",2015,606,46,698,416,282,36324,2.14893617021,0.686468646865
"San Juan County, New Mexico",2009,122470,32.4,45565,6301,39264,45361,3.11914221679,0.0514493345309
"San Juan County, New Mexico",2012,128600,32.8,49168,7377,41791,48701,3.07721758273,0.0573639191291
"San Juan County, New Mexico",2015,125133,34.2,49562,8919,40643,48671,3.07883276333,0.0712761621635
"San Juan County, Utah",2009,14429,28.5,5771,1417,4354,36209,3.31396417088,0.0982050038118
"San Juan County, Utah",2012,14707,30.2,5747,1595,4152,40186,3.54214836224,0.108451757666
"San Juan County, Utah",2015,15152,30.6,5810,1887,3923,41484,3.86235024216,0.124538014784
"San Juan County, Washington",2009,15295,52,11228,3871,7357,51392,2.07897240723,0.253089244851
"San Juan County, Washington",2012,15740,52.9,13229,5266,7963,52712,1.97664196911,0.334561626429
"San Juan County, Washington",2015,15956,54.4,13619,5911,7708,55960,2.07005708355,0.3704562547
"San Juan Municipio, Puerto Rico",2009,424652,37.7,178282,28980,149302,23749,2.84424857001,0.0682441151814
"San Juan Municipio, Puerto Rico",2012,393633,39,184552,35974,148578,23100,2.64933570246,0.0913896954778
"San Juan Municipio, Puerto Rico",2015,371400,40.4,191797,44481,147316,21243,2.52111108094,0.119765751212
"San Lorenzo Municipio, Puerto Rico",2009,44358,34.7,14649,1702,12947,16885,3.42612188152,0.0383696289283
"San Lorenzo Municipio, Puerto Rico",2012,40979,36.8,15323,2192,13131,17875,3.12078288021,0.0534908123673
"San Lorenzo Municipio, Puerto Rico",2015,39778,39,16508,2859,13649,16538,2.91435269983,0.0718739001458
"San Luis Obispo County, California",2009,262149,38.8,115366,12703,102663,55555,2.55349054674,0.048457175118
"San Luis Obispo County, California",2012,270121,39.3,117318,15610,101708,59628,2.65584811421,0.0577889168188
"San Luis Obispo County, California",2015,276517,39.3,118806,15230,103576,60691,2.66970147525,0.0550779879718
"San Mateo County, California",2009,701886,38.8,266819,13959,252860,84426,2.77578897414,0.0198878450347
"San Mateo County, California",2012,721183,39.3,270667,13298,257369,87751,2.80213623241,0.0184391479
"San Mateo County, California",2015,748731,39.5,272838,13127,259711,93623,2.88293911309,0.0175323313713
"San Miguel County, Colorado",2009,7385,36.9,6131,3078,3053,60457,2.41893219784,0.416790792146
"San Miguel County, Colorado",2012,7432,38.2,6610,3250,3360,63766,2.2119047619,0.437298170075
"San Miguel County, Colorado",2015,7676,40.7,6687,3377,3310,56047,2.31903323263,0.439942678478
"San Miguel County, New Mexico",2009,28600,38.7,14539,3687,10852,30956,2.63545890158,0.128916083916
"San Miguel County, New Mexico",2012,29225,41.4,15525,3795,11730,30499,2.49147485081,0.129854576561
"San Miguel County, New Mexico",2015,28668,42.5,15558,4770,10788,29237,2.6573971079,0.166387609879
"San Patricio County, Texas",2009,68392,34.1,27487,3809,23678,43748,2.88841963004,0.0556936483799
"San Patricio County, Texas",2012,65352,35.8,26593,4358,22235,51104,2.93914998876,0.0666850287673
"San Patricio County, Texas",2015,66070,35.5,26880,4099,22781,52261,2.90022387077,0.06204026033
"San Saba County, Texas",2009,5904,39.6,3081,991,2090,35549,2.82488038278,0.167852303523
"San Saba County, Texas",2012,6037,41.7,3172,1118,2054,37230,2.93914313535,0.185191320192
"San Saba County, Texas",2015,5893,42.1,3172,1046,2126,39040,2.77187206021,0.177498727304
"San Sebastián Municipio, Puerto Rico",2009,47584,37.1,15820,2713,13107,11863,3.63042648966,0.0570149630128
"San Sebastián Municipio, Puerto Rico",2012,42291,38.8,16495,4484,12011,13658,3.52102239614,0.10602728713
"San Sebastián Municipio, Puerto Rico",2015,40471,41.1,17576,3924,13652,14345,2.96447406973,0.0969583158311
"Sanborn County, South Dakota",2009,2458,44.8,1278,181,1097,41597,2.24065633546,0.073637103336
"Sanborn County, South Dakota",2012,2357,45.8,1140,136,1004,46200,2.34760956175,0.057700466695
"Sanborn County, South Dakota",2015,2339,46.8,1221,149,1072,50541,2.18190298507,0.0637024369389
"Sanders County, Montana",2009,10950,48.1,5332,1017,4315,31521,2.53765932793,0.0928767123288
"Sanders County, Montana",2012,11421,49.9,6620,1417,5203,30900,2.19507976168,0.124069696174
"Sanders County, Montana",2015,11346,51.5,6662,1624,5038,32257,2.25208416038,0.143134144192
"Sandoval County, New Mexico",2009,116811,36.8,47543,4652,42891,56703,2.7234384836,0.0398250164796
"Sandoval County, New Mexico",2012,131302,38.1,52273,5478,46795,58116,2.80589806603,0.0417206135474
"Sandoval County, New Mexico",2015,136638,39.1,53675,5744,47931,58982,2.85072291419,0.0420380860376
"Sandusky County, Ohio",2009,60659,39.7,26109,2232,23877,47699,2.54047828454,0.0367958588173
"Sandusky County, Ohio",2012,60842,40.9,26364,2459,23905,46785,2.54515791675,0.0404161598895
"Sandusky County, Ohio",2015,60187,41.3,26257,2631,23626,47209,2.54749005333,0.0437137587851
"Sangamon County, Illinois",2009,194049,39,90234,8246,81988,50733,2.36679758013,0.0424944215121
"Sangamon County, Illinois",2012,197474,39.3,90020,7618,82402,55355,2.39647095944,0.0385772304202
"Sangamon County, Illinois",2015,199016,39.7,90433,7548,82885,56167,2.40110997165,0.0379265988664
"Sanilac County, Michigan",2009,43291,41,22154,5203,16951,40146,2.55389062592,0.120186643875
"Sanilac County, Michigan",2012,43096,42.7,22684,6271,16413,40019,2.62572351185,0.145512344533
"Sanilac County, Michigan",2015,42014,44.2,22598,6318,16280,41100,2.58071253071,0.15037844528
"Sanpete County, Utah",2009,24742,27.9,8602,1772,6830,41931,3.62254758419,0.071619109207
"Sanpete County, Utah",2012,27645,28.9,10276,2499,7777,46214,3.55471261412,0.0903960933261
"Sanpete County, Utah",2015,28261,30.5,10501,2558,7943,50323,3.55797557598,0.0905134283996
"Santa Barbara County, California",2009,402025,33.7,151309,10807,140502,59350,2.86134716944,0.0268814128475
"Santa Barbara County, California",2012,423594,33.6,152709,11462,141247,62723,2.99895926993,0.0270589290689
"Santa Barbara County, California",2015,435850,33.6,154135,11422,142713,63985,3.0540315178,0.0262062636228
"Santa Clara County, California",2009,1729378,35.5,613681,28257,585424,85569,2.95406064664,0.01633940064
"Santa Clara County, California",2012,1788393,36.2,632299,27844,604455,90747,2.95868675087,0.0155692848272
"Santa Clara County, California",2015,1868149,36.8,646190,24727,621463,96310,3.00605023952,0.0132360962643
"Santa Cruz County, Arizona",2009,42550,34.7,16727,5652,11075,37204,3.84198645598,0.132831962397
"Santa Cruz County, Arizona",2012,47057,35.5,17961,4043,13918,37692,3.38101738756,0.0859170792868
"Santa Cruz County, Arizona",2015,47073,36.5,18105,2746,15359,40140,3.06484797187,0.0583349266034
"Santa Cruz County, California",2009,251398,36.7,102986,9232,93754,64349,2.68146425753,0.0367226469582
"Santa Cruz County, California",2012,262340,36.9,104325,11015,93310,66571,2.81148858643,0.0419874971411
"Santa Cruz County, California",2015,269278,37,105034,10232,94802,67256,2.84042530748,0.0379979055103
"Santa Fe County, New Mexico",2009,143501,40.6,63687,9083,54604,52923,2.62803091349,0.0632957261622
"Santa Fe County, New Mexico",2012,144209,43,70999,10045,60954,53642,2.36586606293,0.0696558467225
"Santa Fe County, New Mexico",2015,147108,44.4,71673,10494,61179,54315,2.40455058108,0.0713353454605
"Santa Isabel Municipio, Puerto Rico",2009,22809,31.5,8591,1063,7528,16965,3.02988841658,0.0466044105397
"Santa Isabel Municipio, Puerto Rico",2012,23261,33.7,8928,1282,7646,18024,3.04224431075,0.0551137096427
"Santa Isabel Municipio, Puerto Rico",2015,22913,35.5,9316,1589,7727,15674,2.96531642293,0.0693492777026
"Santa Rosa County, Florida",2009,147302,38.2,58774,7846,50928,54250,2.89235783852,0.0532647214566
"Santa Rosa County, Florida",2012,153086,39.2,64707,8232,56475,57491,2.71068614431,0.0537736958311
"Santa Rosa County, Florida",2015,161021,39.5,66786,8132,58654,58923,2.74526886487,0.0505027294576
"Sarasota County, Florida",2009,367446,50.7,218144,52437,165707,49013,2.2174440428,0.142706683431
"Sarasota County, Florida",2012,380479,52.6,228117,58597,169520,48900,2.24444903256,0.154008499812
"Sarasota County, Florida",2015,392038,54,230150,54965,175185,51766,2.23785141422,0.140203245604
"Saratoga County, New York",2009,216491,39.6,94748,10583,84165,64705,2.5722212321,0.0488842492298
"Saratoga County, New York",2012,219832,40.8,98758,10806,87952,67712,2.49945424777,0.0491557189126
"Saratoga County, New York",2015,223774,41.8,100953,11032,89921,71496,2.48856218236,0.0492997399162
"Sargent County, North Dakota",2009,4058,45.1,2091,271,1820,47652,2.22967032967,0.0667816658452
"Sargent County, North Dakota",2012,3876,45.8,2001,238,1763,51175,2.19852524107,0.0614035087719
"Sargent County, North Dakota",2015,3874,45.3,2041,313,1728,57125,2.24189814815,0.0807950438823
"Sarpy County, Nebraska",2009,146340,32.6,57646,2868,54778,65189,2.6715104604,0.019598195982
"Sarpy County, Nebraska",2012,159413,33,62011,3135,58876,69269,2.70760581561,0.0196658992679
"Sarpy County, Nebraska",2015,169192,33.7,64886,2903,61983,70543,2.72965167869,0.0171580216559
"Sauk County, Wisconsin",2009,58239,40,28582,3769,24813,49630,2.3471164309,0.064716083724
"Sauk County, Wisconsin",2012,61953,39.9,29666,4205,25461,52355,2.43325085425,0.0678740335416
"Sauk County, Wisconsin",2015,62992,40.9,29833,4502,25331,51055,2.48675535905,0.0714693929388
"Saunders County, Nebraska",2009,20115,41.1,9079,1183,7896,56495,2.54749240122,0.0588118319662
"Saunders County, Nebraska",2012,20696,41.9,9206,1057,8149,58785,2.53969812247,0.0510726710475
"Saunders County, Nebraska",2015,20913,41.4,9331,1276,8055,60854,2.59627560521,0.0610146798642
"Sawyer County, Wisconsin",2009,16909,45.8,15389,7393,7996,37583,2.11468234117,0.437222780768
"Sawyer County, Wisconsin",2012,16580,47.2,15859,8139,7720,39814,2.14766839378,0.490892641737
"Sawyer County, Wisconsin",2015,16483,49.3,16152,8793,7359,41665,2.23984236989,0.53345871504
"Schenectady County, New York",2009,150474,39.7,66283,8095,58188,54468,2.58599711281,0.053796669192
"Schenectady County, New York",2012,154466,40,68047,9784,58263,56445,2.65118514323,0.0633407999171
"Schenectady County, New York",2015,154796,39.9,68171,11411,56760,58114,2.72720225511,0.0737163751001
"Schleicher County, Texas",2009,2862,38.3,1440,313,1127,52872,2.53948535936,0.109364081062
"Schleicher County, Texas",2012,3327,36.1,1478,364,1114,50417,2.98653500898,0.109407874962
"Schleicher County, Texas",2015,3224,35.5,1492,418,1074,55543,3.00186219739,0.129652605459
"Schley County, Georgia",2009,4129,34.7,1887,412,1475,38722,2.7993220339,0.0997820295471
"Schley County, Georgia",2012,4963,37.7,2178,426,1752,40612,2.83276255708,0.0858351803345
"Schley County, Georgia",2015,5074,38.4,2176,297,1879,39375,2.70037253858,0.0585337012219
"Schoharie County, New York",2009,31813,40.9,16552,4203,12349,49695,2.57616001296,0.132115801716
"Schoharie County, New York",2012,32617,42.4,17183,4556,12627,51896,2.58311554605,0.139681761045
"Schoharie County, New York",2015,31913,43.3,17201,4792,12409,51195,2.57176243049,0.150158242722
"Schoolcraft County, Michigan",2009,8413,46,6065,2543,3522,37906,2.3886996025,0.302270295971
"Schoolcraft County, Michigan",2012,8455,48.3,6297,2646,3651,37468,2.31580388935,0.312950916617
"Schoolcraft County, Michigan",2015,8288,50,6325,2906,3419,34118,2.42410061421,0.350627413127
"Schuyler County, Illinois",2009,6917,43.6,3428,388,3040,42425,2.27532894737,0.0560936822322
"Schuyler County, Illinois",2012,7499,43.2,3456,370,3086,46934,2.43000648088,0.0493399119883
"Schuyler County, Illinois",2015,7311,44.7,3441,441,3000,47723,2.437,0.0603200656545
"Schuyler County, Missouri",2009,4106,42,2328,327,2001,30683,2.05197401299,0.0796395518753
"Schuyler County, Missouri",2012,4397,41.4,2109,353,1756,30896,2.50398633257,0.0802820104617
"Schuyler County, Missouri",2015,4395,41.3,2087,365,1722,37500,2.55226480836,0.0830489192264
"Schuyler County, New York",2009,18896,42.2,9451,1839,7612,44575,2.4823962165,0.0973221845893
"Schuyler County, New York",2012,18472,44.3,9456,1886,7570,47869,2.44015852048,0.102100476397
"Schuyler County, New York",2015,18410,45.5,9513,1827,7686,47680,2.39526411658,0.0992395437262
"Schuylkill County, Pennsylvania",2009,146870,42.6,69906,9071,60835,41315,2.41423522643,0.0617621025397
"Schuylkill County, Pennsylvania",2012,147935,43.2,69333,9212,60121,45441,2.46062108082,0.062270591814
"Schuylkill County, Pennsylvania",2015,146360,43.8,69143,10589,58554,45535,2.49957304369,0.0723490024597
"Scioto County, Ohio",2009,76310,37.9,34878,4210,30668,31445,2.48826137994,0.0551697025292
"Scioto County, Ohio",2012,79122,38.7,34187,4617,29570,34783,2.67575245181,0.0583529233336
"Scioto County, Ohio",2015,78017,39.5,34084,4384,29700,35903,2.62683501684,0.0561928810387
"Scotland County, Missouri",2009,4790,42.5,2409,387,2022,35548,2.36894164194,0.0807933194154
"Scotland County, Missouri",2012,4843,39.4,2367,400,1967,40017,2.46212506355,0.082593433822
"Scotland County, Missouri",2015,4873,39.1,2351,500,1851,39772,2.63263101026,0.102606197414
"Scotland County, North Carolina",2009,36394,36.3,15373,2140,13233,31439,2.75024559813,0.0588009012475
"Scotland County, North Carolina",2012,36266,37.8,15217,2134,13083,30472,2.77199419093,0.0588429934374
"Scotland County, North Carolina",2015,35932,39.1,15173,2177,12996,30958,2.7648507233,0.0605866636981
"Scott County, Arkansas",2009,11170,40.1,5156,781,4375,33969,2.55314285714,0.0699194270367
"Scott County, Arkansas",2012,11170,41.4,5189,942,4247,38130,2.63009182953,0.084333034915
"Scott County, Arkansas",2015,10870,41.3,5191,1136,4055,37321,2.68064118372,0.104507819687
"Scott County, Illinois",2009,5238,42.5,2557,205,2352,48611,2.22704081633,0.0391370752195
"Scott County, Illinois",2012,5322,43.1,2462,344,2118,49746,2.51274787535,0.0646373543781
"Scott County, Illinois",2015,5198,43.5,2435,311,2124,47222,2.4472693032,0.059830704117
"Scott County, Indiana",2009,23646,38.1,10842,1218,9624,38372,2.45698254364,0.0515097690941
"Scott County, Indiana",2012,24044,39.1,10476,1448,9028,41610,2.6632698272,0.0602229246382
"Scott County, Indiana",2015,23783,40.3,10443,1481,8962,44442,2.65376032136,0.0622713703065
"Scott County, Iowa",2009,162994,36.9,70410,4781,65629,50656,2.48356671593,0.0293323680626
"Scott County, Iowa",2012,165432,37.4,71849,4935,66914,53002,2.47230773829,0.0298309879588
"Scott County, Iowa",2015,169994,37.6,72800,5091,67709,55114,2.51065589508,0.0299481158159
"Scott County, Kansas",2009,4658,43.1,2300,128,2172,57843,2.14456721915,0.0274796049807
"Scott County, Kansas",2012,4872,43.8,2202,137,2065,58520,2.3593220339,0.0281198686371
"Scott County, Kansas",2015,4928,42,2373,177,2196,51850,2.24408014572,0.0359172077922
"Scott County, Kentucky",2009,42874,34.3,16710,1294,15416,59764,2.78113648158,0.0301814619583
"Scott County, Kentucky",2012,47211,35.2,19273,1597,17676,60553,2.67090970808,0.0338268623838
"Scott County, Kentucky",2015,50178,35.8,20154,1733,18421,63027,2.72395635416,0.0345370481087
"Scott County, Minnesota",2009,125714,34.2,45433,2043,43390,83503,2.89730352616,0.0162511732981
"Scott County, Minnesota",2012,130689,34.9,47278,2145,45133,84571,2.89564176988,0.0164130110415
"Scott County, Minnesota",2015,137322,35.5,48760,1955,46805,87794,2.93391731653,0.0142366117592
"Scott County, Mississippi",2009,29137,34.6,11707,1661,10046,32114,2.90035835158,0.057006555239
"Scott County, Mississippi",2012,28207,35,11499,1734,9765,35074,2.88858166923,0.0614741021732
"Scott County, Mississippi",2015,28293,36,11480,1653,9827,32935,2.87910857841,0.0584243452444
"Scott County, Missouri",2009,40753,38.1,17687,1641,16046,37132,2.53976068802,0.0402669742105
"Scott County, Missouri",2012,39192,38.9,17027,1743,15284,38968,2.56425019628,0.0444733619106
"Scott County, Missouri",2015,39061,39.7,16999,1752,15247,39162,2.56188102578,0.0448529223522
"Scott County, Tennessee",2009,21852,36.6,9384,924,8460,27027,2.5829787234,0.0422844590884
"Scott County, Tennessee",2012,22196,37.9,9884,1445,8439,29161,2.63016945136,0.0651018201478
"Scott County, Tennessee",2015,22043,38.6,9872,1563,8309,30246,2.65290648694,0.070906863857
"Scott County, Virginia",2009,22771,44.2,11835,1779,10056,33325,2.26441925219,0.0781256861798
"Scott County, Virginia",2012,23061,44.7,11908,2298,9610,37544,2.39968782518,0.0996487576428
"Scott County, Virginia",2015,22570,45.4,11876,2497,9379,37240,2.40643991897,0.110633584404
"Scotts Bluff County, Nebraska",2009,36483,39,16372,1346,15026,37643,2.42799148143,0.0368938957871
"Scotts Bluff County, Nebraska",2012,36835,38.7,16414,1528,14886,43113,2.47447265887,0.0414822858694
"Scotts Bluff County, Nebraska",2015,36684,38.8,16354,1599,14755,45992,2.48620806506,0.0435884854432
"Screven County, Georgia",2009,15077,38.2,7483,2245,5238,32943,2.87838869798,0.148902301519
"Screven County, Georgia",2012,14574,39.7,6762,1901,4861,34634,2.99814852911,0.130437765884
"Screven County, Georgia",2015,14206,40,6675,1385,5290,34466,2.6854442344,0.0974940166127
"Scurry County, Texas",2009,15994,36.4,6867,901,5966,39665,2.68085819645,0.0563336251094
"Scurry County, Texas",2012,16855,37.2,7010,862,6148,46340,2.74154196487,0.051142094334
"Scurry County, Texas",2015,17238,36,7137,1305,5832,56842,2.95576131687,0.0757048381483
"Searcy County, Arkansas",2009,8002,45.6,4473,1129,3344,27071,2.39294258373,0.141089727568
"Searcy County, Arkansas",2012,8146,47.1,4876,1529,3347,30301,2.43382133254,0.18769948441
"Searcy County, Arkansas",2015,7965,47,4901,1729,3172,33083,2.51103404792,0.21707470182
"Sebastian County, Arkansas",2009,121325,36.2,52905,5569,47336,39131,2.56305982762,0.0459015042242
"Sebastian County, Arkansas",2012,125795,36.6,54671,5894,48777,40247,2.57898189721,0.0468540085059
"Sebastian County, Arkansas",2015,127273,36.9,55758,6179,49579,38575,2.56707476956,0.0485491816803
"Sedgwick County, Colorado",2009,2378,48.9,1249,308,941,37792,2.52709883103,0.129520605551
"Sedgwick County, Colorado",2012,2389,47.9,1366,385,981,38401,2.43527013252,0.161155295103
"Sedgwick County, Colorado",2015,2365,49.8,1287,336,951,44191,2.48685594111,0.142071881607
"Sedgwick County, Kansas",2009,476195,34.2,206792,17815,188977,47768,2.5198569138,0.0374111445941
"Sedgwick County, Kansas",2012,497062,34.4,211361,18555,192806,49885,2.57804217711,0.0373293472444
"Sedgwick County, Kansas",2015,506529,34.6,213700,20739,192961,50657,2.62503303776,0.0409433615844
"Seminole County, Florida",2009,408694,37,171448,19851,151597,58313,2.69592406182,0.0485717920987
"Seminole County, Florida",2012,423389,38.3,181231,32596,148635,58577,2.84851481818,0.0769883015383
"Seminole County, Florida",2015,437346,39.1,184374,32114,152260,57010,2.87236306318,0.0734292756765
"Seminole County, Georgia",2009,9068,41.2,4950,1663,3287,35364,2.75874657743,0.183392148213
"Seminole County, Georgia",2012,8815,43.7,4817,1559,3258,28909,2.70564763659,0.176857629041
"Seminole County, Georgia",2015,8769,45.1,4801,1500,3301,34905,2.65646773705,0.171057133082
"Seminole County, Oklahoma",2009,24132,39.1,11561,2227,9334,31760,2.58538675809,0.0922841040941
"Seminole County, Oklahoma",2012,25394,39.2,11652,2149,9503,33377,2.67220877618,0.0846262896747
"Seminole County, Oklahoma",2015,25481,39.7,11662,2460,9202,36068,2.76907194088,0.096542521879
"Seneca County, New York",2009,34181,40.3,14927,2698,12229,45571,2.79507727533,0.0789327404113
"Seneca County, New York",2012,35306,41.2,16020,2620,13400,49155,2.6347761194,0.0742083498555
"Seneca County, New York",2015,35144,42.3,16161,2600,13561,49292,2.59154929577,0.0739813339404
"Seneca County, Ohio",2009,56711,38.7,24400,1947,22453,43397,2.52576493119,0.0343319638165
"Seneca County, Ohio",2012,56630,38.8,24091,2200,21891,42375,2.58690786168,0.0388486667844
"Seneca County, Ohio",2015,55929,39,23959,2421,21538,45444,2.59675921627,0.0432870246205
"Sequatchie County, Tennessee",2009,13377,37.4,5234,1023,4211,37150,3.17668012349,0.0764745458623
"Sequatchie County, Tennessee",2012,14173,40.6,6314,821,5493,33181,2.58019297287,0.0579270443802
"Sequatchie County, Tennessee",2015,14592,41.9,6384,769,5615,45408,2.59875333927,0.0527001096491
"Sequoyah County, Oklahoma",2009,40886,37.9,18118,3153,14965,33424,2.73210825259,0.0771168615174
"Sequoyah County, Oklahoma",2012,41945,38.9,18662,3096,15566,36191,2.69465501735,0.0738109429014
"Sequoyah County, Oklahoma",2015,41464,39.9,18800,3248,15552,35736,2.66615226337,0.0783330117692
"Sevier County, Arkansas",2009,16516,33.9,6692,918,5774,34090,2.86040872878,0.055582465488
"Sevier County, Arkansas",2012,16978,33.9,6868,1077,5791,32081,2.93179070972,0.0634350335729
"Sevier County, Arkansas",2015,17268,34.9,6878,803,6075,36579,2.8424691358,0.0465022006023
"Sevier County, Tennessee",2009,83448,40.5,42669,11529,31140,41774,2.67976878613,0.138157894737
"Sevier County, Tennessee",2012,90218,41.2,55217,18161,37056,43300,2.43463946459,0.201301292425
"Sevier County, Tennessee",2015,93617,42.2,56241,19524,36717,42258,2.54969087888,0.20855186558
"Sevier County, Utah",2009,19603,31.7,7742,1299,6443,44411,3.04252677324,0.0662653675458
"Sevier County, Utah",2012,20759,32.9,8412,1295,7117,45599,2.91681888436,0.0623825810492
"Sevier County, Utah",2015,20871,34.1,8495,1445,7050,46291,2.96042553191,0.0692348234392
"Seward County, Kansas",2009,22648,29.2,8160,589,7571,41290,2.99141460837,0.0260067114094
"Seward County, Kansas",2012,23013,29,8080,689,7391,47731,3.1136517386,0.0299395993569
"Seward County, Kansas",2015,23274,29.4,8110,630,7480,47134,3.1114973262,0.0270688321732
"Seward County, Nebraska",2009,16575,37,6882,399,6483,54872,2.55668671911,0.02407239819
"Seward County, Nebraska",2012,16729,38.3,6899,630,6269,60676,2.66852767587,0.0376591547612
"Seward County, Nebraska",2015,16998,38.2,6966,618,6348,59662,2.67769376181,0.0363572184963
"Shackelford County, Texas",2009,3084,40.9,1644,417,1227,44429,2.51344743276,0.135214007782
"Shackelford County, Texas",2012,3346,43.1,1752,398,1354,46181,2.47119645495,0.118947997609
"Shackelford County, Texas",2015,3352,43,1757,380,1377,48750,2.43427741467,0.113365155131
"Shannon County, Missouri",2009,8310,40.4,4040,667,3373,28474,2.46368218203,0.0802647412756
"Shannon County, Missouri",2012,8407,44.2,4160,789,3371,33091,2.49391871848,0.0938503627929
"Shannon County, Missouri",2015,8317,44.5,4126,849,3277,32404,2.53799206591,0.102080076951
"Shannon County, South Dakota",2009,13593,22.1,3313,535,2778,28808,4.89308855292,0.0393584933422
"Shannon County, South Dakota",2012,13683,23.5,3580,751,2829,26282,4.83669141039,0.0548856244976
"Sharkey County, Mississippi",2009,5184,35.1,2526,463,2063,29495,2.51284537082,0.0893132716049
"Sharkey County, Mississippi",2012,4835,38.2,2094,431,1663,32340,2.9073962718,0.0891416752844
"Sharkey County, Mississippi",2015,4805,38.5,2120,351,1769,30525,2.71622385529,0.0730489073881
"Sharp County, Arkansas",2009,17689,45.7,9641,2592,7049,29589,2.50943396226,0.146531742891
"Sharp County, Arkansas",2012,17278,46.4,9816,2752,7064,30240,2.44592298981,0.159277694178
"Sharp County, Arkansas",2015,17055,47.2,9825,2717,7108,30691,2.39940911649,0.159308120786
"Shasta County, California",2009,179387,40.8,76361,6890,69471,44755,2.58218537231,0.0384085803319
"Shasta County, California",2012,177693,41.9,77300,8420,68880,44396,2.57974738676,0.047385096768
"Shasta County, California",2015,178942,42.2,77790,8415,69375,44620,2.57934414414,0.0470264107923
"Shawano County, Wisconsin",2009,41066,41.7,20157,3091,17066,45376,2.40630493379,0.0752690790435
"Shawano County, Wisconsin",2012,41820,43.2,20674,3455,17219,45901,2.42871246878,0.0826159732186
"Shawano County, Wisconsin",2015,41563,44.3,20696,3739,16957,47861,2.45108214897,0.0899598200322
"Shawnee County, Kansas",2009,173845,37.9,78757,5553,73204,46955,2.37480192339,0.0319422474043
"Shawnee County, Kansas",2012,177688,38.4,79134,5921,73213,47992,2.42700066928,0.0333224528387
"Shawnee County, Kansas",2015,178792,38.8,79425,8057,71368,50378,2.50521242013,0.0450635375185
"Sheboygan County, Wisconsin",2009,114122,39.2,49902,3693,46209,52848,2.46969205133,0.0323601058516
"Sheboygan County, Wisconsin",2012,115377,40.2,50649,4438,46211,52967,2.49674319967,0.0384652053702
"Sheboygan County, Wisconsin",2015,115226,41.3,50648,3947,46701,53713,2.46731333376,0.0342544217451
"Shelby County, Alabama",2009,182996,35.7,76523,6744,69779,67534,2.62250820447,0.0368532645522
"Shelby County, Alabama",2012,195237,36.9,80956,7332,73624,69379,2.65181190916,0.0375543570122
"Shelby County, Alabama",2015,203530,37.9,82850,7316,75534,70187,2.6945481505,0.035945560851
"Shelby County, Illinois",2009,21854,43,10426,1256,9170,45340,2.38320610687,0.0574723162808
"Shelby County, Illinois",2012,22316,44,10420,1425,8995,46546,2.48093385214,0.0638555296648
"Shelby County, Illinois",2015,22115,44.4,10450,1406,9044,47850,2.44526758072,0.0635767578567
"Shelby County, Indiana",2009,43964,39.2,18817,1750,17067,51448,2.57596531318,0.0398052952416
"Shelby County, Indiana",2012,44435,39.9,19064,1940,17124,51829,2.59489605232,0.0436592775965
"Shelby County, Indiana",2015,44441,41,19080,1887,17193,53584,2.58483103589,0.0424607907113
"Shelby County, Iowa",2009,12218,45.1,5489,575,4914,43420,2.48636548637,0.0470617122279
"Shelby County, Iowa",2012,12158,45.8,5531,425,5106,47731,2.38112025069,0.0349564073038
"Shelby County, Iowa",2015,11992,46.6,5553,487,5066,50952,2.36715357284,0.040610406938
"Shelby County, Kentucky",2009,40322,37.4,15910,1066,14844,55748,2.71638372406,0.0264371806954
"Shelby County, Kentucky",2012,42286,38.2,16599,1353,15246,56267,2.7735799554,0.0319964054297
"Shelby County, Kentucky",2015,44290,38.7,16901,1013,15888,60324,2.78763846928,0.022871980131
"Shelby County, Missouri",2009,6457,41.9,3331,525,2806,33275,2.3011404134,0.0813071085643
"Shelby County, Missouri",2012,6328,43.4,3205,562,2643,34219,2.39424895952,0.088811630847
"Shelby County, Missouri",2015,6179,42.4,3189,690,2499,39087,2.47258903561,0.111668554782
"Shelby County, Ohio",2009,48712,37.1,20022,1581,18441,49323,2.64150534136,0.0324560683199
"Shelby County, Ohio",2012,49359,38.3,20170,1883,18287,51159,2.69913052988,0.0381490710914
"Shelby County, Ohio",2015,49067,38.9,20201,1664,18537,54550,2.64697631764,0.0339128130923
"Shelby County, Tennessee",2009,918186,34.1,397268,53173,344095,44146,2.66840843372,0.0579109243661
"Shelby County, Tennessee",2012,929437,34.5,398847,56899,341948,46251,2.71806531987,0.0612187808318
"Shelby County, Tennessee",2015,937750,34.9,401715,54491,347224,46224,2.70070617238,0.0581082378033
"Shelby County, Texas",2009,26358,36.9,12528,2514,10014,31866,2.63211503895,0.0953790120646
"Shelby County, Texas",2012,25602,37.9,11905,2137,9768,35732,2.62100737101,0.083470041403
"Shelby County, Texas",2015,25725,36.9,11902,2506,9396,37756,2.73786717752,0.0974149659864
"Shenandoah County, Virginia",2009,40325,42.4,19367,2622,16745,50436,2.40818154673,0.0650216986981
"Shenandoah County, Virginia",2012,42076,42.7,20817,3556,17261,49953,2.43763397254,0.0845137370472
"Shenandoah County, Virginia",2015,42724,43.8,21026,3930,17096,49406,2.49906410856,0.0919857691227
"Sherburne County, Minnesota",2009,85211,32.7,31270,2804,28466,71228,2.9934307595,0.0329065496239
"Sherburne County, Minnesota",2012,88558,34.3,32381,2413,29968,72041,2.95508542445,0.0272476794869
"Sherburne County, Minnesota",2015,90401,35.3,32743,2169,30574,74170,2.95679335383,0.0239930974215
"Sheridan County, Kansas",2009,2472,45.7,1262,165,1097,46520,2.25341841386,0.0667475728155
"Sheridan County, Kansas",2012,2562,46.6,1268,164,1104,49125,2.32065217391,0.064012490242
"Sheridan County, Kansas",2015,2531,45.7,1263,130,1133,49750,2.23389232127,0.0513630975899
"Sheridan County, Montana",2009,3568,49.4,2055,389,1666,39091,2.14165666267,0.109024663677
"Sheridan County, Montana",2012,3447,48.2,2114,508,1606,48148,2.14632627646,0.147374528576
"Sheridan County, Montana",2015,3630,47.1,2107,468,1639,50664,2.21476510067,0.128925619835
"Sheridan County, Nebraska",2009,5403,46.2,2976,555,2421,31003,2.23172242875,0.102720710716
"Sheridan County, Nebraska",2012,5432,46.6,2943,570,2373,37813,2.28908554572,0.104933726068
"Sheridan County, Nebraska",2015,5294,46.1,2919,660,2259,41985,2.34351482957,0.124669437099
"Sheridan County, North Dakota",2009,1320,53.5,954,268,686,35968,1.92419825073,0.20303030303
"Sheridan County, North Dakota",2012,1282,53.4,905,294,611,39811,2.09819967267,0.229329173167
"Sheridan County, North Dakota",2015,1337,52,843,190,653,48102,2.04747320061,0.142109199701
"Sheridan County, Wyoming",2009,28062,42.4,13783,1488,12295,45861,2.28239121594,0.0530254436605
"Sheridan County, Wyoming",2012,29097,42.5,13967,1521,12446,52352,2.33785955327,0.0522734302505
"Sheridan County, Wyoming",2015,29738,42.2,14257,1679,12578,55455,2.36428685006,0.05645974847
"Sherman County, Kansas",2009,5915,40.4,3267,643,2624,40325,2.25419207317,0.108706677937
"Sherman County, Kansas",2012,6036,41.1,3153,424,2729,42642,2.21179919384,0.0702451954937
"Sherman County, Kansas",2015,6054,38.4,3124,338,2786,39029,2.17300789663,0.0558308556326
"Sherman County, Nebraska",2009,2962,47.6,1983,559,1424,36741,2.08005617978,0.188723835246
"Sherman County, Nebraska",2012,3133,48.6,1934,568,1366,43000,2.29355783309,0.181295882541
"Sherman County, Nebraska",2015,3107,49.5,1937,560,1377,46366,2.25635439361,0.18023817187
"Sherman County, Oregon",2009,1779,45.1,980,145,835,35144,2.13053892216,0.0815064643058
"Sherman County, Oregon",2012,1865,46.7,900,112,788,44583,2.36675126904,0.0600536193029
"Sherman County, Oregon",2015,1795,49.8,938,134,804,38362,2.23258706468,0.074651810585
"Sherman County, Texas",2009,2905,33.3,1306,271,1035,40231,2.80676328502,0.0932874354561
"Sherman County, Texas",2012,3040,35.4,1188,192,996,47500,3.05220883534,0.0631578947368
"Sherman County, Texas",2015,3066,38.3,1279,293,986,51987,3.10953346856,0.0955642530985
"Shiawassee County, Michigan",2009,71406,39.1,30443,2602,27841,46260,2.56477856399,0.0364395148867
"Shiawassee County, Michigan",2012,70402,40.4,30291,2913,27378,47106,2.57148075097,0.0413766654356
"Shiawassee County, Michigan",2015,69113,41.5,30129,2720,27409,48233,2.52154401839,0.0393558375414
"Shoshone County, Idaho",2009,12794,45.1,7221,1431,5790,35357,2.20967184801,0.111849304361
"Shoshone County, Idaho",2012,12797,46.5,7066,1275,5791,38273,2.20980832326,0.0996327264203
"Shoshone County, Idaho",2015,12571,47.1,6991,1279,5712,37665,2.20080532213,0.101742104844
"Sibley County, Minnesota",2009,15001,39.5,6442,402,6040,50656,2.48360927152,0.0267982134524
"Sibley County, Minnesota",2012,15189,40.6,6569,458,6111,52996,2.48551791851,0.0301534004872
"Sibley County, Minnesota",2015,15021,41.4,6538,524,6014,56990,2.49767209844,0.0348844950403
"Sierra County, California",2009,3240,48.3,2272,869,1403,53750,2.30933713471,0.268209876543
"Sierra County, California",2012,3163,51.6,2266,928,1338,42500,2.36397608371,0.293392349036
"Sierra County, California",2015,3021,54.5,2311,1059,1252,42833,2.41293929712,0.350546176763
"Sierra County, New Mexico",2009,12645,51.5,8979,3493,5486,25642,2.3049580751,0.276235666271
"Sierra County, New Mexico",2012,11956,53.8,8373,4112,4261,29185,2.80591410467,0.343927735028
"Sierra County, New Mexico",2015,11615,55.6,8304,3260,5044,29356,2.30273592387,0.280671545415
"Silver Bow County, Montana",2009,32740,41.5,16343,1960,14383,37324,2.27629840784,0.0598656078192
"Silver Bow County, Montana",2012,34164,41.7,16723,1788,14935,39211,2.2875125544,0.0523357920618
"Silver Bow County, Montana",2015,34549,40.6,16776,1632,15144,37749,2.28136555732,0.0472372572289
"Simpson County, Kentucky",2009,17001,38.1,7770,635,7135,40720,2.38276103714,0.0373507440739
"Simpson County, Kentucky",2012,17323,38.4,7469,792,6677,40930,2.59442863561,0.045719563586
"Simpson County, Kentucky",2015,17704,39.6,7531,738,6793,39679,2.60621227734,0.0416854948034
"Simpson County, Mississippi",2009,27903,36.5,11765,1441,10324,34187,2.70273149942,0.0516431924883
"Simpson County, Mississippi",2012,27476,38.1,11914,1935,9979,37977,2.75338210242,0.0704250982676
"Simpson County, Mississippi",2015,27401,37.7,11923,2304,9619,35375,2.84863291402,0.0840845224627
"Sioux County, Iowa",2009,32069,33.2,11960,749,11211,49272,2.86049415752,0.0233558888646
"Sioux County, Iowa",2012,33776,32.9,12271,733,11538,55252,2.92737042815,0.0217018000947
"Sioux County, Iowa",2015,34509,33.3,12504,739,11765,61627,2.93319167021,0.0214147034107
"Sioux County, Nebraska",2009,1218,48.2,790,261,529,43313,2.30245746692,0.214285714286
"Sioux County, Nebraska",2012,1262,47.5,823,264,559,43558,2.25760286225,0.209191759113
"Sioux County, Nebraska",2015,1249,48.1,800,251,549,41215,2.27504553734,0.200960768615
"Sioux County, North Dakota",2009,4144,25.8,1265,237,1028,29858,4.03112840467,0.0571911196911
"Sioux County, North Dakota",2012,4193,26.2,1309,240,1069,30799,3.92235734331,0.0572382542332
"Sioux County, North Dakota",2015,4380,27,1324,226,1098,38068,3.98907103825,0.051598173516
"Siskiyou County, California",2009,44404,46.6,23515,3677,19838,37938,2.23833047686,0.0828078551482
"Siskiyou County, California",2012,44673,47,23862,4277,19585,37948,2.2809803421,0.0957401562465
"Siskiyou County, California",2015,43895,47.8,24002,4869,19133,37170,2.29420373177,0.110923795421
"Sitka City and Borough, Alaska",2009,8811,38.5,3934,418,3516,58895,2.50597269625,0.0474406991261
"Sitka City and Borough, Alaska",2012,8909,38.8,4094,471,3623,66895,2.45901186862,0.052867886407
"Sitka City and Borough, Alaska",2015,8943,38.9,4119,647,3472,70376,2.57574884793,0.0723470871072
"Skagit County, Washington",2009,116152,39.3,48160,4447,43713,53094,2.6571500469,0.0382860389834
"Skagit County, Washington",2012,117087,40.2,51341,5867,45474,56457,2.57481198047,0.0501080393212
"Skagit County, Washington",2015,119343,41,51874,6033,45841,54129,2.60341179294,0.0505517709459
"Skagway Municipality, Alaska",2009,1071,38.2,535,156,379,71295,2.82585751979,0.145658263305
"Skagway Municipality, Alaska",2012,1050,46.7,611,216,395,71583,2.6582278481,0.205714285714
"Skagway Municipality, Alaska",2015,999,43.7,636,230,406,69318,2.460591133,0.23023023023
"Skamania County, Washington",2009,10666,42.6,5109,826,4283,46943,2.49031053,0.0774423401463
"Skamania County, Washington",2012,11053,44.5,5607,1229,4378,55319,2.52466879854,0.111191531711
"Skamania County, Washington",2015,11243,45.2,5653,1158,4495,52374,2.50122358176,0.102997420617
"Slope County, North Dakota",2009,703,44.9,468,143,325,42679,2.16307692308,0.203413940256
"Slope County, North Dakota",2012,768,49.3,433,145,288,55313,2.66666666667,0.188802083333
"Slope County, North Dakota",2015,673,50.4,461,139,322,55000,2.0900621118,0.206537890045
"Smith County, Kansas",2009,3926,50.1,2246,416,1830,38347,2.14535519126,0.105960264901
"Smith County, Kansas",2012,3835,50.4,2241,452,1789,44798,2.14365567356,0.117861799218
"Smith County, Kansas",2015,3740,50.7,2240,573,1667,43848,2.24355128974,0.15320855615
"Smith County, Mississippi",2009,15889,37.3,7391,1433,5958,36762,2.66683450822,0.0901881805022
"Smith County, Mississippi",2012,16425,39.2,7246,1002,6244,36519,2.63052530429,0.06100456621
"Smith County, Mississippi",2015,16257,40.1,7239,1154,6085,32951,2.6716516023,0.0709848065449
"Smith County, Tennessee",2009,18863,38.9,8244,1419,6825,44430,2.76380952381,0.0752266341515
"Smith County, Tennessee",2012,19157,40.2,8519,1263,7256,44116,2.6401598677,0.065928903273
"Smith County, Tennessee",2015,19136,41.6,8585,1107,7478,43914,2.55897298743,0.0578490802676
"Smith County, Texas",2009,197631,35.7,77329,8084,69245,45447,2.85408332732,0.040904513968
"Smith County, Texas",2012,209691,35.8,86878,8962,77916,47312,2.69124441706,0.0427390779766
"Smith County, Texas",2015,217552,36.1,88145,9367,78778,46929,2.76158318312,0.0430563727293
"Smyth County, Virginia",2009,31996,42,15547,2376,13171,36103,2.42927644067,0.0742592824103
"Smyth County, Virginia",2012,32103,43.3,15432,2865,12567,34394,2.55454762473,0.0892439958882
"Smyth County, Virginia",2015,31734,44.3,15356,2561,12795,37983,2.48018757327,0.0807020860906
"Snohomish County, Washington",2009,673709,36.4,274713,15571,259142,64780,2.59976769493,0.0231123526626
"Snohomish County, Washington",2012,714443,37.2,286836,18290,268546,68338,2.66041199645,0.0256003628001
"Snohomish County, Washington",2015,746653,37.6,294147,19381,274766,70722,2.71741409054,0.0259571715375
"Snyder County, Pennsylvania",2009,38261,38.7,15646,1561,14085,44702,2.71643592474,0.0407987245498
"Snyder County, Pennsylvania",2012,39620,39.2,16011,1656,14355,47059,2.76001393243,0.0417970721858
"Snyder County, Pennsylvania",2015,40046,39.3,16104,1662,14442,49917,2.77288464202,0.0415022723868
"Socorro County, New Mexico",2009,18163,34.9,7943,1700,6243,32329,2.90933845907,0.0935968727633
"Socorro County, New Mexico",2012,17843,35.8,8039,2565,5474,34337,3.25959079284,0.143753853052
"Socorro County, New Mexico",2015,17494,36.8,8010,3063,4947,34037,3.53628461694,0.175088601806
"Solano County, California",2009,406461,35.9,149335,12429,136906,67920,2.96890567251,0.0305785794947
"Solano County, California",2012,414209,37,152624,12329,140295,69006,2.95241455504,0.0297651668602
"Solano County, California",2015,425753,37.3,154380,10768,143612,66828,2.96460602178,0.0252916597182
"Somerset County, Maine",2009,51175,42.5,28971,7773,21198,36210,2.41414284366,0.151890571568
"Somerset County, Maine",2012,52098,43.9,30538,8691,21847,38141,2.38467524145,0.166820223425
"Somerset County, Maine",2015,51577,44.9,30720,8920,21800,40066,2.36591743119,0.172945305078
"Somerset County, Maryland",2009,25943,36.8,10921,2580,8341,41615,3.11029852536,0.0994487915815
"Somerset County, Maryland",2012,26402,36.9,11129,2635,8494,41558,3.10831174947,0.0998030452238
"Somerset County, Maryland",2015,25980,37,11181,2796,8385,35154,3.09838998211,0.107621247113
"Somerset County, New Jersey",2009,320712,39,121030,7516,113514,96233,2.82530789154,0.0234353563322
"Somerset County, New Jersey",2012,323650,40.2,123357,8225,115132,98571,2.8111211479,0.0254132550595
"Somerset County, New Jersey",2015,330604,40.8,124672,8674,115998,100667,2.85008362213,0.0262368271406
"Somerset County, Pennsylvania",2009,77710,43.5,38220,7350,30870,38109,2.51733074182,0.0945824218247
"Somerset County, Pennsylvania",2012,77638,44.4,38093,8101,29992,42424,2.58862363297,0.104343233983
"Somerset County, Pennsylvania",2015,76617,45.3,38004,8385,29619,44587,2.58675174719,0.109440463605
"Somervell County, Texas",2009,7730,37.5,3100,498,2602,48566,2.97079169869,0.0644243208279
"Somervell County, Texas",2012,8444,39.4,3642,421,3221,51618,2.62154610369,0.0498578872572
"Somervell County, Texas",2015,8608,40.6,3710,324,3386,51912,2.54223272298,0.0376394052045
"Sonoma County, California",2009,464218,39.3,196952,17891,179061,63848,2.5925131659,0.0385400824613
"Sonoma County, California",2012,483456,39.8,204247,19745,184502,63565,2.62032931892,0.0408413588827
"Sonoma County, California",2015,495078,40.8,206399,18617,187782,64240,2.63645077803,0.0376041755037
"Southampton County, Virginia",2009,18177,39.3,7631,902,6729,47285,2.70129291128,0.0496231501348
"Southampton County, Virginia",2012,18576,43.9,7479,947,6532,46703,2.84384568279,0.0509797588286
"Southampton County, Virginia",2015,18410,45.4,7529,847,6682,48962,2.75516312481,0.0460076045627
"Southeast Fairbanks Census Area, Alaska",2009,6760,33.7,3321,1093,2228,59407,3.03411131059,0.161686390533
"Southeast Fairbanks Census Area, Alaska",2012,7039,36.3,3889,1489,2400,62712,2.93291666667,0.211535729507
"Southeast Fairbanks Census Area, Alaska",2015,7029,35.8,3909,1792,2117,62670,3.32026452527,0.25494380424
"Spalding County, Georgia",2009,63073,35.5,26174,3257,22917,41319,2.75223633111,0.0516385775213
"Spalding County, Georgia",2012,63979,37.1,26759,3686,23073,40655,2.77289472544,0.0576126541521
"Spalding County, Georgia",2015,63873,38.2,26926,4209,22717,40246,2.81168288066,0.0658963881452
"Spartanburg County, South Carolina",2009,276544,37.6,120715,14488,106227,42349,2.60333060333,0.0523894931729
"Spartanburg County, South Carolina",2012,284540,38,122623,15802,106821,43421,2.66370844684,0.055535249877
"Spartanburg County, South Carolina",2015,291240,38.2,123931,14039,109892,43907,2.6502384159,0.0482042301882
"Spencer County, Indiana",2009,20167,40.5,9075,712,8363,51120,2.41145521942,0.0353052015669
"Spencer County, Indiana",2012,20948,42.3,8894,810,8084,54832,2.59129143988,0.038667175864
"Spencer County, Indiana",2015,20856,42.7,8919,955,7964,55247,2.61878453039,0.0457901802839
"Spencer County, Kentucky",2009,16707,37.7,6379,381,5998,57611,2.78542847616,0.0228048123541
"Spencer County, Kentucky",2012,17135,39.4,6717,483,6234,62652,2.74863650946,0.0281879194631
"Spencer County, Kentucky",2015,17577,40.5,6883,465,6418,63000,2.738703646,0.026455026455
"Spink County, South Dakota",2009,6673,44,3391,483,2908,44552,2.2947042641,0.0723812378241
"Spink County, South Dakota",2012,6483,44.2,3149,518,2631,46884,2.46408209806,0.0799012802715
"Spink County, South Dakota",2015,6570,43.8,3140,509,2631,48217,2.49714937286,0.0774733637747
"Spokane County, Washington",2009,454927,36.4,194382,12614,181768,46207,2.50278926984,0.0277275255151
"Spokane County, Washington",2012,470375,36.8,201484,14087,187397,49615,2.51004551834,0.0299484453893
"Spokane County, Washington",2015,480832,37.2,205487,16016,189471,50079,2.53776039605,0.0333089311859
"Spotsylvania County, Virginia",2009,118512,35,44121,3431,40690,77225,2.91255836815,0.028950654786
"Spotsylvania County, Virginia",2012,122854,36.4,45276,3896,41380,79402,2.96892218463,0.0317124391554
"Spotsylvania County, Virginia",2015,127691,36.7,45979,3156,42823,78125,2.98183219298,0.0247159157654
"St. Bernard Parish, Louisiana",2009,38241,35.5,16138,3145,12993,38478,2.94320018471,0.0822415731806
"St. Bernard Parish, Louisiana",2012,35947,33.2,16553,3472,13081,40590,2.74803149606,0.0965866414443
"St. Bernard Parish, Louisiana",2015,42858,33,16800,2255,14545,42753,2.94657958061,0.0526156143544
"St. Charles County, Missouri",2009,342562,36.5,133569,6341,127228,70077,2.69250479454,0.0185105178041
"St. Charles County, Missouri",2012,360695,37,141259,6566,134693,71416,2.67790456817,0.0182037455468
"St. Charles County, Missouri",2015,374805,37.4,145704,6746,138958,72415,2.69725384649,0.0179986926535
"St. Charles Parish, Louisiana",2009,51410,36.5,19640,1460,18180,59884,2.82783278328,0.0283991441354
"St. Charles Parish, Louisiana",2012,52663,36.7,19958,1552,18406,59197,2.8611865696,0.0294704061675
"St. Charles Parish, Louisiana",2015,52639,37.2,20209,1826,18383,59990,2.86346080618,0.0346891088357
"St. Clair County, Alabama",2009,77585,37.8,31099,4744,26355,48425,2.94384367293,0.0611458400464
"St. Clair County, Alabama",2012,83530,38.8,35336,4366,30970,49652,2.69712625121,0.0522686459955
"St. Clair County, Alabama",2015,85864,39.8,35741,3762,31979,51859,2.68501203915,0.0438134724681
"St. Clair County, Illinois",2009,261268,36.2,114284,11796,102488,47029,2.54925454687,0.0451490423626
"St. Clair County, Illinois",2012,268873,37.1,116435,13499,102936,50490,2.61204049118,0.0502058592718
"St. Clair County, Illinois",2015,267029,37.7,117949,15682,102267,49895,2.61109644362,0.0587277037326
"St. Clair County, Michigan",2009,169260,39.3,72922,7245,65677,50648,2.57715790916,0.0428039702233
"St. Clair County, Michigan",2012,162978,41.3,71851,7768,64083,47877,2.54323299471,0.0476628747438
"St. Clair County, Michigan",2015,160429,42.8,71889,7746,64143,49730,2.50111469685,0.0482830410961
"St. Clair County, Missouri",2009,9379,46.9,5447,1308,4139,33041,2.26600628171,0.139460496855
"St. Clair County, Missouri",2012,9693,48.6,5632,1267,4365,32075,2.2206185567,0.130712885588
"St. Clair County, Missouri",2015,9520,49.7,5599,1584,4015,32046,2.37110834371,0.166386554622
"St. Croix County, Wisconsin",2009,80550,36,32896,1569,31327,67748,2.57126440451,0.01947858473
"St. Croix County, Wisconsin",2012,84363,36.8,33969,1943,32026,68139,2.63420345969,0.0230314237284
"St. Croix County, Wisconsin",2015,86118,37.6,34468,2009,32459,70886,2.653131643,0.0233284563041
"St. Francis County, Arkansas",2009,26769,36,11714,1985,9729,27016,2.75146469319,0.0741529381
"St. Francis County, Arkansas",2012,28089,36.9,10931,1754,9177,30104,3.06080418437,0.0624443732422
"St. Francis County, Arkansas",2015,27345,37.5,10915,1485,9430,32105,2.89978791092,0.0543060888645
"St. Francois County, Missouri",2009,62734,37.3,26385,3570,22815,38086,2.74968222661,0.0569069404151
"St. Francois County, Missouri",2012,65246,38.7,28478,3863,24615,36716,2.65066016657,0.0592066946633
"St. Francois County, Missouri",2015,66010,38.9,29187,4251,24936,39741,2.64717677254,0.0643993334343
"St. Helena Parish, Louisiana",2009,10505,38.2,5474,1202,4272,29124,2.45903558052,0.11442170395
"St. Helena Parish, Louisiana",2012,11106,39.2,5168,966,4202,32460,2.64302712994,0.086980010805
"St. Helena Parish, Louisiana",2015,10818,39.2,5163,1032,4131,35437,2.61873638344,0.0953965612867
"St. James Parish, Louisiana",2009,21056,37.7,8299,730,7569,49883,2.7818734311,0.0346694528875
"St. James Parish, Louisiana",2012,21978,38.6,8492,791,7701,53728,2.85391507596,0.0359905359905
"St. James Parish, Louisiana",2015,21650,38.8,8650,686,7964,51107,2.71848317428,0.0316859122402
"St. John the Baptist Parish, Louisiana",2009,47146,34,17388,1601,15787,47574,2.98638119972,0.0339583421711
"St. John the Baptist Parish, Louisiana",2012,45741,35.3,17503,1793,15710,51040,2.91158497772,0.039198968103
"St. John the Baptist Parish, Louisiana",2015,44161,36,17584,2252,15332,50921,2.88031567962,0.0509952220285
"St. Johns County, Florida",2009,174994,41.4,82032,15016,67016,63630,2.61122716963,0.0858086562968
"St. Johns County, Florida",2012,191495,42.2,89990,15969,74021,64346,2.58703611137,0.0833912112588
"St. Johns County, Florida",2015,210495,42.7,94826,15584,79242,66194,2.65635647763,0.0740350127081
"St. Joseph County, Indiana",2009,266400,35.2,113762,12525,101237,44579,2.63144897616,0.0470157657658
"St. Joseph County, Indiana",2012,266785,36.1,114803,13602,101201,44989,2.63618936572,0.0509848754615
"St. Joseph County, Indiana",2015,267246,36.5,115351,13346,102005,45471,2.61993039557,0.0499390075062
"St. Joseph County, Michigan",2009,62219,37.4,27619,5053,22566,43667,2.757201099,0.0812131342516
"St. Joseph County, Michigan",2012,61314,38.6,27741,5483,22258,44214,2.75469494114,0.0894249274228
"St. Joseph County, Michigan",2015,61022,39.2,27682,4412,23270,44449,2.62234636872,0.072301792796
"St. Landry Parish, Louisiana",2009,90983,35.7,38656,6289,32367,28110,2.81098031946,0.069122803161
"St. Landry Parish, Louisiana",2012,83774,36.9,35892,5167,30725,36183,2.72657445077,0.0616778475422
"St. Landry Parish, Louisiana",2015,83613,36.6,36047,5364,30683,32625,2.72505947919,0.064152703527
"St. Lawrence County, New York",2009,109742,36.8,50836,10017,40819,41670,2.68850290306,0.0912777241166
"St. Lawrence County, New York",2012,112060,37.2,52077,10001,42076,43745,2.6632759768,0.0892468320543
"St. Lawrence County, New York",2015,112011,37.8,52203,10754,41449,44705,2.7023812396,0.0960084277437
"St. Louis County, Minnesota",2009,196820,40.6,99932,15053,84879,44125,2.31883033495,0.0764810486739
"St. Louis County, Minnesota",2012,200150,40.8,102881,17403,85478,46231,2.34153817357,0.0869497876593
"St. Louis County, Minnesota",2015,200506,40.9,103195,18650,84545,48331,2.37158909457,0.0930146728776
"St. Louis County, Missouri",2009,994923,39.2,434789,31090,403699,57502,2.46451688015,0.031248649393
"St. Louis County, Missouri",2012,999147,39.8,437803,33652,404151,58485,2.47221211874,0.0336807296624
"St. Louis County, Missouri",2015,1001327,40.2,438076,36237,401839,59755,2.49186116828,0.0361889772272
"St. Louis city, Missouri",2009,355078,34.5,180490,37445,143045,34227,2.48228179943,0.105455702691
"St. Louis city, Missouri",2012,318527,34,175855,36015,139840,34384,2.27779605263,0.113067338091
"St. Louis city, Missouri",2015,317850,34.6,175591,36036,139555,35599,2.27759664648,0.113374233129
"St. Lucie County, Florida",2009,255984,41.9,127648,28795,98853,46656,2.58954204728,0.112487499219
"St. Lucie County, Florida",2012,278246,42.5,136690,32220,104470,43923,2.66340576242,0.115796812892
"St. Lucie County, Florida",2015,288006,43.9,137203,29305,107898,43459,2.66924317411,0.101751352402
"St. Martin Parish, Louisiana",2009,51429,34.9,22083,2654,19429,39186,2.64702249215,0.0516051255128
"St. Martin Parish, Louisiana",2012,52343,36,21993,3232,18761,41137,2.78998987261,0.0617465563686
"St. Martin Parish, Louisiana",2015,53126,36.7,22390,3335,19055,42794,2.78803463658,0.0627752889357
"St. Mary Parish, Louisiana",2009,51085,36.3,22653,2886,19767,38269,2.584357768,0.0564940784966
"St. Mary Parish, Louisiana",2012,54285,37.4,22991,2827,20164,40738,2.69217417179,0.0520770010132
"St. Mary Parish, Louisiana",2015,53441,37.7,23162,2842,20320,40781,2.62997047244,0.0531801425872
"St. Mary's County, Maryland",2009,100140,35.1,40776,4108,36668,75427,2.73099160031,0.0410225684042
"St. Mary's County, Maryland",2012,105528,36,41444,4092,37352,85032,2.82523024202,0.0387764384808
"St. Mary's County, Maryland",2015,109614,36.3,42762,4519,38243,86987,2.86625003269,0.0412264856679
"St. Tammany Parish, Louisiana",2009,225533,38.1,93869,9844,84025,59804,2.68411782208,0.0436477145251
"St. Tammany Parish, Louisiana",2012,234283,39.4,95632,7736,87896,60813,2.66545690361,0.0330198947427
"St. Tammany Parish, Louisiana",2015,242960,39.8,97891,8855,89036,62137,2.72878386271,0.0364463286138
"Stafford County, Kansas",2009,4380,45.2,2467,528,1939,37093,2.25889633832,0.120547945205
"Stafford County, Kansas",2012,4398,45.7,2323,430,1893,43232,2.32329635499,0.0977717144156
"Stafford County, Kansas",2015,4320,43.7,2303,509,1794,47377,2.40802675585,0.117824074074
"Stafford County, Virginia",2009,120436,33.9,42255,2678,39577,90586,3.0430805771,0.0222358763161
"Stafford County, Virginia",2012,129446,34.5,44124,2920,41204,96355,3.14158819532,0.0225576688349
"Stafford County, Virginia",2015,137145,34.7,45759,2354,43405,97144,3.15965902546,0.0171643151409
"Stanislaus County, California",2009,505165,32.2,172450,12523,159927,51529,3.1587224171,0.0247899201251
"Stanislaus County, California",2012,515115,32.8,179176,13177,165999,49866,3.10312110314,0.0255806955728
"Stanislaus County, California",2015,527367,33.5,180169,10973,169196,50125,3.11689992671,0.0208071418955
"Stanley County, South Dakota",2009,2775,43.6,1309,123,1186,51089,2.33979763912,0.0443243243243
"Stanley County, South Dakota",2012,2940,43.5,1423,155,1268,56553,2.31861198738,0.0527210884354
"Stanley County, South Dakota",2015,2962,40.1,1455,187,1268,56829,2.33596214511,0.0631330182309
"Stanly County, North Carolina",2009,59136,39.2,27162,4445,22717,43491,2.6031606286,0.075165719697
"Stanly County, North Carolina",2012,60489,40.5,27118,3964,23154,43256,2.61246436901,0.0655325761709
"Stanly County, North Carolina",2015,60586,41.8,27216,3549,23667,40910,2.55993577555,0.0585778892814
"Stanton County, Kansas",2009,2152,40.6,899,190,709,46875,3.03526093089,0.0882899628253
"Stanton County, Kansas",2012,2200,35.5,924,167,757,51823,2.90620871863,0.0759090909091
"Stanton County, Kansas",2015,2149,35.7,1014,194,820,43780,2.62073170732,0.0902745463006
"Stanton County, Nebraska",2009,6360,38,2527,199,2328,45613,2.73195876289,0.0312893081761
"Stanton County, Nebraska",2012,6139,39,2625,233,2392,50962,2.56647157191,0.0379540641798
"Stanton County, Nebraska",2015,6081,38.8,2637,314,2323,53416,2.61773568661,0.0516362440388
"Stark County, Illinois",2009,6076,42.6,2823,306,2517,47795,2.41398490266,0.050362080316
"Stark County, Illinois",2012,5983,44,2684,246,2438,51392,2.4540607055,0.0411164967408
"Stark County, Illinois",2015,5859,45.9,2662,271,2391,50085,2.4504391468,0.0462536268988
"Stark County, North Dakota",2009,22393,37.6,10235,768,9467,46422,2.36537445865,0.0342964319207
"Stark County, North Dakota",2012,24682,38,10878,791,10087,58793,2.44691186676,0.0320476460579
"Stark County, North Dakota",2015,28628,35,12741,1362,11379,72099,2.51586255383,0.0475757999162
"Stark County, Ohio",2009,379468,40.3,164397,13835,150562,44999,2.52034377864,0.036458937249
"Stark County, Ohio",2012,375593,41.2,165126,14827,150299,45689,2.49897204905,0.03947624157
"Stark County, Ohio",2015,374979,41.8,165462,15077,150385,47137,2.49346011903,0.0402075849581
"Starke County, Indiana",2009,23398,40,10861,1806,9055,38729,2.58398674765,0.0771860842807
"Starke County, Indiana",2012,23310,40.5,10956,1916,9040,39909,2.57853982301,0.0821964821965
"Starke County, Indiana",2015,23117,41.6,10985,2196,8789,42208,2.63021959267,0.0949950253061
"Starr County, Texas",2009,60936,26,18342,3473,14869,21512,4.0981908669,0.0569942234476
"Starr County, Texas",2012,60882,29,19485,3814,15671,24653,3.885010529,0.0626457737919
"Starr County, Texas",2015,62648,29.1,19590,3445,16145,26172,3.88033446888,0.054989784191
"Staunton city, Virginia",2009,23645,42.3,11189,1280,9909,42713,2.38621455243,0.0541340663988
"Staunton city, Virginia",2012,23906,42.6,11704,1091,10613,42918,2.25252049373,0.0456370785577
"Staunton city, Virginia",2015,24193,42.3,11782,1395,10387,40842,2.32916145181,0.0576613069896
"Ste. Genevieve County, Missouri",2009,17758,42.6,8304,1304,7000,49712,2.53685714286,0.0734316927582
"Ste. Genevieve County, Missouri",2012,18066,42.6,8610,1295,7315,47809,2.46971975393,0.0716816118676
"Ste. Genevieve County, Missouri",2015,17990,42.5,8621,1484,7137,47014,2.5206669469,0.0824902723735
"Stearns County, Minnesota",2009,146168,33.3,59224,4371,54853,51559,2.66472207537,0.0299039461442
"Stearns County, Minnesota",2012,150307,33.4,61857,5390,56467,53861,2.66185559707,0.0358599399895
"Stearns County, Minnesota",2015,152595,34,62632,5367,57265,56336,2.66471666812,0.035171532488
"Steele County, Minnesota",2009,36273,37.2,14885,1117,13768,55810,2.63458744916,0.0307942546798
"Steele County, Minnesota",2012,36524,38.8,15329,1139,14190,58403,2.57392529951,0.0311849742635
"Steele County, Minnesota",2015,36523,39.8,15395,1124,14271,57858,2.5592460234,0.0307751280015
"Steele County, North Dakota",2009,1929,43.9,1206,351,855,45037,2.25614035088,0.181959564541
"Steele County, North Dakota",2012,1976,47.8,1164,282,882,50536,2.24036281179,0.142712550607
"Steele County, North Dakota",2015,1979,50.2,1248,300,948,55833,2.08755274262,0.151591712986
"Stephens County, Georgia",2009,25343,38.9,12465,3218,9247,34309,2.74067265059,0.12697786371
"Stephens County, Georgia",2012,26003,40.5,12615,3269,9346,37535,2.78225979028,0.125716263508
"Stephens County, Georgia",2015,25620,41.2,12541,3343,9198,40315,2.78538812785,0.130483996877
"Stephens County, Oklahoma",2009,43056,41.1,20362,2910,17452,42563,2.46710978684,0.0675863991081
"Stephens County, Oklahoma",2012,44848,40.1,20651,2911,17740,44918,2.52807215333,0.064908134142
"Stephens County, Oklahoma",2015,44806,40.1,20682,2814,17868,43781,2.50761137229,0.0628040887381
"Stephens County, Texas",2009,9474,40,4980,1322,3658,34663,2.58993985785,0.139539793118
"Stephens County, Texas",2012,9561,40.5,4943,1391,3552,38424,2.69172297297,0.145486873758
"Stephens County, Texas",2015,9452,39.3,4925,1478,3447,43951,2.74209457499,0.156369022429
"Stephenson County, Illinois",2009,46821,42.3,22214,2649,19565,43561,2.39309992333,0.0565771769078
"Stephenson County, Illinois",2012,47532,43.7,22076,2443,19633,44572,2.42102582387,0.0513969536312
"Stephenson County, Illinois",2015,46625,44.3,21957,2658,19299,45331,2.41592828644,0.0570080428954
"Sterling County, Texas",2009,1114,42.1,660,211,449,38750,2.48106904232,0.189407540395
"Sterling County, Texas",2012,1223,43.5,632,168,464,44239,2.63577586207,0.137367130008
"Sterling County, Texas",2015,1346,36,597,146,451,53456,2.9844789357,0.108469539376
"Steuben County, Indiana",2009,33544,38.1,19246,4970,14276,46818,2.34967778089,0.14816360601
"Steuben County, Indiana",2012,34116,40,19379,5711,13668,48291,2.49604916594,0.167399460664
"Steuben County, Indiana",2015,34267,41.7,19474,5989,13485,48472,2.5411197627,0.17477456445
"Steuben County, New York",2009,96674,40.8,47072,7675,39397,42812,2.45384166307,0.0793905289944
"Steuben County, New York",2012,98992,41.3,48788,7520,41268,46519,2.39875932926,0.0759657346048
"Steuben County, New York",2015,98665,42,48849,7791,41058,47280,2.4030639583,0.0789641716921
"Stevens County, Kansas",2009,5145,34,2028,163,1865,49966,2.75871313673,0.0316812439261
"Stevens County, Kansas",2012,5633,34.8,2300,316,1984,56991,2.83921370968,0.0560979939641
"Stevens County, Kansas",2015,5772,34.9,2294,287,2007,55433,2.87593423019,0.0497227997228
"Stevens County, Minnesota",2009,9635,33.6,4194,417,3777,45049,2.55096637543,0.0432797093928
"Stevens County, Minnesota",2012,9712,34.3,4165,474,3691,52819,2.63126523977,0.048805601318
"Stevens County, Minnesota",2015,9771,32.7,4156,488,3668,52302,2.66384950927,0.0499437109815
"Stevens County, Washington",2009,41733,43.6,18714,2994,15720,41859,2.65477099237,0.071741787075
"Stevens County, Washington",2012,43498,45.1,21005,3371,17634,42746,2.46671203357,0.0774978159915
"Stevens County, Washington",2015,43548,46.2,21159,3480,17679,41978,2.46326149669,0.0799118214384
"Stewart County, Georgia",2009,4638,39.1,2067,482,1585,33772,2.9261829653,0.103924105218
"Stewart County, Georgia",2012,5991,41.6,2378,437,1941,28222,3.08655332303,0.0729427474545
"Stewart County, Georgia",2015,5868,38,2342,611,1731,21118,3.38994800693,0.104124062713
"Stewart County, Tennessee",2009,13078,41.2,6350,1364,4986,37377,2.62294424388,0.104297293164
"Stewart County, Tennessee",2012,13262,42.8,6759,1507,5252,40200,2.52513328256,0.113632936209
"Stewart County, Tennessee",2015,13286,43.2,6763,1632,5131,42023,2.58935879945,0.122836068042
"Stillwater County, Montana",2009,8573,44.6,4027,773,3254,55401,2.63460356484,0.0901668027528
"Stillwater County, Montana",2012,9096,46,4768,1010,3758,53533,2.42043640234,0.111037818821
"Stillwater County, Montana",2015,9288,46.7,4817,1075,3742,58259,2.48209513629,0.115740740741
"Stoddard County, Missouri",2009,29524,40.3,13794,1586,12208,33684,2.41841415465,0.0537190082645
"Stoddard County, Missouri",2012,29902,41.4,13592,1477,12115,37303,2.46817994222,0.0493946893184
"Stoddard County, Missouri",2015,29837,42,13602,1557,12045,38203,2.47712743877,0.0521835305158
"Stokes County, North Carolina",2009,45916,41.2,20600,2500,18100,39975,2.53679558011,0.0544472515027
"Stokes County, North Carolina",2012,47224,42.5,21816,2490,19326,42476,2.44354755252,0.0527274267322
"Stokes County, North Carolina",2015,46661,44.7,21836,2868,18968,40696,2.4599852383,0.0614646064165
"Stone County, Arkansas",2009,11920,46.6,6063,1485,4578,27167,2.60375709917,0.124580536913
"Stone County, Arkansas",2012,12480,46.9,6678,1402,5276,32834,2.36542835481,0.11233974359
"Stone County, Arkansas",2015,12512,48.5,6737,1595,5142,29264,2.43329443796,0.127477621483
"Stone County, Mississippi",2009,15734,35.4,5878,605,5273,43524,2.98388014413,0.0384517605186
"Stone County, Mississippi",2012,17657,35.5,7087,1214,5873,42862,3.00647028776,0.0687546015744
"Stone County, Mississippi",2015,17978,36.8,7216,1452,5764,45025,3.11901457321,0.0807653799088
"Stone County, Missouri",2009,31186,47,18026,5815,12211,40830,2.55392678732,0.186461873918
"Stone County, Missouri",2012,31968,49.7,20258,7042,13216,42084,2.41888619855,0.220282782783
"Stone County, Missouri",2015,31375,51.3,20522,7686,12836,40510,2.44429728888,0.244972111554
"Stonewall County, Texas",2009,1381,45,922,344,578,46121,2.3892733564,0.249094858798
"Stonewall County, Texas",2012,1447,45.8,895,280,615,52917,2.35284552846,0.193503800968
"Stonewall County, Texas",2015,1414,49,917,337,580,42155,2.43793103448,0.238330975955
"Storey County, Nevada",2009,4265,45.4,2107,127,1980,60925,2.15404040404,0.0297772567409
"Storey County, Nevada",2012,4010,52.8,2007,168,1839,62561,2.18053289831,0.0418952618454
"Storey County, Nevada",2015,3929,54.7,1982,215,1767,64832,2.22354272779,0.0547213031306
"Story County, Iowa",2009,84780,24.7,34191,2138,32053,45594,2.64499422831,0.0252182118424
"Story County, Iowa",2012,89734,26.5,36741,1858,34883,49683,2.57242783018,0.0207056411171
"Story County, Iowa",2015,93586,25.9,37688,1787,35901,50438,2.60677975544,0.0190947363922
"Strafford County, New Hampshire",2009,121656,35.8,50149,4176,45973,58363,2.64624888522,0.0343262971
"Strafford County, New Hampshire",2012,123295,36.7,51678,4857,46821,58538,2.63332692595,0.0393933249524
"Strafford County, New Hampshire",2015,125273,37.2,52237,5088,47149,60711,2.65695985069,0.0406152961931
"Stutsman County, North Dakota",2009,20550,41.9,9967,1207,8760,42480,2.34589041096,0.0587347931873
"Stutsman County, North Dakota",2012,20965,41.9,9897,1245,8652,48678,2.42313915858,0.059384688767
"Stutsman County, North Dakota",2015,21076,40.6,10030,969,9061,52359,2.32601258139,0.0459764661226
"Sublette County, Wyoming",2009,7801,40.1,4337,1773,2564,74224,3.04251170047,0.227278554032
"Sublette County, Wyoming",2012,10065,38.2,5685,2163,3522,79776,2.85775127768,0.214903129657
"Sublette County, Wyoming",2015,10117,38.1,5843,2220,3623,81772,2.79243720673,0.219432638134
"Suffolk County, Massachusetts",2009,730630,32.5,300817,26294,274523,51896,2.66145277445,0.0359881198418
"Suffolk County, Massachusetts",2012,724502,31.6,314385,26943,287442,52700,2.52051544312,0.0371883031379
"Suffolk County, Massachusetts",2015,758919,32.2,321386,24714,296672,55044,2.55810794413,0.0325647401106
"Suffolk County, New York",2009,1511028,39,543628,64770,478858,84530,3.15548241859,0.0428648575672
"Suffolk County, New York",2012,1492360,39.8,568570,72221,496349,87778,3.00667473894,0.0483938191857
"Suffolk County, New York",2015,1501373,40.6,570194,76345,493849,88663,3.04014587455,0.0508501218551
"Suffolk city, Virginia",2009,81062,36.7,32049,2056,29993,63657,2.70269729604,0.0253633021638
"Suffolk city, Virginia",2012,84216,38.2,33080,2578,30502,66479,2.76099927874,0.0306117602356
"Suffolk city, Virginia",2015,86184,38.3,34368,3378,30990,65499,2.78102613746,0.0391952102478
"Sullivan County, Indiana",2009,21316,37.8,9185,901,8284,41292,2.57315306615,0.0422687183336
"Sullivan County, Indiana",2012,21379,39.4,8945,1067,7878,45330,2.71375983752,0.0499087889985
"Sullivan County, Indiana",2015,21111,40.8,8874,1235,7639,45023,2.76358162063,0.0585003078964
"Sullivan County, Missouri",2009,6842,39.7,3468,757,2711,30613,2.52379195869,0.110640163695
"Sullivan County, Missouri",2012,6667,40.2,3363,735,2628,34247,2.53691019787,0.110244487776
"Sullivan County, Missouri",2015,6512,40.9,3343,831,2512,40197,2.5923566879,0.127610565111
"Sullivan County, New Hampshire",2009,42641,42.4,21515,3676,17839,50016,2.39032456976,0.0862081095659
"Sullivan County, New Hampshire",2012,43534,44.2,22288,4239,18049,53821,2.41198958391,0.0973721688795
"Sullivan County, New Hampshire",2015,43135,45.1,22342,4922,17420,56032,2.47617680827,0.114106873768
"Sullivan County, New York",2009,75924,41,48369,18980,29389,48586,2.58341556365,0.249986828934
"Sullivan County, New York",2012,77340,41.8,49179,19515,29664,48050,2.60720064725,0.25232738557
"Sullivan County, New York",2015,76330,42.2,49548,21144,28404,50710,2.68729756372,0.277007729595
"Sullivan County, Pennsylvania",2009,6219,48,6268,3768,2500,37621,2.4876,0.605885190545
"Sullivan County, Pennsylvania",2012,6453,49.7,6300,3924,2376,38981,2.71590909091,0.608089260809
"Sullivan County, Pennsylvania",2015,6381,51.8,6311,3642,2669,44189,2.39078306482,0.57075693465
"Sullivan County, Tennessee",2009,153314,42.2,73660,6376,67284,39106,2.27861007074,0.0415878523814
"Sullivan County, Tennessee",2012,156675,43.5,73753,7158,66595,40025,2.35265410316,0.0456869315462
"Sullivan County, Tennessee",2015,156752,44.3,74004,7583,66421,40346,2.35997651345,0.0483757782995
"Sully County, South Dakota",2009,1363,44.4,903,256,647,48098,2.10664605873,0.187820983125
"Sully County, South Dakota",2012,1382,47.2,773,197,576,51563,2.39930555556,0.142547033285
"Sully County, South Dakota",2015,1469,44.6,802,180,622,60417,2.36173633441,0.122532334922
"Summers County, West Virginia",2009,13217,43.5,7518,2317,5201,26859,2.54124206883,0.175304532042
"Summers County, West Virginia",2012,13813,46.2,7669,2399,5270,33066,2.6210626186,0.173676970969
"Summers County, West Virginia",2015,13544,46.3,7678,2094,5584,36651,2.42550143266,0.154607206143
"Summit County, Colorado",2009,26246,33,28217,18359,9858,67329,2.66240616758,0.69949706622
"Summit County, Colorado",2012,27753,36.3,29781,18423,11358,64680,2.44347596408,0.663820127554
"Summit County, Colorado",2015,28940,37.1,30238,20095,10143,67983,2.85319925071,0.694367657222
"Summit County, Ohio",2009,544221,39.1,242563,20798,221765,47776,2.4540436949,0.0382160923595
"Summit County, Ohio",2012,541788,40.2,244929,23633,221296,49227,2.44825030728,0.0436203828804
"Summit County, Ohio",2015,541847,40.7,245237,24335,220902,50765,2.45288408435,0.0449112018706
"Summit County, Utah",2009,35644,35.7,22058,9308,12750,83380,2.79560784314,0.261137919425
"Summit County, Utah",2012,36598,36.7,26392,13088,13304,86515,2.75090198437,0.357615170228
"Summit County, Utah",2015,38521,38.2,27083,13156,13927,91773,2.76592230918,0.341527997716
"Sumner County, Kansas",2009,23871,39.5,11193,1659,9534,48848,2.50377595972,0.0694985547317
"Sumner County, Kansas",2012,24000,39.9,10865,1607,9258,48105,2.59235255995,0.0669583333333
"Sumner County, Kansas",2015,23638,40.8,10855,1764,9091,50141,2.60015399846,0.0746256028429
"Sumner County, Tennessee",2009,151874,37.8,61661,3947,57714,54708,2.63149322521,0.0259886484849
"Sumner County, Tennessee",2012,161206,38.7,65877,5348,60529,55560,2.66328536734,0.0331749438607
"Sumner County, Tennessee",2015,169623,39.4,67504,5079,62425,57382,2.71722867441,0.0299428733132
"Sumter County, Alabama",2009,13267,35.6,7181,1847,5334,20994,2.48725159355,0.139217607598
"Sumter County, Alabama",2012,13669,37.1,6796,1830,4966,22655,2.75251711639,0.133879581535
"Sumter County, Alabama",2015,13341,36.7,6752,1937,4815,19501,2.7707165109,0.145191514879
"Sumter County, Florida",2009,71519,50.4,39767,8108,31659,41010,2.25904166272,0.11336847551
"Sumter County, Florida",2012,94240,63,53387,11573,41814,46981,2.25379059645,0.122803480475
"Sumter County, Florida",2015,108501,65.3,61171,13132,48039,50350,2.25860238556,0.12103114257
"Sumter County, Georgia",2009,32363,33.4,14287,2315,11972,32245,2.70322418978,0.0715323054105
"Sumter County, Georgia",2012,32425,34.2,13912,2362,11550,33528,2.80735930736,0.0728450269854
"Sumter County, Georgia",2015,31429,34.6,13857,2454,11403,32758,2.75620450759,0.0780807534443
"Sumter County, South Carolina",2009,104441,34.9,45336,6139,39197,37752,2.66451514146,0.0587795980506
"Sumter County, South Carolina",2012,107279,35.6,46079,6732,39347,40726,2.72648486543,0.0627522627914
"Sumter County, South Carolina",2015,107777,35.8,46698,6127,40571,41332,2.65650341377,0.0568488638578
"Sunflower County, Mississippi",2009,30604,32.1,10751,1252,9499,24333,3.2218128224,0.0409096850085
"Sunflower County, Mississippi",2012,29230,33.4,9749,1380,8369,26611,3.49265145179,0.0472117687308
"Sunflower County, Mississippi",2015,27911,34.1,9702,1194,8508,27384,3.28055947344,0.0427788327183
"Surry County, North Carolina",2009,72166,40.5,32579,3898,28681,36511,2.51616052439,0.0540143557908
"Surry County, North Carolina",2012,73551,41.1,33595,3679,29916,36137,2.4585840353,0.0500197142119
"Surry County, North Carolina",2015,73170,42.7,33565,4298,29267,36164,2.50008542044,0.0587399207325
"Surry County, Virginia",2009,7026,43,3750,1118,2632,53320,2.66945288754,0.159123256476
"Surry County, Virginia",2012,6988,45.3,3466,894,2572,52955,2.71695178849,0.127933600458
"Surry County, Virginia",2015,6823,47.5,3497,829,2668,53673,2.55734632684,0.121500806097
"Susquehanna County, Pennsylvania",2009,41116,43.5,22647,5321,17326,41624,2.37308091885,0.129414339916
"Susquehanna County, Pennsylvania",2012,43171,45.1,22939,5800,17139,46815,2.51887508023,0.134349447546
"Susquehanna County, Pennsylvania",2015,42369,46.4,22997,5510,17487,50477,2.42288557214,0.130047912389
"Sussex County, Delaware",2009,184726,44.4,114106,40823,73283,50537,2.52072104035,0.22099217219
"Sussex County, Delaware",2012,197681,45.4,123132,47490,75642,52692,2.61337616668,0.240235530982
"Sussex County, Delaware",2015,207302,47,127680,46497,81183,53751,2.55351489844,0.224295954694
"Sussex County, New Jersey",2009,151239,40.3,60347,5268,55079,81488,2.74585595236,0.0348322853232
"Sussex County, New Jersey",2012,148962,41.8,62060,6881,55179,85507,2.69961398358,0.0461929888159
"Sussex County, New Jersey",2015,145930,43.4,62184,8243,53941,86565,2.70536326727,0.0564859864319
"Sussex County, Virginia",2009,12051,38.9,4862,829,4033,37492,2.98809818993,0.0687909717036
"Sussex County, Virginia",2012,12095,40.5,4701,1062,3639,39603,3.3237153064,0.0878048780488
"Sussex County, Virginia",2015,11864,38.5,4007,858,3149,39194,3.76754525246,0.0723196223871
"Sutter County, California",2009,90731,34.2,32984,2237,30747,52155,2.95088951768,0.0246552997322
"Sutter County, California",2012,94615,34.5,33835,2200,31635,50510,2.9908329382,0.0232521270412
"Sutter County, California",2015,95247,35.4,34065,2148,31917,52017,2.9842090422,0.0225518913982
"Sutton County, Texas",2009,4270,37.3,2139,630,1509,54557,2.82968853545,0.147540983607
"Sutton County, Texas",2012,4123,35.3,2007,679,1328,62321,3.1046686747,0.164685908319
"Sutton County, Texas",2015,3966,35.1,2027,547,1480,51667,2.67972972973,0.137922339889
"Suwannee County, Florida",2009,39256,41.6,16849,3318,13531,34157,2.90118986032,0.0845221112696
"Suwannee County, Florida",2012,42287,42.2,19025,3145,15880,36159,2.6629093199,0.0743727386667
"Suwannee County, Florida",2015,43595,41.6,18927,3278,15649,36289,2.78580100965,0.0751921091868
"Swain County, North Carolina",2009,13367,40.5,8107,2499,5608,33272,2.38355920114,0.186952943817
"Swain County, North Carolina",2012,13995,40.9,8699,3223,5476,43426,2.55569758948,0.230296534477
"Swain County, North Carolina",2015,14163,40.7,8769,3390,5379,33931,2.63301728946,0.23935606863
"Sweet Grass County, Montana",2009,3675,47,1946,659,1287,43016,2.85547785548,0.179319727891
"Sweet Grass County, Montana",2012,3661,43.1,2052,785,1267,44179,2.88950276243,0.214422288992
"Sweet Grass County, Montana",2015,3633,46.1,1995,585,1410,50588,2.57659574468,0.161023947151
"Sweetwater County, Wyoming",2009,39140,33.5,16886,1391,15495,67210,2.52597612133,0.0355390904446
"Sweetwater County, Wyoming",2012,43890,32.9,18624,2089,16535,72139,2.6543695192,0.0475962633857
"Sweetwater County, Wyoming",2015,44772,33.6,19042,2363,16679,69022,2.68433359314,0.0527785222907
"Swift County, Minnesota",2009,10890,42.5,4937,409,4528,40677,2.40503533569,0.0375573921028
"Swift County, Minnesota",2012,9764,44.4,4792,484,4308,45984,2.26648096565,0.0495698484228
"Swift County, Minnesota",2015,9525,44.5,4815,584,4231,49035,2.25124084141,0.061312335958
"Swisher County, Texas",2009,7609,35.2,3343,636,2707,35060,2.81086073144,0.0835852280195
"Swisher County, Texas",2012,7816,36.4,3230,608,2622,40227,2.98093058734,0.0777891504606
"Swisher County, Texas",2015,7713,36.1,3217,623,2594,37040,2.9734001542,0.0807727213795
"Switzerland County, Indiana",2009,9627,39.3,5162,1055,4107,44246,2.34404674945,0.109587618157
"Switzerland County, Indiana",2012,10509,40.6,4989,973,4016,44833,2.61678286853,0.0925873061186
"Switzerland County, Indiana",2015,10500,40.1,5054,983,4071,44061,2.57921886514,0.093619047619
"Talbot County, Georgia",2009,6496,40.3,3108,606,2502,30523,2.59632294165,0.0932881773399
"Talbot County, Georgia",2012,6772,45.3,3375,695,2680,26750,2.52686567164,0.102628470171
"Talbot County, Georgia",2015,6490,47.5,3376,711,2665,34078,2.43527204503,0.109553158706
"Talbot County, Maryland",2009,36034,46.5,19643,3430,16213,61591,2.22253746993,0.0951878781151
"Talbot County, Maryland",2012,37746,47.3,19618,3762,15856,62942,2.38054994955,0.0996661897949
"Talbot County, Maryland",2015,37799,49,20027,3796,16231,58228,2.32881523012,0.100425937194
"Taliaferro County, Georgia",2009,1863,41,1062,338,724,21116,2.57320441989,0.181427804616
"Taliaferro County, Georgia",2012,1674,43.4,1032,362,670,24390,2.49850746269,0.216248506571
"Taliaferro County, Georgia",2015,1721,47.9,1073,366,707,26306,2.4342291372,0.212667054038
"Talladega County, Alabama",2009,80190,38,36310,5595,30715,35865,2.61077649357,0.069771791994
"Talladega County, Alabama",2012,82194,39.4,37037,5482,31555,35209,2.60478529552,0.0666958658783
"Talladega County, Alabama",2015,81437,40.9,37157,5733,31424,35155,2.59155422607,0.0703979763498
"Tallahatchie County, Mississippi",2009,13201,35.7,6025,954,5071,23557,2.60323407612,0.0722672524809
"Tallahatchie County, Mississippi",2012,15262,35.4,5554,917,4637,27689,3.29135216735,0.0600838684314
"Tallahatchie County, Mississippi",2015,14959,36,5530,1144,4386,29731,3.410624715,0.0764757002473
"Tallapoosa County, Alabama",2009,40778,41.3,21259,5276,15983,36637,2.55133579428,0.129383491098
"Tallapoosa County, Alabama",2012,41534,41.8,22046,5707,16339,38611,2.54201603525,0.137405499109
"Tallapoosa County, Alabama",2015,41153,42.8,22078,5755,16323,39206,2.52116645225,0.139843996792
"Tama County, Iowa",2009,17659,40.9,7824,611,7213,45691,2.44821849439,0.0345999207203
"Tama County, Iowa",2012,17746,42.1,7769,839,6930,49244,2.56075036075,0.0472782598896
"Tama County, Iowa",2015,17479,43,7745,955,6790,55203,2.57422680412,0.054636992963
"Taney County, Missouri",2009,45732,39.9,24528,4905,19623,40103,2.33053049992,0.107255313566
"Taney County, Missouri",2012,51596,41.1,28982,8556,20426,40112,2.52599627925,0.16582680828
"Taney County, Missouri",2015,53555,41.5,29986,8686,21300,38357,2.51431924883,0.162188404444
"Tangipahoa Parish, Louisiana",2009,114229,32.6,48738,6068,42670,38067,2.67703304429,0.0531213614756
"Tangipahoa Parish, Louisiana",2012,121209,33.5,50205,5919,44286,40491,2.73695976155,0.0488330074499
"Tangipahoa Parish, Louisiana",2015,125486,34.4,51938,6455,45483,41302,2.75896488798,0.051440001275
"Taos County, New Mexico",2009,31444,43.8,17729,5751,11978,35800,2.62514610119,0.182896578044
"Taos County, New Mexico",2012,32775,45.4,20116,6743,13373,33835,2.45083376954,0.205736079329
"Taos County, New Mexico",2015,32943,46.8,20316,7092,13224,36582,2.49115245009,0.215280939805
"Tarrant County, Texas",2009,1704943,32.8,669015,63307,605708,54647,2.81479359691,0.0371314466231
"Tarrant County, Texas",2012,1814667,33.4,714057,62180,651877,56859,2.78375675166,0.0342652398484
"Tarrant County, Texas",2015,1914526,34,732985,59248,673737,58711,2.84165186119,0.0309465632747
"Tate County, Mississippi",2009,26888,35.5,10816,827,9989,38194,2.69176093703,0.0307572151145
"Tate County, Mississippi",2012,28580,36.2,10956,953,10003,43277,2.85714285714,0.033344996501
"Tate County, Mississippi",2015,28415,36.7,11100,1096,10004,42880,2.84036385446,0.0385711771951
"Tattnall County, Georgia",2009,23310,33.6,8899,1693,7206,36028,3.23480432973,0.0726297726298
"Tattnall County, Georgia",2012,25023,36.2,9902,1874,8028,36520,3.11696562033,0.0748911001878
"Tattnall County, Georgia",2015,25302,36.2,9888,2008,7880,33980,3.21091370558,0.079361315311
"Taylor County, Florida",2009,20723,38,10121,3047,7074,35900,2.92945999435,0.147034695749
"Taylor County, Florida",2012,22561,41.2,10947,3199,7748,34634,2.9118482189,0.141793360223
"Taylor County, Florida",2015,22685,41.2,10906,3301,7605,36181,2.98290598291,0.145514657263
"Taylor County, Georgia",2009,8654,37.7,4233,890,3343,23458,2.58869279091,0.102842616131
"Taylor County, Georgia",2012,8700,40.3,4543,1016,3527,28402,2.46668556847,0.116781609195
"Taylor County, Georgia",2015,8401,42.6,4513,1108,3405,28143,2.46725403818,0.131889060826
"Taylor County, Iowa",2009,6434,44.2,3228,430,2798,37987,2.2994996426,0.0668324525956
"Taylor County, Iowa",2012,6292,44.3,3103,367,2736,42638,2.29970760234,0.0583280356008
"Taylor County, Iowa",2015,6213,43.7,3086,342,2744,44246,2.26421282799,0.0550458715596
"Taylor County, Kentucky",2009,24103,40,10347,840,9507,33911,2.53528978647,0.034850433556
"Taylor County, Kentucky",2012,24514,40.2,10856,1366,9490,35000,2.58314014752,0.0557232601779
"Taylor County, Kentucky",2015,24993,39.2,10954,1239,9715,33340,2.57261966032,0.0495738806866
"Taylor County, Texas",2009,126587,32.1,54019,5051,48968,40363,2.58509638948,0.0399014116773
"Taylor County, Texas",2012,131425,32.6,55775,6352,49423,44372,2.65918701819,0.0483317481453
"Taylor County, Texas",2015,134435,32,56492,7016,49476,45396,2.71717600453,0.0521887901216
"Taylor County, West Virginia",2009,16188,42.2,7314,1012,6302,37639,2.56870834656,0.0625154435384
"Taylor County, West Virginia",2012,16889,42.4,7518,718,6800,40720,2.48367647059,0.0425128782047
"Taylor County, West Virginia",2015,16977,43,7521,789,6732,43970,2.52183600713,0.0464746421629
"Taylor County, Wisconsin",2009,19324,41.2,9187,1174,8013,44098,2.41158118058,0.0607534671911
"Taylor County, Wisconsin",2012,20631,41.8,10496,1686,8810,44578,2.3417707151,0.0817216809655
"Taylor County, Wisconsin",2015,20569,43.1,10594,1838,8756,45420,2.34913202376,0.0893577714036
"Tazewell County, Illinois",2009,130789,39.5,56346,3192,53154,54271,2.46056740791,0.0244057221938
"Tazewell County, Illinois",2012,135201,39.9,57468,3160,54308,55580,2.48952272225,0.0233726081908
"Tazewell County, Illinois",2015,135697,40.5,57958,3670,54288,58194,2.49957633363,0.0270455500122
"Tazewell County, Virginia",2009,44307,42.6,21104,3055,18049,35830,2.45481744141,0.0689507301329
"Tazewell County, Virginia",2012,44846,43.4,20802,2666,18136,36080,2.47276135862,0.0594478883289
"Tazewell County, Virginia",2015,43870,43.1,20716,2884,17832,37664,2.46018393899,0.0657396854342
"Tehama County, California",2009,60601,39.3,26231,2940,23291,36949,2.60190631574,0.0485140509233
"Tehama County, California",2012,63200,39.6,26928,3376,23552,40307,2.68342391304,0.053417721519
"Tehama County, California",2015,63152,40.5,27220,3516,23704,41001,2.6641916976,0.0556751963517
"Telfair County, Georgia",2009,13146,36.8,5183,991,4192,24609,3.13597328244,0.0753841472691
"Telfair County, Georgia",2012,16312,39.2,7165,1378,5787,24469,2.81873163988,0.0844776851398
"Telfair County, Georgia",2015,16416,40.3,7228,1939,5289,26449,3.10380034033,0.118116471735
"Teller County, Colorado",2009,21554,45.7,12031,3244,8787,56686,2.45294184591,0.150505706597
"Teller County, Colorado",2012,23163,47.4,12622,3588,9034,57970,2.56398051804,0.154902214739
"Teller County, Colorado",2015,23340,49.4,12730,3149,9581,62372,2.4360713913,0.134918594687
"Tensas Parish, Louisiana",2009,5798,38.9,3499,1100,2399,30572,2.41684035015,0.189720593308
"Tensas Parish, Louisiana",2012,5189,41.9,3358,1251,2107,29888,2.46274323683,0.241086914627
"Tensas Parish, Louisiana",2015,4893,43,3367,1452,1915,22940,2.55509138381,0.296750459841
"Terrebonne Parish, Louisiana",2009,108277,34.4,43787,5085,38702,47338,2.79771071262,0.0469628822372
"Terrebonne Parish, Louisiana",2012,111666,35.1,43850,4624,39226,49545,2.84673430888,0.041409202443
"Terrebonne Parish, Louisiana",2015,112742,35.2,44363,4277,40086,47826,2.8125031183,0.0379361728548
"Terrell County, Georgia",2009,10364,37.3,4711,795,3916,26723,2.64657814096,0.0767078348128
"Terrell County, Georgia",2012,9365,40.4,4110,739,3371,32855,2.77810738653,0.0789108382274
"Terrell County, Georgia",2015,9213,41,4167,855,3312,28688,2.78170289855,0.0928036470205
"Terrell County, Texas",2009,810,38.8,994,594,400,35900,2.025,0.733333333333
"Terrell County, Texas",2012,1001,47.1,870,431,439,37750,2.28018223235,0.430569430569
"Terrell County, Texas",2015,921,46.1,814,348,466,31111,1.97639484979,0.377850162866
"Terry County, Texas",2009,12154,36.4,5125,784,4341,34310,2.79981571067,0.0645055125884
"Terry County, Texas",2012,12561,35.5,4864,768,4096,35537,3.06665039062,0.0611416288512
"Terry County, Texas",2015,12687,34.3,4868,822,4046,37475,3.13568956995,0.0647907306692
"Teton County, Idaho",2009,8422,33.6,4352,887,3465,51125,2.43059163059,0.105319401567
"Teton County, Idaho",2012,10007,33.9,5422,1745,3677,56532,2.72151210226,0.174377935445
"Teton County, Idaho",2015,10285,35.2,5498,1893,3605,53474,2.85298196949,0.184054448226
"Teton County, Montana",2009,6132,45,2916,451,2465,39360,2.48762677485,0.0735485975212
"Teton County, Montana",2012,6082,45.6,2903,514,2389,42423,2.54583507744,0.0845116737915
"Teton County, Montana",2015,6074,44.8,2877,563,2314,46360,2.62489196197,0.092690154758
"Teton County, Wyoming",2009,20067,34.7,12108,4374,7734,67073,2.59464701319,0.217969801166
"Teton County, Wyoming",2012,21326,36.6,12821,5494,7327,69020,2.91060461307,0.257619806809
"Teton County, Wyoming",2015,22311,38,13146,4959,8187,75325,2.72517405643,0.222267043163
"Texas County, Missouri",2009,24477,41.9,11230,1847,9383,30569,2.60865394863,0.0754585937819
"Texas County, Missouri",2012,25840,41.9,11651,1985,9666,34520,2.67328781295,0.0768188854489
"Texas County, Missouri",2015,25735,41.6,11609,2475,9134,35088,2.81749507335,0.096172527686
"Texas County, Oklahoma",2009,20395,30.9,8374,1355,7019,42634,2.90568457045,0.0664378524148
"Texas County, Oklahoma",2012,20620,31,8221,1083,7138,47983,2.88876435976,0.0525218234724
"Texas County, Oklahoma",2015,21588,31.5,8181,1008,7173,50242,3.00961940611,0.0466926070039
"Thayer County, Nebraska",2009,5150,48.8,2806,502,2304,36719,2.23524305556,0.0974757281553
"Thayer County, Nebraska",2012,5195,48.8,2741,487,2254,43077,2.30479148181,0.0937439846006
"Thayer County, Nebraska",2015,5182,48.9,2723,382,2341,45741,2.21358393849,0.0737167116943
"Thomas County, Georgia",2009,45275,38.8,20073,2376,17697,36036,2.55834322202,0.0524792932082
"Thomas County, Georgia",2012,44715,39.1,20165,2703,17462,31471,2.56070324132,0.060449513586
"Thomas County, Georgia",2015,44824,39.4,20306,2921,17385,36641,2.57831463906,0.0651659825094
"Thomas County, Kansas",2009,7420,35.6,3594,503,3091,41541,2.40051763183,0.0677897574124
"Thomas County, Kansas",2012,7854,36.2,3537,400,3137,48029,2.50366592286,0.0509294626942
"Thomas County, Kansas",2015,7925,35.3,3539,365,3174,48504,2.49684940139,0.0460567823344
"Thomas County, Nebraska",2009,662,47.4,396,82,314,41000,2.10828025478,0.123867069486
"Thomas County, Nebraska",2012,831,38.9,406,78,328,56429,2.53353658537,0.0938628158845
"Thomas County, Nebraska",2015,675,44,390,90,300,51000,2.25,0.133333333333
"Throckmorton County, Texas",2009,1630,50.4,1126,388,738,34239,2.20867208672,0.238036809816
"Throckmorton County, Texas",2012,1626,49.2,1127,369,758,41019,2.14511873351,0.226937269373
"Throckmorton County, Texas",2015,1545,49.6,1048,347,701,41042,2.20399429387,0.224595469256
"Thurston County, Nebraska",2009,7252,26.9,2524,351,2173,40553,3.3373216751,0.0484004412576
"Thurston County, Nebraska",2012,6926,28.6,2405,360,2045,41961,3.38679706601,0.0519780537107
"Thurston County, Nebraska",2015,6946,28.6,2396,312,2084,41266,3.3330134357,0.0449179383818
"Thurston County, Washington",2009,239248,38,100074,6034,94040,59453,2.54410888983,0.0252206915
"Thurston County, Washington",2012,252410,38.3,108095,7329,100766,63224,2.50491237124,0.0290360920724
"Thurston County, Washington",2015,262723,38.5,110904,8273,102631,61677,2.55987956855,0.0314894394476
"Tift County, Georgia",2009,41932,33.7,16359,1709,14650,37121,2.86225255973,0.0407564628446
"Tift County, Georgia",2012,40430,34.4,16414,2655,13759,37033,2.93844029363,0.0656690576305
"Tift County, Georgia",2015,40787,35.1,16414,2287,14127,37653,2.88716641891,0.0560717875794
"Tillamook County, Oregon",2009,24914,47,17700,6827,10873,38851,2.291363929,0.274022637874
"Tillamook County, Oregon",2012,25254,47.9,18337,7494,10843,41869,2.32906022319,0.296745070088
"Tillamook County, Oregon",2015,25430,48,18474,8380,10094,42581,2.51931840697,0.329532048761
"Tillman County, Oklahoma",2009,8090,41.2,4337,1086,3251,28368,2.48846508767,0.134239802225
"Tillman County, Oklahoma",2012,7981,40.5,4085,1210,2875,34550,2.776,0.151610073926
"Tillman County, Oklahoma",2015,7715,40.5,4060,1003,3057,37759,2.5237160615,0.130006480881
"Tioga County, New York",2009,50367,41.3,21833,1709,20124,51011,2.50283243888,0.0339309468501
"Tioga County, New York",2012,51067,42.8,22196,1876,20320,56488,2.51313976378,0.0367360526367
"Tioga County, New York",2015,50199,43.6,22183,2311,19872,57514,2.52611714976,0.0460367736409
"Tioga County, Pennsylvania",2009,40828,41.6,20781,4062,16719,39812,2.44201208206,0.0994905457039
"Tioga County, Pennsylvania",2012,42081,42.3,21348,4250,17098,42607,2.46116504854,0.100995698771
"Tioga County, Pennsylvania",2015,42284,43,21441,4830,16611,46494,2.54554211065,0.114227603822
"Tippah County, Mississippi",2009,21439,37.7,9386,1139,8247,29872,2.59961198011,0.0531274779607
"Tippah County, Mississippi",2012,22095,38.1,9680,1185,8495,34523,2.60094173043,0.0536320434487
"Tippah County, Mississippi",2015,22054,38.4,9723,1374,8349,35609,2.64151395377,0.0623016232883
"Tippecanoe County, Indiana",2009,162527,26,66911,5525,61386,41842,2.64762323657,0.0339943517077
"Tippecanoe County, Indiana",2012,173317,27.7,71147,5310,65837,44047,2.63251666996,0.03063750238
"Tippecanoe County, Indiana",2015,180952,27.9,73136,5380,67756,45932,2.67064171439,0.0297316415403
"Tipton County, Indiana",2009,16055,41.3,7191,338,6853,50556,2.34276958996,0.0210526315789
"Tipton County, Indiana",2012,15917,43,7016,351,6665,53368,2.38814703676,0.0220518942012
"Tipton County, Indiana",2015,15573,43.8,6966,572,6394,51613,2.4355645918,0.0367302382328
"Tipton County, Tennessee",2009,57543,36.3,22941,1618,21323,51138,2.69863527646,0.0281181029839
"Tipton County, Tennessee",2012,61038,37.2,23189,1806,21383,51847,2.85451059253,0.0295881254301
"Tipton County, Tennessee",2015,61674,37,23385,1810,21575,53669,2.85858632677,0.0293478613354
"Tishomingo County, Mississippi",2009,19060,42.1,9971,2397,7574,29740,2.51650382889,0.125760755509
"Tishomingo County, Mississippi",2012,19573,42.5,10281,2712,7569,32878,2.58594266085,0.138558217953
"Tishomingo County, Mississippi",2015,19539,42.8,10303,2651,7652,35143,2.55345007841,0.135677363222
"Titus County, Texas",2009,29111,32.1,11210,1109,10101,39750,2.88199188199,0.0380955652502
"Titus County, Texas",2012,32045,32.8,11981,1350,10631,40909,3.0142978083,0.0421282571384
"Titus County, Texas",2015,32553,33.8,12070,1609,10461,44178,3.11184399197,0.0494270881332
"Toa Alta Municipio, Puerto Rico",2009,79734,31.8,23402,2150,21252,24831,3.7518351214,0.0269646574861
"Toa Alta Municipio, Puerto Rico",2012,74178,34.3,24355,2363,21992,27211,3.37295380138,0.0318558063038
"Toa Alta Municipio, Puerto Rico",2015,74603,35.8,25715,3146,22569,29976,3.30555186318,0.0421698859295
"Toa Baja Municipio, Puerto Rico",2009,94862,34.3,34127,3913,30214,23655,3.13967035149,0.0412493938563
"Toa Baja Municipio, Puerto Rico",2012,89294,35.7,34568,4458,30110,23572,2.9655928263,0.0499249669631
"Toa Baja Municipio, Puerto Rico",2015,85242,37.6,34673,5840,28833,23303,2.95640412028,0.0685108279956
"Todd County, Kentucky",2009,12043,36.4,5313,545,4768,40177,2.52579697987,0.0452545046915
"Todd County, Kentucky",2012,12472,38,5293,604,4689,40011,2.65984218383,0.0484284797947
"Todd County, Kentucky",2015,12524,36.9,5292,725,4567,40497,2.74228158529,0.0578888534015
"Todd County, Minnesota",2009,23968,41.6,12826,2721,10105,42604,2.37189510143,0.113526368491
"Todd County, Minnesota",2012,24783,41.9,12880,2771,10109,45287,2.45157780196,0.111810515273
"Todd County, Minnesota",2015,24466,43,12913,3074,9839,46414,2.48663482061,0.125643750511
"Todd County, South Dakota",2009,9997,23.4,2953,419,2534,26337,3.94514601421,0.0419125737721
"Todd County, South Dakota",2012,9711,22.9,3142,480,2662,30972,3.64800901578,0.0494284831634
"Todd County, South Dakota",2015,9942,23.9,3140,403,2737,31128,3.63244428206,0.0405351036009
"Tolland County, Connecticut",2009,148526,37.6,55830,2837,52993,76498,2.80274753269,0.0191010328158
"Tolland County, Connecticut",2012,152137,38.3,57912,3413,54499,80887,2.79155580836,0.0224337274956
"Tolland County, Connecticut",2015,151948,38.1,58383,3916,54467,79626,2.78972588907,0.0257719746229
"Tom Green County, Texas",2009,106643,33.5,45839,4513,41326,40753,2.58053041669,0.0423187644759
"Tom Green County, Texas",2012,110434,34.2,46533,4737,41796,44310,2.64221456599,0.0428943984642
"Tom Green County, Texas",2015,115056,33.9,47367,4542,42825,46711,2.68665499124,0.0394764288694
"Tompkins County, New York",2009,100583,28.3,40689,2882,37807,46506,2.6604332531,0.0286529532824
"Tompkins County, New York",2012,101570,29.8,41662,3117,38545,50539,2.63510182903,0.0306881953333
"Tompkins County, New York",2015,103855,30.2,41983,3523,38460,52624,2.70033801352,0.0339222955082
"Tooele County, Utah",2009,54473,29.2,18094,1240,16854,60236,3.23205173846,0.0227635709434
"Tooele County, Utah",2012,58158,29.5,19496,1278,18218,61933,3.19233724887,0.0219746208604
"Tooele County, Utah",2015,60893,30.7,20148,1517,18631,63552,3.2683699211,0.0249125515248
"Toole County, Montana",2009,5110,41.3,2279,346,1933,41322,2.64355923435,0.06771037182
"Toole County, Montana",2012,5210,42.8,2335,294,2041,45057,2.55267025968,0.0564299424184
"Toole County, Montana",2015,5150,41.7,2338,366,1972,44804,2.61156186613,0.071067961165
"Toombs County, Georgia",2009,27601,35.1,11882,1959,9923,30203,2.78151768618,0.0709756892866
"Toombs County, Georgia",2012,27270,35.7,12120,1761,10359,31757,2.63249348393,0.0645764576458
"Toombs County, Georgia",2015,27210,34.9,12101,1420,10681,33679,2.54751427769,0.0521866960676
"Torrance County, New Mexico",2009,16566,38.7,7402,1784,5618,35146,2.94873620506,0.10769045032
"Torrance County, New Mexico",2012,16285,40.8,7763,2189,5574,31538,2.92160028705,0.134418176236
"Torrance County, New Mexico",2015,15853,43.3,7769,2399,5370,32083,2.952141527,0.151327824387
"Towner County, North Dakota",2009,2318,48.1,1549,407,1142,42681,2.02977232925,0.175582398619
"Towner County, North Dakota",2012,2264,48.8,1435,417,1018,53594,2.22396856582,0.184187279152
"Towner County, North Dakota",2015,2294,48.5,1382,379,1003,56625,2.28713858425,0.165213600697
"Towns County, Georgia",2009,10752,49.9,8200,3231,4969,39908,2.16381565707,0.300502232143
"Towns County, Georgia",2012,10491,51.3,7780,3297,4483,35843,2.34017399063,0.314269373749
"Towns County, Georgia",2015,10800,52.4,7854,3586,4268,37000,2.53045923149,0.332037037037
"Traill County, North Dakota",2009,7997,41.7,3760,393,3367,44385,2.37511137511,0.0491434287858
"Traill County, North Dakota",2012,8105,42.2,3789,415,3374,46398,2.40219324244,0.0512029611351
"Traill County, North Dakota",2015,8077,41.4,3813,535,3278,54960,2.46400244051,0.0662374644051
"Transylvania County, North Carolina",2009,29886,47.3,17252,4639,12613,38446,2.36946008087,0.155223181423
"Transylvania County, North Carolina",2012,32825,49.4,19092,5199,13893,40678,2.36270064061,0.158385376999
"Transylvania County, North Carolina",2015,32928,50.1,19310,5643,13667,45114,2.40930709007,0.171373906706
"Traverse County, Minnesota",2009,3684,47.4,2189,495,1694,38881,2.17473435655,0.134364820847
"Traverse County, Minnesota",2012,3549,47.6,2081,512,1569,44025,2.26195028681,0.14426599042
"Traverse County, Minnesota",2015,3429,48.4,2075,551,1524,49186,2.25,0.160688247302
"Travis County, Texas",2009,966761,31.3,416042,35831,380211,54044,2.54269602931,0.0370629348929
"Travis County, Texas",2012,1034842,32,441762,36356,405406,56403,2.55260652284,0.035131933184
"Travis County, Texas",2015,1121645,33,464197,35977,428220,61451,2.61931950866,0.0320752109625
"Treasure County, Montana",2009,912,40.4,433,91,342,43553,2.66666666667,0.0997807017544
"Treasure County, Montana",2012,698,51.9,444,108,336,38125,2.07738095238,0.154727793696
"Treasure County, Montana",2015,812,49,437,84,353,41103,2.30028328612,0.103448275862
"Trego County, Kansas",2009,2949,48,1711,393,1318,37463,2.23748103187,0.133265513733
"Trego County, Kansas",2012,2977,46.8,1695,471,1224,44063,2.43218954248,0.158212966073
"Trego County, Kansas",2015,2951,49.1,1665,363,1302,54000,2.26651305684,0.123009149441
"Trempealeau County, Wisconsin",2009,27675,41.2,12564,1050,11514,46409,2.40359562272,0.0379403794038
"Trempealeau County, Wisconsin",2012,28853,40.9,12642,969,11673,48624,2.47177246638,0.0335840293904
"Trempealeau County, Wisconsin",2015,29412,40.7,12764,968,11796,51077,2.49338758901,0.0329117367061
"Treutlen County, Georgia",2009,6907,37.8,2910,522,2388,27627,2.89237855946,0.0755755031128
"Treutlen County, Georgia",2012,6851,37.8,2754,405,2349,35960,2.9165602384,0.0591154575974
"Treutlen County, Georgia",2015,6762,42.8,3231,604,2627,38596,2.57403882756,0.089322685596
"Trigg County, Kentucky",2009,13231,43.7,7091,1591,5500,41250,2.40563636364,0.120247902653
"Trigg County, Kentucky",2012,14282,44.3,7769,1735,6034,44144,2.36692078223,0.121481585212
"Trigg County, Kentucky",2015,14250,45.1,7835,1821,6014,44083,2.36947123379,0.127789473684
"Trimble County, Kentucky",2009,8930,38.6,3623,520,3103,46759,2.87786013535,0.0582306830907
"Trimble County, Kentucky",2012,8829,39.5,3912,448,3464,52805,2.54878752887,0.0507418733718
"Trimble County, Kentucky",2015,8783,41.1,3923,375,3548,47409,2.47547914318,0.0426961174997
"Trinity County, California",2009,13922,50.4,8326,2567,5759,35551,2.41743358222,0.184384427525
"Trinity County, California",2012,13693,49.2,8661,2850,5811,36569,2.35639304767,0.208135543708
"Trinity County, California",2015,13373,50.3,8770,3286,5484,34974,2.43854850474,0.245718986017
"Trinity County, Texas",2009,14005,45.3,8593,3274,5319,36519,2.63301372438,0.233773652267
"Trinity County, Texas",2012,14466,46.5,8708,4001,4707,37223,3.07329509242,0.276579565879
"Trinity County, Texas",2015,14405,47.7,8733,3408,5325,34295,2.70516431925,0.236584519264
"Tripp County, South Dakota",2009,5761,44,3092,529,2563,39044,2.24775653531,0.0918243360528
"Tripp County, South Dakota",2012,5608,44,3070,542,2528,40920,2.21835443038,0.0966476462197
"Tripp County, South Dakota",2015,5504,46.4,3070,491,2579,37153,2.13416052734,0.0892078488372
"Troup County, Georgia",2009,63414,35,26972,3494,23478,39788,2.70099667774,0.0550982432901
"Troup County, Georgia",2012,67146,36.1,27979,3425,24554,40246,2.7346257229,0.0510082506776
"Troup County, Georgia",2015,68867,36.1,28241,3596,24645,41489,2.79435991073,0.0522165914008
"Trousdale County, Tennessee",2009,7682,39.3,3384,488,2896,44764,2.65262430939,0.0635251236657
"Trousdale County, Tennessee",2012,7827,38,3368,519,2849,43613,2.74727974728,0.0663089306248
"Trousdale County, Tennessee",2015,7884,40.2,3402,476,2926,41029,2.69446343131,0.0603754439371
"Trujillo Alto Municipio, Puerto Rico",2009,85675,35,27459,2440,25019,31095,3.42439745793,0.0284797198716
"Trujillo Alto Municipio, Puerto Rico",2012,74655,36.4,28093,3449,24644,31354,3.02933776984,0.046199182908
"Trujillo Alto Municipio, Puerto Rico",2015,71886,37.8,29340,4528,24812,30140,2.89722714815,0.0629886208719
"Trumbull County, Ohio",2009,213350,41.8,97093,9303,87790,42407,2.43023123363,0.0436044059058
"Trumbull County, Ohio",2012,209942,42.8,96153,9393,86760,42488,2.41980175196,0.0447409284469
"Trumbull County, Ohio",2015,206373,43.6,95669,8841,86828,43073,2.37680241397,0.0428399063831
"Tucker County, West Virginia",2009,6861,45.3,4820,1819,3001,31306,2.28623792069,0.265121702376
"Tucker County, West Virginia",2012,7109,46.2,5327,2198,3129,36445,2.271971876,0.309185539457
"Tucker County, West Virginia",2015,6972,47.7,5346,2336,3010,40533,2.31627906977,0.335054503729
"Tulare County, California",2009,416299,29.3,134831,11651,123180,43164,3.37959896087,0.0279870958133
"Tulare County, California",2012,441877,29.7,141759,11763,129996,43803,3.39915843564,0.0266205301475
"Tulare County, California",2015,454033,30.3,144792,11222,133570,42031,3.39921389534,0.0247162651173
"Tulsa County, Oklahoma",2009,585419,34.8,261966,25220,236746,45264,2.47277250724,0.0430802553385
"Tulsa County, Oklahoma",2012,602692,35.3,268795,27986,240809,47845,2.5027802117,0.0464349949891
"Tulsa County, Oklahoma",2015,623335,35.3,274891,28811,246080,49759,2.53305835501,0.0462207320301
"Tunica County, Mississippi",2009,10406,30.4,4495,672,3823,29420,2.72194611562,0.0645781280031
"Tunica County, Mississippi",2012,10716,32.2,4779,698,4081,30463,2.62582700319,0.0651362448675
"Tunica County, Mississippi",2015,10477,32.2,4811,822,3989,31211,2.6264728002,0.0784575737329
"Tuolumne County, California",2009,55761,45.9,30361,8244,22117,48354,2.52118280056,0.147845268198
"Tuolumne County, California",2012,55205,48,31193,9088,22105,48169,2.49739877856,0.164622769677
"Tuolumne County, California",2015,54079,48.6,31361,9228,22133,50306,2.44336511092,0.170639249986
"Turner County, Georgia",2009,9374,35.9,4013,618,3395,30414,2.76111929308,0.0659270322168
"Turner County, Georgia",2012,8834,39.5,3856,775,3081,27056,2.86725089257,0.0877292279828
"Turner County, Georgia",2015,8338,38,3827,814,3013,31806,2.76734152008,0.0976253298153
"Turner County, South Dakota",2009,8331,43.8,3999,466,3533,47950,2.35805264648,0.0559356619854
"Turner County, South Dakota",2012,8344,43.7,3951,509,3442,50565,2.42417199303,0.0610019175455
"Turner County, South Dakota",2015,8302,44,3981,461,3520,53378,2.35852272727,0.0555287882438
"Tuscaloosa County, Alabama",2009,178754,31.6,81419,11734,69685,39579,2.56517184473,0.0656432863041
"Tuscaloosa County, Alabama",2012,194254,31.4,84890,16971,67919,43996,2.86008333456,0.087364996345
"Tuscaloosa County, Alabama",2015,200458,31.9,87064,17936,69128,46565,2.89980904988,0.0894751020164
"Tuscarawas County, Ohio",2009,91243,40.3,39063,3483,35580,42995,2.56444631816,0.0381727913374
"Tuscarawas County, Ohio",2012,92532,40.8,40123,3825,36298,43869,2.54923136261,0.0413370509662
"Tuscarawas County, Ohio",2015,92697,41,40007,3294,36713,45310,2.52490943263,0.0355351305868
"Tuscola County, Michigan",2009,56538,40.3,24287,2536,21751,42851,2.59932876649,0.0448547879302
"Tuscola County, Michigan",2012,55616,41.6,24429,3186,21243,43463,2.61808595773,0.0572856731876
"Tuscola County, Michigan",2015,54420,43.3,24303,2999,21304,43768,2.55444986857,0.0551084160235
"Twiggs County, Georgia",2009,10259,38.6,4486,1308,3178,29593,3.22813089994,0.127497806804
"Twiggs County, Georgia",2012,8984,43.9,4244,1200,3044,30533,2.95137976347,0.13357079252
"Twiggs County, Georgia",2015,8509,45.6,4197,1175,3022,30468,2.81568497684,0.138089082148
"Twin Falls County, Idaho",2009,72578,34.5,29529,2505,27024,41577,2.68568679692,0.0345145911984
"Twin Falls County, Idaho",2012,77122,34.6,31014,3034,27980,42639,2.75632594711,0.0393402660719
"Twin Falls County, Idaho",2015,80004,34.5,31577,2560,29017,44048,2.75714236482,0.03199840008
"Tyler County, Texas",2009,20340,39.6,10775,2558,8217,33548,2.47535596933,0.125762045231
"Tyler County, Texas",2012,21638,42.2,10579,2400,8179,36785,2.6455556914,0.110915981144
"Tyler County, Texas",2015,21462,42.8,10596,2628,7968,41360,2.69352409639,0.122448979592
"Tyler County, West Virginia",2009,8970,44.2,4919,1130,3789,33579,2.36737925574,0.125975473802
"Tyler County, West Virginia",2012,9188,45.1,4990,1355,3635,37919,2.52764786795,0.147474967349
"Tyler County, West Virginia",2015,9033,46.2,4990,1374,3616,38854,2.49806415929,0.152108933909
"Tyrrell County, North Carolina",2009,4112,43.3,2317,573,1744,30313,2.35779816514,0.139348249027
"Tyrrell County, North Carolina",2012,4367,44.2,2180,514,1666,33605,2.6212484994,0.11770093886
"Tyrrell County, North Carolina",2015,4152,44.4,2003,552,1451,32361,2.86147484493,0.132947976879
"Uinta County, Wyoming",2009,20119,33.8,8615,1364,7251,56407,2.77465177217,0.0677966101695
"Uinta County, Wyoming",2012,20942,34.3,8706,1457,7249,59714,2.88895020003,0.0695731066756
"Uinta County, Wyoming",2015,20930,34.6,8765,1263,7502,56569,2.78992268728,0.0603440038223
"Uintah County, Utah",2009,29014,29,10395,611,9784,57735,2.96545380213,0.0210587992004
"Uintah County, Utah",2012,32809,29.4,11868,911,10957,61850,2.99434151684,0.0277667713127
"Uintah County, Utah",2015,35721,29.7,12766,1785,10981,66815,3.25298242419,0.0499706055262
"Ulster County, New York",2009,181510,40.6,81613,11746,69867,57485,2.59793607855,0.0647126880062
"Ulster County, New York",2012,182516,42.1,83558,13284,70274,58934,2.59720522526,0.0727826601503
"Ulster County, New York",2015,181300,43.1,83733,14259,69474,58918,2.60960935026,0.0786486486486
"Umatilla County, Oregon",2009,72905,36.1,29335,2936,26399,45230,2.76165763855,0.040271586311
"Umatilla County, Oregon",2012,75846,35.7,29707,2921,26786,48452,2.83155379676,0.0385122485035
"Umatilla County, Oregon",2015,76738,36,29741,2947,26794,48101,2.86399940285,0.038403398577
"Unicoi County, Tennessee",2009,17686,44,8605,1309,7296,34686,2.42406798246,0.0740133438878
"Unicoi County, Tennessee",2012,18287,44.7,8826,1306,7520,35415,2.43178191489,0.0714168535025
"Unicoi County, Tennessee",2015,18069,45.7,8840,1412,7428,33210,2.43255250404,0.0781448890365
"Union County, Arkansas",2009,43157,39.8,21274,3176,18098,35732,2.38462813571,0.0735917695855
"Union County, Arkansas",2012,41594,39.8,19739,3107,16632,39349,2.50084175084,0.0746982737895
"Union County, Arkansas",2015,40633,39.7,19641,3105,16536,38678,2.45724479923,0.0764157212118
"Union County, Florida",2009,14574,37.1,4009,690,3319,40694,4.3910816511,0.0473445862495
"Union County, Florida",2012,15400,39.8,4479,697,3782,43750,4.07191961925,0.0452597402597
"Union County, Florida",2015,15191,40.3,4477,594,3883,39163,3.91218130312,0.0391020999276
"Union County, Georgia",2009,20699,48.5,13217,3886,9331,38100,2.21830457614,0.187738538094
"Union County, Georgia",2012,21344,51,14027,4691,9336,42125,2.28620394173,0.219780734633
"Union County, Georgia",2015,21725,53.3,14203,5846,8357,40799,2.59961708747,0.269090909091
"Union County, Illinois",2009,18078,42.3,8161,973,7188,38028,2.51502504174,0.0538223254785
"Union County, Illinois",2012,17799,43.3,7926,1068,6858,41869,2.59536307962,0.0600033709759
"Union County, Illinois",2015,17551,43.6,7914,1202,6712,42606,2.61486889154,0.0684861261467
"Union County, Indiana",2009,7083,38.4,3349,325,3024,42995,2.34226190476,0.0458845122123
"Union County, Indiana",2012,7449,40.2,3247,264,2983,44263,2.49715051961,0.0354409987918
"Union County, Indiana",2015,7299,42.1,3226,263,2963,44277,2.46338170773,0.0360323331963
"Union County, Iowa",2009,12076,41.9,5784,456,5328,42229,2.26651651652,0.0377608479629
"Union County, Iowa",2012,12525,41.5,5930,579,5351,41795,2.3406839843,0.0462275449102
"Union County, Iowa",2015,12575,40.6,5910,573,5337,44351,2.35619261758,0.0455666003976
"Union County, Kentucky",2009,15158,34.6,6394,583,5811,39133,2.60850111857,0.0384615384615
"Union County, Kentucky",2012,14992,36.6,6140,730,5410,37445,2.77116451017,0.0486926360726
"Union County, Kentucky",2015,15138,37.1,6183,621,5562,40120,2.7216828479,0.0410225921522
"Union County, Mississippi",2009,26939,36.7,11242,1146,10096,35955,2.6682844691,0.0425405545863
"Union County, Mississippi",2012,27175,37.1,11506,1220,10286,36582,2.64194050165,0.0448942042318
"Union County, Mississippi",2015,27811,38,11686,1341,10345,35865,2.6883518608,0.0482183308763
"Union County, New Jersey",2009,522050,37.6,196744,13057,183687,66433,2.84206285693,0.0250110142707
"Union County, New Jersey",2012,536383,37.9,199758,15015,184743,69347,2.90340094077,0.0279930571998
"Union County, New Jersey",2015,548744,38.1,200708,14533,186175,69594,2.94746340808,0.026484116455
"Union County, New Mexico",2009,3755,36.6,2138,603,1535,37415,2.44625407166,0.160585885486
"Union County, New Mexico",2012,4460,40.5,2290,618,1672,40507,2.66746411483,0.138565022422
"Union County, New Mexico",2015,4339,40.3,2299,740,1559,36070,2.78319435536,0.170546208804
"Union County, North Carolina",2009,181852,35.2,66224,4219,62005,60074,2.93286025321,0.0232001847656
"Union County, North Carolina",2012,201617,36.3,72808,5288,67520,64953,2.98603376777,0.0262279470481
"Union County, North Carolina",2015,213422,37.2,75313,4602,70711,65903,3.01822912984,0.0215629129143
"Union County, Ohio",2009,47406,36,18591,1282,17309,69079,2.73880640129,0.0270429903388
"Union County, Ohio",2012,52153,36.8,19432,1319,18113,65866,2.87931320046,0.0252909707975
"Union County, Ohio",2015,53470,38.1,19815,1384,18431,67382,2.90109055396,0.0258836730877
"Union County, Oregon",2009,24821,39.5,10830,977,9853,40542,2.51913122907,0.0393618307079
"Union County, Oregon",2012,25670,40.1,11444,1145,10299,41784,2.49247499757,0.0446045968056
"Union County, Oregon",2015,25745,40,11513,1383,10130,43822,2.54146100691,0.0537191687706
"Union County, Pennsylvania",2009,43424,37.4,15550,1802,13748,44246,3.15856851906,0.041497789241
"Union County, Pennsylvania",2012,44944,38.4,16923,1620,15303,46737,2.93694046919,0.0360448558206
"Union County, Pennsylvania",2015,44958,38.6,17074,2158,14916,49803,3.01407884151,0.0480003558877
"Union County, South Carolina",2009,27800,41.3,13606,2144,11462,33345,2.42540568836,0.0771223021583
"Union County, South Carolina",2012,28804,42.4,14102,2271,11831,32459,2.43462091117,0.07884321622
"Union County, South Carolina",2015,28125,43.5,14049,2383,11666,34033,2.41085204869,0.0847288888889
"Union County, South Dakota",2009,13947,40,6096,364,5732,56720,2.43318213538,0.0260988026099
"Union County, South Dakota",2012,14377,40.4,6301,565,5736,64496,2.50645048815,0.0392988801558
"Union County, South Dakota",2015,14842,40.8,6561,622,5939,64471,2.49907391817,0.041908098639
"Union County, Tennessee",2009,18927,39.1,9096,1378,7718,31226,2.45231925369,0.0728060442754
"Union County, Tennessee",2012,19179,40.1,9000,1596,7404,33456,2.59035656402,0.0832160175192
"Union County, Tennessee",2015,19096,41,9061,1759,7302,37351,2.61517392495,0.0921135316297
"Union Parish, Louisiana",2009,22712,40.4,12148,3363,8785,35788,2.58531587934,0.148071504051
"Union Parish, Louisiana",2012,22633,40.9,11404,3048,8356,36507,2.70859262805,0.134670613706
"Union Parish, Louisiana",2015,22533,41.7,11420,2903,8517,34992,2.64564987672,0.128833266764
"Upshur County, Texas",2009,37635,39.8,15679,1754,13925,42256,2.7026929982,0.0466055533413
"Upshur County, Texas",2012,39386,40.4,16580,1937,14643,45696,2.6897493683,0.0491799116437
"Upshur County, Texas",2015,40096,40.5,16709,2865,13844,46673,2.89627275354,0.0714535115722
"Upshur County, West Virginia",2009,23566,40.2,11375,1731,9644,34275,2.44359187059,0.0734532801494
"Upshur County, West Virginia",2012,24210,41.3,11112,2028,9084,41214,2.66512549538,0.0837670384139
"Upshur County, West Virginia",2015,24560,41.8,11148,2055,9093,40330,2.70097877488,0.0836726384365
"Upson County, Georgia",2009,27501,37.8,12341,1756,10585,33634,2.59811053377,0.0638522235555
"Upson County, Georgia",2012,27061,41,12178,1965,10213,34905,2.64966219524,0.0726137245482
"Upson County, Georgia",2015,26528,41.5,12124,1965,10159,35774,2.61128063786,0.0740726779252
"Upton County, Texas",2009,3046,36.8,1325,288,1037,42940,2.93731918997,0.0945502298096
"Upton County, Texas",2012,3300,37.1,1484,305,1179,52042,2.7989821883,0.0924242424242
"Upton County, Texas",2015,3405,31.9,1514,297,1217,46131,2.79786359901,0.0872246696035
"Utah County, Utah",2009,504990,23.2,136740,7010,129730,56752,3.89262314037,0.0138814629993
"Utah County, Utah",2012,516571,24.5,148683,7431,141252,59864,3.65708804123,0.0143852442355
"Utah County, Utah",2015,551957,24.4,155425,6961,148464,62180,3.71778343572,0.0126114896631
"Utuado Municipio, Puerto Rico",2009,34543,35.8,11897,1953,9944,13367,3.47375301689,0.0565382277162
"Utuado Municipio, Puerto Rico",2012,33033,38,12717,2493,10224,14752,3.23092723005,0.0754699845609
"Utuado Municipio, Puerto Rico",2015,31474,39.7,13361,3231,10130,15725,3.1070088845,0.102656160641
"Uvalde County, Texas",2009,26623,34,10598,1934,8664,32331,3.07283010157,0.0726439544755
"Uvalde County, Texas",2012,26434,35.2,10821,2161,8660,34110,3.05242494226,0.0817507755164
"Uvalde County, Texas",2015,26952,34.1,10955,2520,8435,38568,3.19525785418,0.093499554764
"Val Verde County, Texas",2009,47533,32.4,17555,2895,14660,34150,3.24236016371,0.0609050554352
"Val Verde County, Texas",2012,48578,32.6,18582,3679,14903,40509,3.25961215863,0.0757338712998
"Val Verde County, Texas",2015,48980,31.7,18738,3948,14790,42174,3.31169709263,0.0806043282973
"Valdez-Cordova Census Area, Alaska",2009,9529,38.7,5287,1621,3666,55952,2.59929078014,0.170112288803
"Valdez-Cordova Census Area, Alaska",2012,9614,39.6,6057,2351,3706,67421,2.5941716136,0.244539213647
"Valdez-Cordova Census Area, Alaska",2015,9617,36.6,6093,3083,3010,78810,3.1950166113,0.320578142872
"Valencia County, New Mexico",2009,70974,36,26628,2045,24583,42955,2.88711711345,0.0288133682757
"Valencia County, New Mexico",2012,76172,37.4,29946,2500,27446,42525,2.77534066895,0.0328204589613
"Valencia County, New Mexico",2015,76297,38.5,30162,3299,26863,41703,2.84022633362,0.0432389215828
"Valley County, Idaho",2009,8667,44.7,9820,5848,3972,52523,2.18202416918,0.674743279105
"Valley County, Idaho",2012,9793,46.7,11696,8059,3637,51953,2.69260379434,0.822934749311
"Valley County, Idaho",2015,9720,49.4,11868,8680,3188,48384,3.04893350063,0.893004115226
"Valley County, Montana",2009,6888,45.8,4811,1763,3048,38559,2.25984251969,0.255952380952
"Valley County, Montana",2012,7423,45.8,4877,1630,3247,45083,2.28611025562,0.219587767749
"Valley County, Montana",2015,7577,45.5,4843,1548,3295,49141,2.2995447648,0.204302494391
"Valley County, Nebraska",2009,4221,46.3,2321,369,1952,34211,2.16239754098,0.0874200426439
"Valley County, Nebraska",2012,4322,47.3,2300,414,1886,44762,2.29162248144,0.0957889865803
"Valley County, Nebraska",2015,4254,46,2275,378,1897,44612,2.24248813917,0.0888575458392
"Van Buren County, Arkansas",2009,16411,45.5,9685,2935,6750,30531,2.43125925926,0.178843458656
"Van Buren County, Arkansas",2012,17223,46.5,10315,3235,7080,33900,2.43262711864,0.187830227022
"Van Buren County, Arkansas",2015,17002,47.1,10329,3450,6879,32312,2.47158017154,0.202917303847
"Van Buren County, Iowa",2009,7662,42.9,3670,582,3088,42797,2.48121761658,0.0759592795615
"Van Buren County, Iowa",2012,7565,43.8,3658,617,3041,41572,2.48766853009,0.0815598149372
"Van Buren County, Iowa",2015,7432,43.9,3639,695,2944,45111,2.52445652174,0.0935145317546
"Van Buren County, Michigan",2009,78026,38.7,36778,7250,29528,43740,2.64244107288,0.0929177453669
"Van Buren County, Michigan",2012,76149,40.1,36756,8378,28378,44425,2.68338149271,0.11002114276
"Van Buren County, Michigan",2015,75351,41.3,36690,8323,28367,46008,2.65629076039,0.110456397394
"Van Buren County, Tennessee",2009,5423,41.7,2588,540,2048,30359,2.64794921875,0.0995758805089
"Van Buren County, Tennessee",2012,5552,43.5,2663,583,2080,31940,2.66923076923,0.105007204611
"Van Buren County, Tennessee",2015,5596,45.8,2658,552,2106,40439,2.6571699905,0.0986418870622
"Van Wert County, Ohio",2009,28846,39.2,12760,1195,11565,44526,2.49424989192,0.0414268876101
"Van Wert County, Ohio",2012,28808,40.2,12627,1331,11296,44602,2.55028328612,0.0462024437656
"Van Wert County, Ohio",2015,28576,41.5,12672,1317,11355,48060,2.51660061647,0.0460876259798
"Van Zandt County, Texas",2009,51874,41.4,22077,2885,19192,42271,2.70289704043,0.0556155299379
"Van Zandt County, Texas",2012,52507,42.3,22766,3436,19330,42668,2.71634764615,0.0654388938618
"Van Zandt County, Texas",2015,52736,43.5,22893,4280,18613,44002,2.83328856176,0.0811589805825
"Vance County, North Carolina",2009,42987,36.9,19097,2990,16107,33874,2.66883963494,0.0695559122525
"Vance County, North Carolina",2012,45183,38.4,20011,3826,16185,34499,2.79165894347,0.0846778655689
"Vance County, North Carolina",2015,44829,40,19990,3401,16589,33316,2.70233287118,0.0758660688394
"Vanderburgh County, Indiana",2009,174544,36.9,81405,8562,72843,42579,2.3961670991,0.0490535337794
"Vanderburgh County, Indiana",2012,179610,37.5,82968,8667,74301,43645,2.41732951104,0.0482545515283
"Vanderburgh County, Indiana",2015,181305,37.8,83329,9112,74217,43046,2.44290391689,0.0502578527895
"Vega Alta Municipio, Puerto Rico",2009,39547,34.1,14341,2352,11989,17040,3.29860705647,0.0594735378158
"Vega Alta Municipio, Puerto Rico",2012,39913,35.3,15196,3654,11542,17616,3.45806619303,0.0915491193346
"Vega Alta Municipio, Puerto Rico",2015,39319,36.7,16084,3512,12572,18016,3.12750556793,0.0893206846563
"Vega Baja Municipio, Puerto Rico",2009,64580,34.7,22179,3499,18680,16924,3.45717344754,0.0541808609477
"Vega Baja Municipio, Puerto Rico",2012,59444,36.6,23424,6142,17282,16462,3.43964818887,0.103324137003
"Vega Baja Municipio, Puerto Rico",2015,56858,38.5,24765,7456,17309,16948,3.2848806979,0.131133701502
"Venango County, Pennsylvania",2009,54817,43.4,27414,5022,22392,38475,2.44806180779,0.0916139153912
"Venango County, Pennsylvania",2012,54865,44.4,27450,4925,22525,41814,2.43573806881,0.0897657887542
"Venango County, Pennsylvania",2015,53906,45.4,27309,5180,22129,43644,2.43598897374,0.0960931992728
"Ventura County, California",2009,792313,36.1,271565,14387,257178,74828,3.08079618008,0.0181582278721
"Ventura County, California",2012,822794,36.4,281245,15294,265951,76483,3.09378043324,0.0185878846953
"Ventura County, California",2015,840833,37.1,283899,14930,268969,77348,3.12613349494,0.0177562012909
"Vermilion County, Illinois",2009,80926,39.3,36827,4083,32744,39249,2.4714756902,0.0504535007291
"Vermilion County, Illinois",2012,81463,39.6,36315,4452,31863,40961,2.55666446976,0.0546505775628
"Vermilion County, Illinois",2015,80368,40,36093,4562,31531,42977,2.54885668073,0.0567638861238
"Vermilion Parish, Louisiana",2009,55612,36.2,24158,3065,21093,40785,2.63651448348,0.0551140041718
"Vermilion Parish, Louisiana",2012,58041,36.7,25221,3273,21948,44339,2.64447785675,0.0563911717579
"Vermilion Parish, Louisiana",2015,59110,36.7,25722,3926,21796,45374,2.71196549826,0.0664185417019
"Vermillion County, Indiana",2009,16301,41.1,7623,947,6676,42451,2.44173157579,0.0580945954236
"Vermillion County, Indiana",2012,16224,41.5,7488,968,6520,41864,2.48834355828,0.0596646942801
"Vermillion County, Indiana",2015,15860,42.9,7466,928,6538,43600,2.42581829306,0.0585119798235
"Vernon County, Missouri",2009,20127,38.5,9181,1118,8063,33161,2.49621728885,0.055547274805
"Vernon County, Missouri",2012,20958,40.3,9476,1316,8160,38138,2.56838235294,0.062792251169
"Vernon County, Missouri",2015,20878,40.6,9477,1437,8040,40693,2.59676616915,0.0688284318421
"Vernon County, Wisconsin",2009,28988,41.1,13651,1617,12034,41545,2.40884161542,0.0557817027736
"Vernon County, Wisconsin",2012,29827,41.6,13728,1991,11737,44676,2.54127971373,0.0667516008985
"Vernon County, Wisconsin",2015,30279,42.3,13761,2003,11758,47675,2.57518285423,0.0661514581063
"Vernon Parish, Louisiana",2009,47475,29,22161,3571,18590,40030,2.55379236148,0.0752185360716
"Vernon Parish, Louisiana",2012,51542,30,21449,3349,18100,46260,2.84762430939,0.0649761359668
"Vernon Parish, Louisiana",2015,52476,30,21649,3807,17842,46312,2.94115009528,0.072547450263
"Victoria County, Texas",2009,86206,35.7,34512,3033,31479,45859,2.73852409543,0.0351831659049
"Victoria County, Texas",2012,87188,36.2,35366,3439,31927,50097,2.73085476243,0.0394435013993
"Victoria County, Texas",2015,90099,35.7,35876,3366,32510,51758,2.77142417718,0.0373589052043
"Vieques Municipio, Puerto Rico",2009,9240,39.1,4193,1173,3020,14910,3.05960264901,0.126948051948
"Vieques Municipio, Puerto Rico",2012,9293,41.9,4544,1623,2921,16598,3.18144471072,0.174647584203
"Vieques Municipio, Puerto Rico",2015,9130,42.8,5139,2366,2773,18104,3.29246303642,0.259145673604
"Vigo County, Indiana",2009,105434,35.6,47364,5432,41932,37509,2.51440427359,0.0515203824193
"Vigo County, Indiana",2012,107805,36.2,46129,6401,39728,40547,2.71357732582,0.0593757246881
"Vigo County, Indiana",2015,108268,36,46353,6038,40315,40313,2.68555128364,0.0557690176229
"Vilas County, Wisconsin",2009,21846,49.7,23778,13275,10503,42318,2.07997714939,0.607662730019
"Vilas County, Wisconsin",2012,21489,50.9,24801,14133,10668,40743,2.01434195726,0.657685327377
"Vilas County, Wisconsin",2015,21355,52.6,25330,14684,10646,41061,2.00591771557,0.687614141887
"Villalba Municipio, Puerto Rico",2009,30054,30.8,8256,942,7314,14961,4.10910582445,0.0313435815532
"Villalba Municipio, Puerto Rico",2012,25983,33.5,8645,1020,7625,16014,3.40760655738,0.0392564369011
"Villalba Municipio, Puerto Rico",2015,24685,35.9,9175,1172,8003,17818,3.08446832438,0.0474782256431
"Vinton County, Ohio",2009,13274,37.7,5746,818,4928,33873,2.69358766234,0.0616242278138
"Vinton County, Ohio",2012,13397,39.5,6258,945,5313,34432,2.52155091286,0.0705381801896
"Vinton County, Ohio",2015,13234,41,6223,1231,4992,40680,2.65104166667,0.0930179839807
"Virginia Beach city, Virginia",2009,434922,34.1,174133,11614,162519,63370,2.67613017555,0.0267036388134
"Virginia Beach city, Virginia",2012,439528,34.8,177945,13719,164226,65980,2.67636062499,0.0312130285215
"Virginia Beach city, Virginia",2015,448290,35,180824,14582,166242,66634,2.69661096474,0.0325280510384
"Volusia County, Florida",2009,494449,43.3,245255,45237,200018,43326,2.47202251797,0.0914897188588
"Volusia County, Florida",2012,495581,45.3,253924,58345,195579,43419,2.5339172406,0.117730502178
"Volusia County, Florida",2015,503719,46.3,255437,55257,200180,41117,2.51633030273,0.109698065787
"Wabash County, Illinois",2009,12199,41.3,5884,778,5106,44738,2.38915001958,0.0637757193213
"Wabash County, Illinois",2012,11935,42.8,5593,834,4759,45011,2.50787980668,0.0698785085882
"Wabash County, Illinois",2015,11652,42.7,5539,668,4871,47491,2.3921166085,0.0573292138689
"Wabash County, Indiana",2009,33004,40.9,14472,1046,13426,43198,2.45821540295,0.0316931281057
"Wabash County, Indiana",2012,32804,41.6,14184,1367,12817,44389,2.55941327924,0.0416717473479
"Wabash County, Indiana",2015,32358,42.4,14122,1221,12901,45649,2.50817766065,0.0377340997589
"Wabasha County, Minnesota",2009,21831,42.1,10239,1141,9098,51541,2.39953836008,0.0522651275709
"Wabasha County, Minnesota",2012,21636,43,10009,1163,8846,53537,2.4458512322,0.0537530042522
"Wabasha County, Minnesota",2015,21381,43.8,10029,1076,8953,56510,2.38813805428,0.0503250549553
"Wabaunsee County, Kansas",2009,6804,42.3,3221,548,2673,53414,2.54545454545,0.0805408583186
"Wabaunsee County, Kansas",2012,7048,41.6,3223,581,2642,55817,2.66767600303,0.0824347332577
"Wabaunsee County, Kansas",2015,6997,42.1,3241,573,2668,54688,2.62256371814,0.0818922395312
"Wade Hampton Census Area, Alaska",2009,7577,21.9,2081,422,1659,36712,4.56720916215,0.055694866042
"Wade Hampton Census Area, Alaska",2012,7556,21.8,2176,472,1704,40608,4.43427230047,0.062466913711
"Wadena County, Minnesota",2009,13343,43.3,6749,902,5847,34212,2.28202497007,0.0676009892828
"Wadena County, Minnesota",2012,13808,43.4,6899,1066,5833,35767,2.36722098406,0.077201622248
"Wadena County, Minnesota",2015,13759,43.3,6942,1269,5673,41906,2.42534814031,0.0922305400102
"Wagoner County, Oklahoma",2009,66969,36.9,28845,3143,25702,52536,2.60559489534,0.0469321626424
"Wagoner County, Oklahoma",2012,73067,38,29694,3004,26690,56821,2.73761708505,0.041112951127
"Wagoner County, Oklahoma",2015,75391,38.4,30486,3034,27452,55715,2.74628442372,0.0402435303949
"Wahkiakum County, Washington",2009,3975,50.7,1961,262,1699,39226,2.3396115362,0.0659119496855
"Wahkiakum County, Washington",2012,4003,48.8,1966,267,1699,45335,2.35609181872,0.0666999750187
"Wahkiakum County, Washington",2015,4035,52.1,2054,338,1716,44485,2.3513986014,0.0837670384139
"Wake County, North Carolina",2009,828759,33.8,338667,28387,310280,64008,2.67100360964,0.0342524183749
"Wake County, North Carolina",2012,905573,34.5,371663,30360,341303,65826,2.65328168812,0.0335257345349
"Wake County, North Carolina",2015,976019,35.3,392813,28144,364669,67309,2.67645179601,0.0288355042269
"Wakulla County, Florida",2009,30232,38.9,13139,2183,10956,52353,2.75940124133,0.0722082561524
"Wakulla County, Florida",2012,30449,39.5,12851,2269,10582,53385,2.87743337743,0.0745180465697
"Wakulla County, Florida",2015,31128,40,12841,2150,10691,50340,2.91160789449,0.0690696479054
"Waldo County, Maine",2009,38319,42.7,20341,4802,15539,41697,2.46598880237,0.125316422662
"Waldo County, Maine",2012,38761,44.2,21529,5036,16493,42238,2.35014854787,0.129924408555
"Waldo County, Maine",2015,38976,45,21717,4829,16888,44082,2.30791094268,0.123896756979
"Walker County, Alabama",2009,68880,40,33644,5701,27943,36708,2.4650180725,0.0827671312427
"Walker County, Alabama",2012,67016,41.5,30912,4887,26025,37408,2.57506243996,0.0729228840874
"Walker County, Alabama",2015,65923,42.4,30673,5071,25602,35843,2.57491602219,0.0769230769231
"Walker County, Georgia",2009,64295,38.2,28727,3334,25393,38646,2.53199700705,0.0518547320943
"Walker County, Georgia",2012,68463,39.6,30036,3785,26251,38504,2.60801493276,0.0552853366052
"Walker County, Georgia",2015,68285,40.4,30090,4230,25860,41632,2.6405645785,0.0619462546679
"Walker County, Texas",2009,63928,34.9,23094,3765,19329,34214,3.30736199493,0.0588943811788
"Walker County, Texas",2012,67447,35,24234,4083,20151,38654,3.3470795494,0.06053642119
"Walker County, Texas",2015,69330,35,24844,4159,20685,37666,3.35170413343,0.0599884609837
"Walla Walla County, Washington",2009,57795,36.1,22566,1842,20724,44282,2.78879559931,0.0318712691409
"Walla Walla County, Washington",2012,58643,37,23446,1949,21497,47166,2.72796204122,0.0332349982095
"Walla Walla County, Washington",2015,59726,36.9,23768,2072,21696,47946,2.75285766962,0.0346917590329
"Wallace County, Kansas",2009,1543,46.6,789,162,627,38560,2.46092503987,0.104990278678
"Wallace County, Kansas",2012,1508,45.1,785,186,599,46932,2.51752921536,0.123342175066
"Wallace County, Kansas",2015,1595,41.8,813,188,625,47279,2.552,0.117868338558
"Waller County, Texas",2009,35552,31.5,14034,1553,12481,43865,2.84848970435,0.0436824932493
"Waller County, Texas",2012,42894,32.3,15772,2280,13492,51576,3.17921731396,0.0531542873129
"Waller County, Texas",2015,45847,29.1,16035,2098,13937,51348,3.28958886417,0.0457609003861
"Wallowa County, Oregon",2009,6828,50.3,4071,923,3148,41382,2.16899618806,0.13517867604
"Wallowa County, Oregon",2012,6938,50.8,4101,1121,2980,40204,2.32818791946,0.161573940617
"Wallowa County, Oregon",2015,6857,52.2,4088,1006,3082,40581,2.22485399091,0.146711389821
"Walsh County, North Dakota",2009,11052,44.6,5739,854,4885,42300,2.26243602866,0.0772710821571
"Walsh County, North Dakota",2012,11131,45.6,5537,630,4907,48044,2.26839209293,0.0565986883479
"Walsh County, North Dakota",2015,11005,45.4,5571,642,4929,49411,2.23270440252,0.0583371194911
"Walthall County, Mississippi",2009,15304,36.2,6831,1485,5346,32475,2.86270108492,0.0970334553058
"Walthall County, Mississippi",2012,15405,36.8,7116,1650,5466,32260,2.81833150384,0.107108081792
"Walthall County, Mississippi",2015,14978,39.4,7147,1386,5761,31384,2.59989585141,0.0925357190546
"Walton County, Florida",2009,52528,41.6,40637,19107,21530,46159,2.43975847654,0.363748857752
"Walton County, Florida",2012,55349,43,45064,22545,22519,44254,2.45788001243,0.407324432239
"Walton County, Florida",2015,59487,43.6,46918,23428,23490,44966,2.53243933589,0.393833946913
"Walton County, Georgia",2009,82243,36.2,31218,2715,28503,52160,2.88541557029,0.0330119280668
"Walton County, Georgia",2012,83771,37.4,32400,2688,29712,52062,2.81943322563,0.032087476573
"Walton County, Georgia",2015,86201,38.5,32502,2835,29667,54453,2.90561903799,0.0328882495563
"Walworth County, South Dakota",2009,5312,48.5,3197,917,2280,37804,2.3298245614,0.172628012048
"Walworth County, South Dakota",2012,5443,46.8,3020,742,2278,42711,2.38937664618,0.136321881315
"Walworth County, South Dakota",2015,5495,44.9,2992,603,2389,43221,2.30012557555,0.109736123749
"Walworth County, Wisconsin",2009,100069,37.4,50285,11240,39045,53910,2.56291458573,0.112322497477
"Walworth County, Wisconsin",2012,102310,37.9,51441,12034,39407,54443,2.59623924683,0.117622910761
"Walworth County, Wisconsin",2015,103039,38.9,51651,12003,39648,53445,2.59884483454,0.116489872767
"Wapello County, Iowa",2009,35484,39.5,16390,1401,14989,38619,2.36733604643,0.0394825836997
"Wapello County, Iowa",2012,35449,39.9,16085,1515,14570,41088,2.43301304049,0.0427374538069
"Wapello County, Iowa",2015,35315,39.8,16017,1524,14493,42095,2.43669357621,0.0431544669404
"Ward County, North Dakota",2009,56353,32.5,26087,2121,23966,47683,2.3513727781,0.0376377477685
"Ward County, North Dakota",2012,62013,32.5,27185,2464,24721,53361,2.50851502771,0.0397336042443
"Ward County, North Dakota",2015,67736,31.1,30210,4079,26131,61393,2.59217021928,0.0602190858628
"Ward County, Texas",2009,10297,36.2,4909,1012,3897,40514,2.64228894021,0.0982810527338
"Ward County, Texas",2012,10705,36.5,4703,769,3934,40222,2.7211489578,0.0718355908454
"Ward County, Texas",2015,11225,34.8,4723,840,3883,51345,2.89080607777,0.0748329621381
"Ware County, Georgia",2009,35658,36.9,16521,3086,13435,33545,2.654112393,0.0865443939649
"Ware County, Georgia",2012,36099,37.5,16346,3098,13248,34700,2.72486413043,0.0858195517881
"Ware County, Georgia",2015,35723,37.9,16394,2493,13901,34909,2.56981512121,0.0697869719788
"Warren County, Georgia",2009,5887,43.1,2830,452,2378,32892,2.4756097561,0.076779344318
"Warren County, Georgia",2012,5788,43.2,2971,689,2282,32155,2.53637160386,0.119039391845
"Warren County, Georgia",2015,5561,44.3,2955,830,2125,29176,2.61694117647,0.149253731343
"Warren County, Illinois",2009,17551,40.1,7881,871,7010,38433,2.50370898716,0.0496268018916
"Warren County, Illinois",2012,17723,40,7697,815,6882,41138,2.5752688172,0.0459854426452
"Warren County, Illinois",2015,17701,40.2,7690,861,6829,43699,2.59203397276,0.0486413196995
"Warren County, Indiana",2009,8573,41.3,3829,349,3480,48432,2.46350574713,0.0407092033127
"Warren County, Indiana",2012,8490,42.6,3680,434,3246,51504,2.61552680222,0.0511189634865
"Warren County, Indiana",2015,8367,44.1,3673,368,3305,56042,2.53161875946,0.0439823114617
"Warren County, Iowa",2009,44192,37.9,17183,774,16409,60609,2.69315619477,0.0175144822592
"Warren County, Iowa",2012,46239,38.5,18385,1120,17265,62778,2.67819287576,0.0242219771189
"Warren County, Iowa",2015,47542,38.4,18951,942,18009,64447,2.63990227109,0.0198140591477
"Warren County, Kentucky",2009,104494,32.8,44905,4062,40843,44060,2.5584310653,0.0388730453423
"Warren County, Kentucky",2012,113787,32.7,47392,3591,43801,43509,2.59781740143,0.0315589654354
"Warren County, Kentucky",2015,118950,32.8,49133,3746,45387,44911,2.62079450063,0.0314922236234
"Warren County, Mississippi",2009,48596,35.7,21466,2194,19272,38917,2.52158572022,0.0451477487859
"Warren County, Mississippi",2012,48419,37.9,21871,3169,18702,40876,2.58897444124,0.0654495136207
"Warren County, Mississippi",2015,48020,37.9,21872,3457,18415,41121,2.60765680152,0.0719908371512
"Warren County, Missouri",2009,30249,38.3,13839,2280,11559,49722,2.61692187906,0.0753743925419
"Warren County, Missouri",2012,32440,39.7,14696,2048,12648,47877,2.56483238457,0.0631319358816
"Warren County, Missouri",2015,33043,40.2,14893,2942,11951,51133,2.76487323237,0.089035499198
"Warren County, New Jersey",2009,109567,40.3,45268,2892,42376,69767,2.58559090051,0.0263948086559
"Warren County, New Jersey",2012,108488,41.4,45033,3395,41638,73056,2.60550458716,0.0312937836443
"Warren County, New Jersey",2015,107226,42.6,45266,3599,41667,70471,2.57340341277,0.0335646205211
"Warren County, New York",2009,65743,42.5,37467,10042,27425,50168,2.39719234275,0.152746299986
"Warren County, New York",2012,65700,44.2,38691,10176,28515,54909,2.30405049974,0.154885844749
"Warren County, New York",2015,65180,45.2,38928,12140,26788,56798,2.43317903539,0.186253451979
"Warren County, North Carolina",2009,19545,42.6,11391,3797,7594,27876,2.57374242823,0.194269634178
"Warren County, North Carolina",2012,20860,45.1,11786,4235,7551,34803,2.76254800689,0.203020134228
"Warren County, North Carolina",2015,20468,46.1,11750,3933,7817,34254,2.61839580402,0.192153605628
"Warren County, Ohio",2009,203129,36.8,75378,4432,70946,70939,2.8631494376,0.0218186472636
"Warren County, Ohio",2012,213146,37.5,80726,4851,75875,72055,2.80917298188,0.0227590477888
"Warren County, Ohio",2015,219916,38.7,82922,4563,78359,74379,2.80651871514,0.020748831372
"Warren County, Pennsylvania",2009,41025,44.4,23484,5755,17729,40160,2.31400530205,0.14028031688
"Warren County, Pennsylvania",2012,41613,45.1,23527,6074,17453,43108,2.38428923394,0.145964001634
"Warren County, Pennsylvania",2015,40962,46.2,23428,6315,17113,44020,2.39361888623,0.154167276988
"Warren County, Tennessee",2009,39915,38.3,17475,2489,14986,34261,2.66348592019,0.0623575097081
"Warren County, Tennessee",2012,39767,38.7,17784,2452,15332,34008,2.59372554135,0.061659164634
"Warren County, Tennessee",2015,40015,39.7,17825,2164,15661,35376,2.55507311155,0.054079720105
"Warren County, Virginia",2009,36087,38.6,15294,1656,13638,59630,2.6460624725,0.0458891013384
"Warren County, Virginia",2012,37567,39.8,15955,1606,14349,61693,2.61809185309,0.0427502861554
"Warren County, Virginia",2015,38481,40.4,16099,1735,14364,61454,2.67898913952,0.0450871858839
"Warrick County, Indiana",2009,57065,39.7,24066,1843,22223,60553,2.56783512577,0.0322965039867
"Warrick County, Indiana",2012,59643,39.5,24259,1853,22406,61948,2.66192091404,0.0310681890582
"Warrick County, Indiana",2015,60995,40.6,24727,1844,22883,62185,2.66551588515,0.0302319862284
"Wasatch County, Utah",2009,20318,31.6,9098,2474,6624,62030,3.06733091787,0.121763953145
"Wasatch County, Utah",2012,23661,31.9,10619,3247,7372,65012,3.20957677699,0.137230040996
"Wasatch County, Utah",2015,26661,33,11352,3257,8095,66486,3.29351451513,0.122163459735
"Wasco County, Oregon",2009,23732,42.8,10828,1546,9282,41307,2.55677655678,0.0651441092196
"Wasco County, Oregon",2012,25113,41.8,11430,1682,9748,43601,2.57622076323,0.0669772627723
"Wasco County, Oregon",2015,25492,41,11423,1719,9704,43422,2.62695795548,0.0674329201318
"Waseca County, Minnesota",2009,19241,38.6,7885,603,7282,49971,2.64226860753,0.0313393274778
"Waseca County, Minnesota",2012,19089,39.3,7909,542,7367,53433,2.59114972173,0.028393315522
"Waseca County, Minnesota",2015,19076,39,7895,570,7325,53564,2.60423208191,0.0298804780876
"Washakie County, Wyoming",2009,7791,42.5,3705,347,3358,47778,2.32013103038,0.044538570145
"Washakie County, Wyoming",2012,8425,41.6,3821,382,3439,44519,2.44984006979,0.0453412462908
"Washakie County, Wyoming",2015,8400,43.4,3819,307,3512,47652,2.39179954442,0.0365476190476
"Washburn County, Wisconsin",2009,16583,46.4,11792,4386,7406,41518,2.23913043478,0.264487728397
"Washburn County, Wisconsin",2012,15893,47.6,12779,5369,7410,40892,2.14480431849,0.337821682502
"Washburn County, Wisconsin",2015,15700,49.2,13022,5881,7141,42368,2.19857162862,0.374585987261
"Washington County, Alabama",2009,17212,39.2,8426,1792,6634,34738,2.59451311426,0.104113409249
"Washington County, Alabama",2012,17407,39.5,8407,1712,6695,42256,2.6,0.0983512380077
"Washington County, Alabama",2015,16997,40.9,8371,2238,6133,42811,2.7714006196,0.131670294758
"Washington County, Arkansas",2009,193353,30.9,81599,8078,73521,43317,2.62990166075,0.0417785087379
"Washington County, Arkansas",2012,204057,31.1,87458,9771,77687,41429,2.62665568242,0.0478836795601
"Washington County, Arkansas",2015,216432,31.2,89331,7609,81722,43524,2.6483933335,0.0351565387743
"Washington County, Colorado",2009,4647,44,2480,342,2138,38818,2.17352666043,0.0735958683021
"Washington County, Colorado",2012,4796,44.2,2418,345,2073,43925,2.31355523396,0.0719349457882
"Washington County, Colorado",2015,4795,44.4,2422,459,1963,45541,2.44268976057,0.095724713243
"Washington County, Florida",2009,22997,41.2,10145,1845,8300,35090,2.77072289157,0.0802278558073
"Washington County, Florida",2012,24732,40.8,10755,2166,8589,38536,2.87949703109,0.0875788452208
"Washington County, Florida",2015,24629,40.9,10700,2454,8246,38970,2.9867814698,0.0996386373787
"Washington County, Georgia",2009,20608,38.2,8618,1392,7226,31178,2.85192360919,0.0675465838509
"Washington County, Georgia",2012,21092,39.2,9020,1913,7107,31441,2.9677782468,0.0906978949365
"Washington County, Georgia",2015,20785,40,9040,1810,7230,37932,2.87482710927,0.0870820303103
"Washington County, Idaho",2009,10011,42.1,4355,329,4026,35897,2.48658718331,0.0328638497653
"Washington County, Idaho",2012,10144,44,4527,533,3994,36311,2.53980971457,0.0525433753943
"Washington County, Idaho",2015,10025,44.9,4537,725,3812,34775,2.62985309549,0.072319201995
"Washington County, Illinois",2009,14725,40.9,6723,482,6241,52527,2.35939753245,0.0327334465195
"Washington County, Illinois",2012,14692,42.4,6551,527,6024,54407,2.43891102258,0.0358698611489
"Washington County, Illinois",2015,14457,42.6,6575,798,5777,53202,2.50250995326,0.055198173895
"Washington County, Indiana",2009,27780,38.1,12038,1210,10828,38123,2.56557074252,0.0435565154788
"Washington County, Indiana",2012,28162,39,12211,1454,10757,41125,2.61801617551,0.0516298558341
"Washington County, Indiana",2015,27930,40.7,12188,1646,10542,41289,2.64940239044,0.058933046903
"Washington County, Iowa",2009,21152,40.9,8918,580,8338,50201,2.53681938115,0.0274205748865
"Washington County, Iowa",2012,21765,41.9,9479,553,8926,52636,2.43838225409,0.0254077647599
"Washington County, Iowa",2015,22017,41.5,9529,591,8938,56390,2.46330275229,0.0268428941273
"Washington County, Kansas",2009,5821,46.6,3205,525,2680,37184,2.17201492537,0.0901906888851
"Washington County, Kansas",2012,5806,46,2973,500,2473,42962,2.34775576223,0.0861178091629
"Washington County, Kansas",2015,5686,46.3,2956,514,2442,45159,2.32841932842,0.0903974674639
"Washington County, Kentucky",2009,11365,38.7,4721,604,4117,42995,2.76050522225,0.0531456225253
"Washington County, Kentucky",2012,11701,40.9,5033,492,4541,39748,2.57674521031,0.0420476882318
"Washington County, Kentucky",2015,11910,41.5,5077,582,4495,40976,2.64961067853,0.0488664987406
"Washington County, Maine",2009,32590,44.1,22884,8628,14256,34203,2.28605499439,0.264743786438
"Washington County, Maine",2012,32832,45.9,23019,8923,14096,36486,2.32917139614,0.271777534113
"Washington County, Maine",2015,32191,46.8,23013,8874,14139,38083,2.27675224556,0.275667111926
"Washington County, Maryland",2009,144158,38.6,60054,4530,55524,51962,2.59631870903,0.031423854382
"Washington County, Maryland",2012,147882,39.8,60841,5043,55798,54561,2.65031004696,0.0341015133688
"Washington County, Maryland",2015,149270,40.4,61111,5044,56067,56228,2.6623504022,0.0337911167683
"Washington County, Minnesota",2009,225551,37.2,88485,4032,84453,78714,2.67072809728,0.0178762231158
"Washington County, Minnesota",2012,238721,38.2,92674,4458,88216,80747,2.70609639975,0.0186745196275
"Washington County, Minnesota",2015,246670,38.9,94934,4002,90932,83706,2.71268640303,0.0162241050797
"Washington County, Mississippi",2009,55811,33.9,25147,3956,21191,27588,2.63371242509,0.070882084177
"Washington County, Mississippi",2012,51010,35.2,21861,3466,18395,27610,2.77303615113,0.0679474612821
"Washington County, Mississippi",2015,49499,36.2,21650,3457,18193,29144,2.72077172539,0.0698397947433
"Washington County, Missouri",2009,24230,37.6,10363,1748,8615,35510,2.81253627394,0.072141972761
"Washington County, Missouri",2012,25120,40.1,10953,1732,9221,34015,2.72421646242,0.068949044586
"Washington County, Missouri",2015,25048,40.1,10897,1915,8982,35305,2.78868848809,0.0764532098371
"Washington County, Nebraska",2009,19724,39.7,8075,768,7307,60870,2.69932941015,0.0389373352261
"Washington County, Nebraska",2012,20201,41,8292,696,7596,65803,2.65942601369,0.0344537399139
"Washington County, Nebraska",2015,20257,41.2,8372,338,8034,65370,2.5214090117,0.0166855901664
"Washington County, New York",2009,62486,40.9,28395,3995,24400,46886,2.56090163934,0.063934321288
"Washington County, New York",2012,63108,42.2,28802,4212,24590,50864,2.56640910939,0.0667427267541
"Washington County, New York",2015,62700,42.9,28994,4757,24237,51143,2.58695383092,0.0758692185008
"Washington County, North Carolina",2009,12979,42.8,6292,1356,4936,32845,2.62945705024,0.104476461977
"Washington County, North Carolina",2012,13085,43.6,6470,1374,5096,33718,2.56770015699,0.105005731754
"Washington County, North Carolina",2015,12668,45.1,6455,1239,5216,34538,2.4286809816,0.0978054941585
"Washington County, Ohio",2009,61461,41.3,28064,2898,25166,40727,2.44222363506,0.0471518523942
"Washington County, Ohio",2012,61751,42.7,28323,3348,24975,43829,2.47251251251,0.0542177454616
"Washington County, Ohio",2015,61351,43.6,28124,3060,25064,43509,2.44777369933,0.0498769376212
"Washington County, Oklahoma",2009,49793,40.7,22993,2259,20734,43779,2.40151442076,0.0453678227863
"Washington County, Oklahoma",2012,51112,41,23437,1995,21442,47959,2.38373286074,0.0390319298795
"Washington County, Oklahoma",2015,51760,40.5,23616,2615,21001,50023,2.46464454074,0.0505216383308
"Washington County, Oregon",2009,518002,34.5,203503,12113,191390,62218,2.70652594179,0.0233840795981
"Washington County, Oregon",2012,531818,35.4,212386,12226,200160,64375,2.65696442846,0.0229890676886
"Washington County, Oregon",2015,556210,36.1,217085,10659,206426,66754,2.69447647099,0.0191636252495
"Washington County, Pennsylvania",2009,206037,42.7,92165,8557,83608,49354,2.46432159602,0.0415313754326
"Washington County, Pennsylvania",2012,207916,43.5,92991,8868,84123,53326,2.47157138951,0.0426518401662
"Washington County, Pennsylvania",2015,208226,44.2,93643,9904,83739,56450,2.48660719617,0.0475637048207
"Washington County, Rhode Island",2009,127064,41.4,60831,11892,48939,69828,2.59637507918,0.0935906314928
"Washington County, Rhode Island",2012,126692,41.9,62206,12858,49348,72391,2.56731782443,0.10149022827
"Washington County, Rhode Island",2015,126405,43.3,62722,13158,49564,72807,2.55033895569,0.104093983624
"Washington County, Tennessee",2009,116750,38.6,52815,6139,46676,41107,2.50128545719,0.0525824411135
"Washington County, Tennessee",2012,122840,39.6,57143,5883,51260,42995,2.3964104565,0.0478915662651
"Washington County, Tennessee",2015,125317,39.8,58443,5805,52638,42817,2.38073255063,0.0463225260739
"Washington County, Texas",2009,32152,38.8,14101,1879,12222,43791,2.63066601211,0.058441154516
"Washington County, Texas",2012,33628,41.1,15451,3172,12279,44162,2.73865949996,0.0943261567741
"Washington County, Texas",2015,34236,42,15667,3715,11952,51269,2.86445783133,0.108511508354
"Washington County, Utah",2009,130258,31.8,53856,9547,44309,48728,2.93976393058,0.0732930031169
"Washington County, Utah",2012,139484,32.5,57996,11470,46526,49145,2.9979796243,0.0822316538098
"Washington County, Utah",2015,148244,34.6,61026,12106,48920,50774,3.03033524121,0.0816626642562
"Washington County, Vermont",2009,58788,41.2,29155,4880,24275,54227,2.4217507724,0.0830101381234
"Washington County, Vermont",2012,59462,42.5,29905,5199,24706,57276,2.40678377722,0.0874339914567
"Washington County, Vermont",2015,59132,43.2,30076,5564,24512,58788,2.4123694517,0.094094568085
"Washington County, Virginia",2009,52547,42.3,25028,2551,22477,40431,2.33781198559,0.0485470150532
"Washington County, Virginia",2012,54691,43.2,25574,2661,22913,42844,2.38689826736,0.0486551717833
"Washington County, Virginia",2015,54759,44.7,25704,3031,22673,43310,2.41516341022,0.0553516316952
"Washington County, Wisconsin",2009,128046,39.6,53035,2319,50716,64694,2.52476536004,0.0181106789747
"Washington County, Wisconsin",2012,131840,40.9,54703,2822,51881,66485,2.54120005397,0.0214047330097
"Washington County, Wisconsin",2015,132921,42.1,55303,2406,52897,69237,2.51282681438,0.0181009772722
"Washington Parish, Louisiana",2009,44844,37,20335,3211,17124,30340,2.61878065872,0.0716037819998
"Washington Parish, Louisiana",2012,47025,38.8,21031,3611,17420,30490,2.69948335247,0.0767889420521
"Washington Parish, Louisiana",2015,46556,39.2,21232,3628,17604,30705,2.64462622131,0.0779276570152
"Washita County, Oklahoma",2009,11573,40,5546,1071,4475,41294,2.5861452514,0.0925429879893
"Washita County, Oklahoma",2012,11616,39.3,5469,894,4575,45417,2.53901639344,0.0769628099174
"Washita County, Oklahoma",2015,11649,38.8,5469,829,4640,49632,2.51056034483,0.071164906859
"Washoe County, Nevada",2009,404495,36.1,176075,19648,156427,55525,2.58583876185,0.0485741480117
"Washoe County, Nevada",2012,422010,37,184432,22540,161892,53994,2.60673782522,0.05341105661
"Washoe County, Nevada",2015,435019,37.6,186481,20136,166345,52870,2.61516126123,0.0462876334137
"Washtenaw County, Michigan",2009,346007,32.5,146606,12681,133925,58807,2.58358782901,0.0366495475525
"Washtenaw County, Michigan",2012,346010,33.1,147576,12693,134883,59063,2.5652602626,0.0366839108696
"Washtenaw County, Michigan",2015,354092,33.4,149098,11031,138067,61003,2.5646389072,0.0311529207099
"Watauga County, North Carolina",2009,44636,27.8,27025,8528,18497,33801,2.41314807807,0.191056546286
"Watauga County, North Carolina",2012,51103,28.1,31907,10930,20977,34848,2.43614434857,0.213881768194
"Watauga County, North Carolina",2015,52240,29.5,32737,12741,19996,37656,2.6125225045,0.243893568147
"Watonwan County, Minnesota",2009,11019,42,5144,647,4497,43535,2.45030020013,0.0587167619566
"Watonwan County, Minnesota",2012,11177,40.4,5043,580,4463,49210,2.50436925835,0.0518922787868
"Watonwan County, Minnesota",2015,11054,39.6,5033,583,4450,50604,2.48404494382,0.0527410891985
"Waukesha County, Wisconsin",2009,378848,41.1,155433,7185,148248,74466,2.55550159193,0.0189653898133
"Waukesha County, Wisconsin",2012,389740,42.2,160639,7644,152995,75689,2.54740350992,0.0196130753836
"Waukesha County, Wisconsin",2015,393873,42.8,162095,7104,154991,76545,2.54126368628,0.0180362705745
"Waupaca County, Wisconsin",2009,51914,42.3,24506,3251,21255,47374,2.44243707363,0.0626227992449
"Waupaca County, Wisconsin",2012,52377,43.4,25343,3956,21387,49777,2.4490110815,0.0755293353953
"Waupaca County, Wisconsin",2015,52125,44.4,25478,3946,21532,51994,2.42081553037,0.0757026378897
"Waushara County, Wisconsin",2009,24660,43.8,14943,4563,10380,43137,2.37572254335,0.18503649635
"Waushara County, Wisconsin",2012,24565,46.3,14849,4886,9963,43582,2.46562280438,0.198900875229
"Waushara County, Wisconsin",2015,24321,47.9,14898,5209,9689,45166,2.51016616782,0.214177048641
"Wayne County, Georgia",2009,28954,36.3,11137,1566,9571,38457,3.02518023195,0.0540857912551
"Wayne County, Georgia",2012,30157,37.6,12130,2010,10120,36496,2.97994071146,0.0666511920947
"Wayne County, Georgia",2015,30046,37.3,12125,2059,10066,38955,2.98489966223,0.0685282566731
"Wayne County, Illinois",2009,16505,42.4,8257,799,7458,37128,2.21305980156,0.0484095728567
"Wayne County, Illinois",2012,16727,42.6,7975,849,7126,41446,2.34731967443,0.0507562623304
"Wayne County, Illinois",2015,16555,42.4,7905,862,7043,44993,2.35056084055,0.0520688613712
"Wayne County, Indiana",2009,68151,40.1,31119,3420,27699,40956,2.46041373335,0.0501826825725
"Wayne County, Indiana",2012,68797,40.5,31283,3081,28202,39131,2.43943691937,0.0447839295318
"Wayne County, Indiana",2015,67866,40.9,31215,4047,27168,38494,2.49801236749,0.0596322164265
"Wayne County, Iowa",2009,6329,45.2,3388,450,2938,35332,2.15418652144,0.071101279823
"Wayne County, Iowa",2012,6372,45.4,3204,553,2651,38447,2.40362127499,0.0867859384809
"Wayne County, Iowa",2015,6384,44.5,3196,600,2596,43358,2.45916795069,0.093984962406
"Wayne County, Kentucky",2009,20575,39,10028,1955,8073,26513,2.54861885297,0.0950182260024
"Wayne County, Kentucky",2012,20819,40.9,10877,2581,8296,27646,2.50952266152,0.123973293626
"Wayne County, Kentucky",2015,20655,42,10860,2943,7917,28573,2.60894278136,0.142483660131
"Wayne County, Michigan",2009,1977997,36.2,837785,128486,709299,42232,2.78866458292,0.0649576313816
"Wayne County, Michigan",2012,1822469,37.2,821990,147727,674263,41504,2.70290524617,0.0810587175968
"Wayne County, Michigan",2015,1778969,37.8,817593,150318,667275,41210,2.66602075606,0.084497256557
"Wayne County, Mississippi",2009,20892,36,9474,815,8659,30375,2.41274974015,0.0390101474249
"Wayne County, Mississippi",2012,20754,37.5,9234,938,8296,30783,2.50168756027,0.0451961067746
"Wayne County, Mississippi",2015,20564,36.7,9210,1580,7630,32557,2.69515072084,0.0768333009142
"Wayne County, Missouri",2009,12593,44.9,7870,2275,5595,28315,2.25075960679,0.180655919956
"Wayne County, Missouri",2012,13444,45.9,8060,2400,5660,30427,2.37526501767,0.178518298126
"Wayne County, Missouri",2015,13397,46.7,8001,2548,5453,33750,2.45681276362,0.190191833993
"Wayne County, Nebraska",2009,9334,24.9,3744,466,3278,43956,2.84746796827,0.0499250053568
"Wayne County, Nebraska",2012,9542,29.4,3773,455,3318,46612,2.87582881254,0.0476839237057
"Wayne County, Nebraska",2015,9425,30.1,3811,311,3500,54159,2.69285714286,0.0329973474801
"Wayne County, New York",2009,91658,40.6,40126,4078,36048,52351,2.54266533511,0.0444914791944
"Wayne County, New York",2012,93476,41.8,40976,4330,36646,53497,2.5507831687,0.0463220505798
"Wayne County, New York",2015,92416,43.1,41386,4910,36476,50798,2.53361114157,0.0531293282548
"Wayne County, North Carolina",2009,113290,36,50958,6107,44851,40325,2.52591915453,0.053905905199
"Wayne County, North Carolina",2012,122419,36.7,52870,5388,47482,41233,2.57821911461,0.0440127757946
"Wayne County, North Carolina",2015,124355,36.7,53141,5611,47530,40390,2.61634756996,0.045120823449
"Wayne County, Ohio",2009,113828,37.6,45707,2882,42825,48474,2.65798015178,0.0253189022033
"Wayne County, Ohio",2012,114644,38.4,45826,3472,42354,49241,2.70680455211,0.0302850563483
"Wayne County, Ohio",2015,115371,38.8,45939,3029,42910,50383,2.68867396877,0.0262544313562
"Wayne County, Pennsylvania",2009,51233,43.8,32866,12256,20610,44194,2.48583212033,0.239220814709
"Wayne County, Pennsylvania",2012,52299,45.6,31741,12525,19216,50153,2.72163821815,0.239488326737
"Wayne County, Pennsylvania",2015,51642,46.5,31847,12541,19306,49919,2.67491971408,0.242844971148
"Wayne County, Tennessee",2009,16592,39.6,7109,1287,5822,31697,2.8498797664,0.0775675024108
"Wayne County, Tennessee",2012,17015,41.7,7273,1217,6056,35377,2.80961030383,0.0715251248898
"Wayne County, Tennessee",2015,16897,42.2,7251,1284,5967,30701,2.83174124351,0.0759898206782
"Wayne County, Utah",2009,2502,40.8,1451,499,952,45040,2.6281512605,0.199440447642
"Wayne County, Utah",2012,2756,36.9,1586,599,987,44821,2.79229989868,0.217343976778
"Wayne County, Utah",2015,2722,40.3,1613,641,972,40645,2.80041152263,0.235488611315
"Wayne County, West Virginia",2009,41496,39.9,19646,2680,16966,34814,2.44583284215,0.0645845382687
"Wayne County, West Virginia",2012,42273,41.7,19267,2484,16783,36575,2.51879878448,0.0587609112199
"Wayne County, West Virginia",2015,41499,42.5,19245,2554,16691,36318,2.48630998742,0.0615436516543
"Waynesboro city, Virginia",2009,21699,39.5,9475,746,8729,40809,2.48585175851,0.0343794644915
"Waynesboro city, Virginia",2012,21030,38.2,9710,976,8734,43884,2.40783146325,0.0464098906324
"Waynesboro city, Virginia",2015,21150,38.5,9868,837,9031,45643,2.34193334072,0.0395744680851
"Weakley County, Tennessee",2009,33389,37.9,15741,1881,13860,33506,2.40901875902,0.0563359190152
"Weakley County, Tennessee",2012,34802,36.8,15486,1584,13902,35509,2.50338080852,0.0455146255962
"Weakley County, Tennessee",2015,34415,36.9,15517,1839,13678,37037,2.51608422284,0.0534360017434
"Webb County, Texas",2009,231035,26.5,68742,6190,62552,35964,3.6934870188,0.0267924773303
"Webb County, Texas",2012,250320,27.8,73548,6545,67003,38421,3.73595212155,0.0261465324385
"Webb County, Texas",2015,263251,28.3,76731,7063,69668,38862,3.77865016937,0.0268299075787
"Weber County, Utah",2009,221981,30.5,81297,6276,75021,53471,2.95891816958,0.028272690005
"Weber County, Utah",2012,230940,30.9,86038,6437,79601,54923,2.90121983392,0.0278730406166
"Weber County, Utah",2015,238682,31.8,87515,7378,80137,56581,2.97842444813,0.0309114218919
"Webster County, Georgia",2009,2203,40.1,1144,259,885,25030,2.48926553672,0.117566954153
"Webster County, Georgia",2012,2773,45.6,1516,293,1223,29926,2.26737530662,0.10566173819
"Webster County, Georgia",2015,2720,41,1392,330,1062,37063,2.56120527307,0.121323529412
"Webster County, Iowa",2009,38458,38.6,17273,1250,16023,40772,2.4001747488,0.0325029902751
"Webster County, Iowa",2012,37895,40,17039,1231,15808,41751,2.39720394737,0.0324844966354
"Webster County, Iowa",2015,37295,39.7,17006,1851,15155,42408,2.46090399208,0.049631317871
"Webster County, Kentucky",2009,13829,40.2,6490,990,5500,37519,2.51436363636,0.0715886904331
"Webster County, Kentucky",2012,13618,39.7,5963,968,4995,41138,2.72632632633,0.0710823909532
"Webster County, Kentucky",2015,13357,39.7,5934,805,5129,38917,2.60421134724,0.0602680242569
"Webster County, Mississippi",2009,9834,39.7,4557,839,3718,31533,2.6449704142,0.0853162497458
"Webster County, Mississippi",2012,10162,40.5,4804,772,4032,35391,2.52033730159,0.0759692973824
"Webster County, Mississippi",2015,9999,41.1,4806,762,4044,34448,2.47255192878,0.0762076207621
"Webster County, Missouri",2009,35635,36,13284,1020,12264,39478,2.90565883888,0.0286235442683
"Webster County, Missouri",2012,36183,37.6,14359,1537,12822,42384,2.82194665419,0.0424785120084
"Webster County, Missouri",2015,36690,38.1,14468,1583,12885,44451,2.84749708964,0.0431452711911
"Webster County, Nebraska",2009,3555,48.4,1632,353,1279,37386,2.77951524629,0.0992967651195
"Webster County, Nebraska",2012,3773,47.5,1925,361,1564,39722,2.41240409207,0.0956798303737
"Webster County, Nebraska",2015,3697,47.5,1909,357,1552,40256,2.38208762887,0.0965647822559
"Webster County, West Virginia",2009,9510,43.3,5475,1259,4216,28691,2.25569259962,0.132386961094
"Webster County, West Virginia",2012,9158,44.7,5442,1327,4115,25634,2.2255164034,0.144900633326
"Webster County, West Virginia",2015,8927,46.3,5412,1525,3887,29086,2.29662979161,0.170830066092
"Webster Parish, Louisiana",2009,40719,39.5,20020,3066,16954,35145,2.40173410405,0.0752965446106
"Webster Parish, Louisiana",2012,41156,40.4,19366,2999,16367,35896,2.51457200464,0.0728690834872
"Webster Parish, Louisiana",2015,40617,40.9,19421,3656,15765,33681,2.57640342531,0.0900115715095
"Weld County, Colorado",2009,241221,32,91616,8329,83287,55795,2.89626232185,0.0345285029081
"Weld County, Colorado",2012,253552,33.2,96351,6798,89553,56589,2.83130660056,0.026811068341
"Weld County, Colorado",2015,270948,33.9,99226,4932,94294,60572,2.87343839481,0.0182027547721
"Wells County, Indiana",2009,27720,39.8,11674,811,10863,47161,2.55178127589,0.0292568542569
"Wells County, Indiana",2012,27677,40.3,11681,874,10807,49841,2.5610252614,0.0315785670412
"Wells County, Indiana",2015,27796,41.2,11684,853,10831,51101,2.56633736497,0.0306878687581
"Wells County, North Dakota",2009,4251,48.9,2610,472,2138,38209,1.98830682881,0.111032698189
"Wells County, North Dakota",2012,4228,51.4,2472,489,1983,41982,2.13212304589,0.115657521287
"Wells County, North Dakota",2015,4204,51,2508,500,2008,48098,2.09362549801,0.11893434824
"West Baton Rouge Parish, Louisiana",2009,22323,35.2,9443,745,8698,46485,2.56645205794,0.033373650495
"West Baton Rouge Parish, Louisiana",2012,23748,35.8,9372,672,8700,50788,2.72965517241,0.0282971197575
"West Baton Rouge Parish, Louisiana",2015,24669,35.4,9873,694,9179,53703,2.68754766314,0.0281324739552
"West Carroll Parish, Louisiana",2009,11520,39.7,5236,1027,4209,34649,2.73699215966,0.0891493055556
"West Carroll Parish, Louisiana",2012,11587,40.1,5067,888,4179,33665,2.77267288825,0.0766376111159
"West Carroll Parish, Louisiana",2015,11454,39.7,5065,769,4296,31926,2.66620111732,0.0671381176881
"West Feliciana Parish, Louisiana",2009,15134,39.8,5047,750,4297,43348,3.5219920875,0.0495572882252
"West Feliciana Parish, Louisiana",2012,15575,42.2,5106,1115,3991,58212,3.90253069406,0.0715890850722
"West Feliciana Parish, Louisiana",2015,15415,40.4,5214,1303,3911,56685,3.9414472002,0.0845280570873
"Westchester County, New York",2009,949050,39.4,360130,21603,338527,79585,2.80346914722,0.0227627627628
"Westchester County, New York",2012,950227,40.1,370133,25258,344875,81093,2.75527944908,0.026581016957
"Westchester County, New York",2015,967315,40.3,370032,28166,341866,83958,2.82951507316,0.0291177124308
"Westmoreland County, Pennsylvania",2009,363222,44,166338,14402,151936,46760,2.390625,0.0396506819521
"Westmoreland County, Pennsylvania",2012,364877,45.1,168159,15095,153064,49734,2.38381984007,0.0413701055424
"Westmoreland County, Pennsylvania",2015,361251,46.1,168250,17077,151173,52247,2.38965291421,0.047271841462
"Westmoreland County, Virginia",2009,17303,45,10519,3162,7357,50151,2.35190974582,0.182742876958
"Westmoreland County, Virginia",2012,17468,46.5,10625,3548,7077,48672,2.46827751872,0.203114266087
"Westmoreland County, Virginia",2015,17557,46.6,10752,3808,6944,47911,2.52836981567,0.216893546733
"Weston County, Wyoming",2009,6765,43.6,3342,425,2917,53267,2.31916352417,0.0628233555063
"Weston County, Wyoming",2012,7152,41.7,3522,564,2958,53802,2.41784989858,0.0788590604027
"Weston County, Wyoming",2015,7152,42.1,3506,520,2986,57738,2.39517749498,0.072706935123
"Wetzel County, West Virginia",2009,16507,43.4,8417,1346,7071,36021,2.33446471503,0.0815411643545
"Wetzel County, West Virginia",2012,16526,44.9,8186,1206,6980,37897,2.3676217765,0.0729759167373
"Wetzel County, West Virginia",2015,16157,46,8154,1629,6525,39096,2.47616858238,0.100823172619
"Wexford County, Michigan",2009,31624,39.8,16342,3745,12597,40232,2.51043899341,0.118422716924
"Wexford County, Michigan",2012,32694,40.8,16740,4435,12305,40660,2.65696871191,0.135651801554
"Wexford County, Michigan",2015,32751,41.7,16690,4017,12673,41534,2.5843131066,0.122652743428
"Wharton County, Texas",2009,40919,36.7,17398,2400,14998,42695,2.72829710628,0.0586524597375
"Wharton County, Texas",2012,41153,37.3,17154,2516,14638,40988,2.81138133625,0.0611377056351
"Wharton County, Texas",2015,41264,37.3,17288,2547,14741,45176,2.79926734957,0.0617245056223
"Whatcom County, Washington",2009,192886,35.8,86230,10455,75775,47812,2.54550973276,0.0542030007362
"Whatcom County, Washington",2012,201404,36.5,90559,11315,79244,51639,2.54156781586,0.056180612103
"Whatcom County, Washington",2015,207100,36.5,91911,12144,79767,53145,2.596311758,0.0586383389667
"Wheatland County, Montana",2009,2018,51.3,1371,473,898,30375,2.24721603563,0.234390485629
"Wheatland County, Montana",2012,2142,48.5,1307,512,795,31496,2.69433962264,0.239028944911
"Wheatland County, Montana",2015,2115,46.5,1343,458,885,32723,2.38983050847,0.216548463357
"Wheeler County, Georgia",2009,6819,37.6,2155,375,1780,35625,3.8308988764,0.0549934007919
"Wheeler County, Georgia",2012,7572,36.6,2612,584,2028,27601,3.73372781065,0.0771262546223
"Wheeler County, Georgia",2015,7956,38.4,2590,578,2012,27620,3.95427435388,0.0726495726496
"Wheeler County, Nebraska",2009,741,44.1,553,227,326,42955,2.27300613497,0.306342780027
"Wheeler County, Nebraska",2012,725,47.3,581,252,329,39602,2.20364741641,0.347586206897
"Wheeler County, Nebraska",2015,847,47.8,563,174,389,46394,2.17737789203,0.205430932704
"Wheeler County, Oregon",2009,1346,55,878,250,628,32339,2.14331210191,0.18573551263
"Wheeler County, Oregon",2012,1287,56,882,256,626,36357,2.05591054313,0.198912198912
"Wheeler County, Oregon",2015,1348,56.5,935,264,671,33487,2.00894187779,0.195845697329
"Wheeler County, Texas",2009,4763,41.5,2568,481,2087,40603,2.28222328701,0.100986773042
"Wheeler County, Texas",2012,5414,40.5,2715,361,2354,49615,2.29991503823,0.0666789804211
"Wheeler County, Texas",2015,5618,39,2709,416,2293,52221,2.45006541648,0.0740477038092
"White County, Arkansas",2009,73838,35.7,30154,2396,27758,38417,2.66006196412,0.0324494162897
"White County, Arkansas",2012,77007,36.1,32356,2717,29639,41410,2.59816458045,0.0352825067851
"White County, Arkansas",2015,78660,36.2,32970,3566,29404,42554,2.67514623861,0.0453343503687
"White County, Georgia",2009,24702,41.3,11804,2127,9677,42295,2.55265061486,0.0861063881467
"White County, Georgia",2012,27141,43.2,15765,3611,12154,40720,2.23309198618,0.133045945249
"White County, Georgia",2015,27791,43.9,16001,4685,11316,40888,2.45590314599,0.168579756036
"White County, Illinois",2009,14772,43.5,7647,925,6722,40070,2.19756024993,0.0626184673707
"White County, Illinois",2012,14686,44.5,7202,945,6257,43151,2.34713121304,0.0643469971401
"White County, Illinois",2015,14464,44.5,7129,958,6171,44648,2.34386647221,0.0662334070796
"White County, Indiana",2009,23840,40.9,12910,2878,10032,43979,2.37639553429,0.12072147651
"White County, Indiana",2012,24612,42.2,12969,3368,9601,48940,2.56348297052,0.136843816025
"White County, Indiana",2015,24388,42,12964,3451,9513,52154,2.56364974246,0.14150401837
"White County, Tennessee",2009,24897,40.6,10704,1389,9315,32678,2.67278582931,0.0557898541993
"White County, Tennessee",2012,25863,41.4,11465,1730,9735,34717,2.65670261941,0.06689092526
"White County, Tennessee",2015,26252,42.5,11572,1841,9731,34901,2.69777001336,0.0701279902484
"White Pine County, Nevada",2009,9060,41.9,4503,903,3600,46148,2.51666666667,0.0996688741722
"White Pine County, Nevada",2012,9967,42,4495,1016,3479,46505,2.86490370796,0.101936390087
"White Pine County, Nevada",2015,9974,39.4,4453,1266,3187,57122,3.12958895513,0.126930018047
"Whiteside County, Illinois",2009,59059,41.1,25608,1777,23831,43719,2.47824262515,0.0300885555123
"Whiteside County, Illinois",2012,58400,42,25742,2352,23390,46193,2.4967935015,0.0402739726027
"Whiteside County, Illinois",2015,57525,42.7,25750,2202,23548,47401,2.44288262273,0.0382790091265
"Whitfield County, Georgia",2009,92292,33.2,35149,3697,31452,42783,2.93437619229,0.0400576431327
"Whitfield County, Georgia",2012,102152,34,39599,5126,34473,41832,2.96324659879,0.0501801237372
"Whitfield County, Georgia",2015,103456,34.8,39731,5156,34575,40596,2.992219812,0.049837612125
"Whitley County, Indiana",2009,32504,38.4,13908,898,13010,51376,2.49838585703,0.0276273689392
"Whitley County, Indiana",2012,33234,40,14267,1181,13086,50568,2.5396607061,0.035535896973
"Whitley County, Indiana",2015,33330,41,14421,1269,13152,54389,2.53421532847,0.0380738073807
"Whitley County, Kentucky",2009,38257,36.7,16124,2442,13682,27189,2.79615553282,0.0638314556813
"Whitley County, Kentucky",2012,35756,37.9,15218,1888,13330,29876,2.68237059265,0.0528023268822
"Whitley County, Kentucky",2015,35794,37.1,15180,2070,13110,31014,2.73028222731,0.0578309213835
"Whitman County, Washington",2009,41793,23.6,18364,2783,15581,32403,2.68230537193,0.0665900988204
"Whitman County, Washington",2012,44997,24.1,19308,2884,16424,34169,2.73971018022,0.0640931617663
"Whitman County, Washington",2015,46737,24.2,19708,2309,17399,36631,2.68618886143,0.0494041123735
"Wibaux County, Montana",2009,922,47.8,566,145,421,32154,2.19002375297,0.15726681128
"Wibaux County, Montana",2012,899,50.2,531,153,378,45625,2.37830687831,0.170189098999
"Wibaux County, Montana",2015,986,51.2,558,110,448,38553,2.20089285714,0.111561866126
"Wichita County, Kansas",2009,2177,35.8,1116,243,873,40450,2.49369988545,0.111621497474
"Wichita County, Kansas",2012,2239,38.3,1049,141,908,51098,2.46585903084,0.0629745422063
"Wichita County, Kansas",2015,2204,35.7,868,87,781,57171,2.82202304738,0.0394736842105
"Wichita County, Texas",2009,128464,33.1,55792,6624,49168,42999,2.61275626424,0.0515630838211
"Wichita County, Texas",2012,131019,34.1,55632,7497,48135,45589,2.72190713618,0.0572207084469
"Wichita County, Texas",2015,131957,34,55897,7956,47941,45543,2.75248743247,0.0602923679684
"Wicomico County, Maryland",2009,92827,35.9,40056,3794,36262,51352,2.55989741327,0.0408717291305
"Wicomico County, Maryland",2012,98940,35.6,41140,4622,36518,50639,2.70934881428,0.0467151809177
"Wicomico County, Maryland",2015,101182,35.5,41685,4696,36989,52278,2.73546189408,0.0464114170505
"Wilbarger County, Texas",2009,13725,35.9,6451,1221,5230,36338,2.62428298279,0.0889617486339
"Wilbarger County, Texas",2012,13451,37.8,6319,1194,5125,42271,2.62458536585,0.088766634451
"Wilbarger County, Texas",2015,13158,37.6,6280,1068,5212,41630,2.52455871067,0.0811673506612
"Wilcox County, Alabama",2009,12552,35.5,6443,2077,4366,22006,2.87494273935,0.165471637986
"Wilcox County, Alabama",2012,11706,38.8,5680,2056,3624,24212,3.23013245033,0.175636425765
"Wilcox County, Alabama",2015,11235,40.2,5616,1773,3843,23750,2.92349726776,0.157810413885
"Wilcox County, Georgia",2009,8721,39,3404,785,2619,28863,3.32989690722,0.0900126132324
"Wilcox County, Georgia",2012,9142,39.7,3517,860,2657,31509,3.4407226195,0.0940713191862
"Wilcox County, Georgia",2015,8972,39.4,3500,758,2742,32043,3.27206418673,0.0844850646456
"Wilkes County, Georgia",2009,10292,43.5,5217,1154,4063,32074,2.53310361802,0.112125923047
"Wilkes County, Georgia",2012,10398,44.2,5158,1068,4090,28224,2.54229828851,0.102712060012
"Wilkes County, Georgia",2015,9991,44.4,5160,1154,4006,32727,2.49400898652,0.115503953558
"Wilkes County, North Carolina",2009,66563,40,30942,4328,26614,34154,2.50105207785,0.0650211078227
"Wilkes County, North Carolina",2012,69265,42.4,32957,5006,27951,32009,2.47808665164,0.0722731538295
"Wilkes County, North Carolina",2015,68946,43.7,33017,5595,27422,33232,2.51425862446,0.0811504655818
"Wilkin County, Minnesota",2009,6455,43.5,3016,393,2623,49327,2.4609226077,0.0608830364059
"Wilkin County, Minnesota",2012,6584,42.8,3084,405,2679,52970,2.45763344532,0.0615127582017
"Wilkin County, Minnesota",2015,6526,43.7,3069,293,2776,51476,2.35086455331,0.044897333742
"Wilkinson County, Georgia",2009,10044,37.8,4591,869,3722,36353,2.69854916711,0.0865193150139
"Wilkinson County, Georgia",2012,9577,40.5,4485,1159,3326,40331,2.87943475646,0.12101910828
"Wilkinson County, Georgia",2015,9386,41.6,4444,1131,3313,38485,2.83308179897,0.120498614958
"Wilkinson County, Mississippi",2009,10200,35.4,5422,1719,3703,25478,2.75452335944,0.168529411765
"Wilkinson County, Mississippi",2012,9778,36.2,5052,1555,3497,35960,2.79611095224,0.15903047658
"Wilkinson County, Mississippi",2015,9345,36.8,5047,1838,3209,29931,2.91212215644,0.196682718031
"Will County, Illinois",2009,664361,34.3,226543,13914,212629,74118,3.12450794576,0.0209434328626
"Will County, Illinois",2012,677669,35.5,237175,15083,222092,76352,3.05129856096,0.0222571786521
"Will County, Illinois",2015,683995,36.6,239232,15592,223640,76101,3.05846449651,0.0227954882711
"Willacy County, Texas",2009,20364,31.2,7206,1513,5693,22747,3.57702441595,0.0742977803968
"Willacy County, Texas",2012,21983,31.9,7041,1659,5382,26369,4.0845410628,0.0754674066324
"Willacy County, Texas",2015,22002,32.3,7102,1549,5553,26495,3.962182604,0.0704026906645
"Williams County, North Dakota",2009,19644,40.9,9766,946,8820,52139,2.22721088435,0.0481571981267
"Williams County, North Dakota",2012,23287,37.6,10884,1142,9742,69617,2.39037158694,0.0490402370421
"Williams County, North Dakota",2015,29619,32.6,14683,2601,12082,88013,2.45149809634,0.0878152537223
"Williams County, Ohio",2009,38204,39.7,17005,1545,15460,44734,2.47115135834,0.0404407915402
"Williams County, Ohio",2012,37779,40.6,16668,1635,15033,43176,2.51307124326,0.0432780115937
"Williams County, Ohio",2015,37386,41.6,16564,1414,15150,42492,2.46772277228,0.0378216444658
"Williamsburg County, South Carolina",2009,34920,39.1,15978,4223,11755,25948,2.9706507869,0.120933562428
"Williamsburg County, South Carolina",2012,34361,40.6,15371,4030,11341,25174,3.02980336831,0.117284130264
"Williamsburg County, South Carolina",2015,33238,41,15220,3335,11885,28297,2.79663441313,0.100336963716
"Williamsburg city, Virginia",2009,12330,21.9,4672,842,3830,41236,3.21932114883,0.0682887266829
"Williamsburg city, Virginia",2012,14207,24.1,5161,880,4281,50865,3.31861714553,0.061941296544
"Williamsburg city, Virginia",2015,14754,24.6,5020,482,4538,48639,3.25121198766,0.0326691066829
"Williamson County, Illinois",2009,64212,39.6,29657,3388,26269,39286,2.44440214702,0.0527627234785
"Williamson County, Illinois",2012,66335,40.4,30345,3532,26813,41596,2.47398649909,0.0532448933444
"Williamson County, Illinois",2015,67121,41,30688,3892,26796,44453,2.50488878937,0.0579848333606
"Williamson County, Tennessee",2009,165526,38.1,60656,3166,57490,88358,2.87921377631,0.0191269045346
"Williamson County, Tennessee",2012,184225,38.5,68522,3576,64946,91146,2.8365873187,0.0194110462749
"Williamson County, Tennessee",2015,199456,38.9,72301,2823,69478,96565,2.87077923947,0.0141534975132
"Williamson County, Texas",2009,372438,34.1,132621,8589,124032,69406,3.00275735294,0.0230615565544
"Williamson County, Texas",2012,426296,34.4,161794,10442,151352,70849,2.81658650034,0.0244947172856
"Williamson County, Texas",2015,473592,35.2,172113,10320,161793,73750,2.92714765163,0.0217909086302
"Wilson County, Kansas",2009,9668,43.6,5020,918,4102,37985,2.35689907362,0.0949524203558
"Wilson County, Kansas",2012,9368,44.1,4697,920,3777,40414,2.48027535081,0.0982066609735
"Wilson County, Kansas",2015,9061,43.8,4663,894,3769,40306,2.40408596445,0.0986646065556
"Wilson County, North Carolina",2009,76765,38.3,33968,3569,30399,38712,2.52524754104,0.0464925421742
"Wilson County, North Carolina",2012,81020,38.8,35428,3496,31932,38398,2.53726669172,0.0431498395458
"Wilson County, North Carolina",2015,81581,39.9,35671,3668,32003,39847,2.54916726557,0.0449614493571
"Wilson County, Tennessee",2009,106472,38.4,42562,2413,40149,61179,2.65192159207,0.0226632354046
"Wilson County, Tennessee",2012,114618,39.3,45702,3124,42578,61353,2.69195359106,0.0272557538955
"Wilson County, Tennessee",2015,122445,40.1,48065,3537,44528,61070,2.74984279554,0.0288864388093
"Wilson County, Texas",2009,39033,38.5,12962,1304,11658,59347,3.34817292846,0.0334076294418
"Wilson County, Texas",2012,42999,39.8,16568,1446,15122,62870,2.84347308557,0.0336286890393
"Wilson County, Texas",2015,45509,40.4,16931,1454,15477,68100,2.94042773147,0.0319497242304
"Winchester city, Virginia",2009,25977,37.4,11546,1534,10012,44708,2.5945864962,0.0590522385187
"Winchester city, Virginia",2012,26330,35.6,11866,1412,10454,45959,2.51865314712,0.0536270413976
"Winchester city, Virginia",2015,27168,37,11903,1295,10608,45363,2.56108597285,0.0476663722026
"Windham County, Connecticut",2009,116579,38,46832,4179,42653,57427,2.73319578928,0.0358469364122
"Windham County, Connecticut",2012,118046,39.4,48996,5087,43909,58489,2.68842378556,0.043093370381
"Windham County, Connecticut",2015,117470,40.4,49176,4900,44276,59392,2.65313036408,0.0417127777305
"Windham County, Vermont",2009,43627,43.6,28344,9701,18643,46465,2.34012766186,0.222362298577
"Windham County, Vermont",2012,44310,44.9,29631,10377,19254,51113,2.3013399813,0.234190927556
"Windham County, Vermont",2015,43858,45.8,29861,10804,19057,51045,2.30141155481,0.246340462401
"Windsor County, Vermont",2009,56921,44.5,33345,8947,24398,51066,2.33301909993,0.157182762074
"Windsor County, Vermont",2012,56607,45.5,34106,9206,24900,53124,2.27337349398,0.16263006342
"Windsor County, Vermont",2015,56150,46.8,34132,9625,24507,52965,2.29118211123,0.171415850401
"Winkler County, Texas",2009,6583,36,3244,657,2587,40074,2.54464630847,0.0998025216467
"Winkler County, Texas",2012,7137,34.4,3036,364,2672,47167,2.67103293413,0.0510018214936
"Winkler County, Texas",2015,7576,33,3006,378,2628,55756,2.88280060883,0.0498944033791
"Winn Parish, Louisiana",2009,15531,38.5,7845,2041,5804,30514,2.67591316334,0.131414590174
"Winn Parish, Louisiana",2012,15233,39.9,7249,1780,5469,33853,2.78533552752,0.116851572244
"Winn Parish, Louisiana",2015,14855,41.3,7243,1730,5513,31087,2.69454017776,0.116459104679
"Winnebago County, Illinois",2009,295803,37.2,124321,13177,111144,46882,2.66143921399,0.0445465394198
"Winnebago County, Illinois",2012,294433,38.4,125928,12809,113119,47573,2.60286070421,0.0435039550594
"Winnebago County, Illinois",2015,290439,39.2,125720,11808,113912,48225,2.54967869935,0.0406556970655
"Winnebago County, Iowa",2009,10835,43.3,5188,517,4671,39694,2.3196317705,0.0477157360406
"Winnebago County, Iowa",2012,10800,43.8,5189,549,4640,46438,2.3275862069,0.0508333333333
"Winnebago County, Iowa",2015,10614,43.2,5179,599,4580,47668,2.31746724891,0.0564348973054
"Winnebago County, Wisconsin",2009,161386,36.9,71202,5456,65746,50554,2.45468925866,0.0338071456012
"Winnebago County, Wisconsin",2012,166984,37.8,73264,6032,67232,51603,2.48369823893,0.0361232213865
"Winnebago County, Wisconsin",2015,169004,37.7,74023,5084,68939,52018,2.45150060198,0.0300821282337
"Winneshiek County, Iowa",2009,20764,39.5,8695,761,7934,49645,2.61709100076,0.0366499711038
"Winneshiek County, Iowa",2012,21033,40.2,8726,737,7989,52827,2.63274502441,0.0350401749632
"Winneshiek County, Iowa",2015,20884,40.6,8777,529,8248,54429,2.53200775946,0.0253303964758
"Winona County, Minnesota",2009,49558,33.5,21006,1516,19490,42941,2.5427398666,0.0305904193067
"Winona County, Minnesota",2012,51481,33.1,20812,1558,19254,46900,2.67378207126,0.0302635923933
"Winona County, Minnesota",2015,51213,33.9,20886,1818,19068,50547,2.68580868471,0.035498799133
"Winston County, Alabama",2009,24190,41.2,12922,3546,9376,29818,2.57999146758,0.146589499793
"Winston County, Alabama",2012,24432,43.1,13432,3888,9544,32830,2.55993294216,0.159135559921
"Winston County, Alabama",2015,24130,43.9,13416,4010,9406,33194,2.56538379758,0.166183174472
"Winston County, Mississippi",2009,19543,38,8827,1314,7513,30406,2.60122454412,0.0672363506115
"Winston County, Mississippi",2012,19160,39.4,8736,1295,7441,32094,2.57492272544,0.0675887265136
"Winston County, Mississippi",2015,18697,40.5,8755,1091,7664,33202,2.43958768267,0.0583516072097
"Wirt County, West Virginia",2009,5696,41.7,3451,919,2532,33668,2.24960505529,0.161341292135
"Wirt County, West Virginia",2012,5769,43.9,3232,929,2303,36602,2.50499348676,0.161033107991
"Wirt County, West Virginia",2015,5841,45,3243,813,2430,39352,2.4037037037,0.139188495121
"Wise County, Texas",2009,57615,37.3,21024,2875,18149,55703,3.1745550719,0.0499001996008
"Wise County, Texas",2012,59351,38.5,23634,3282,20352,55492,2.91622444969,0.0552981415646
"Wise County, Texas",2015,61243,39.3,23917,2849,21068,56897,2.90692044807,0.0465196022403
"Wise County, Virginia",2009,41715,38,18416,2246,16170,32324,2.57977736549,0.0538415438092
"Wise County, Virginia",2012,41361,39.5,17935,2262,15673,35120,2.63899700121,0.054689199971
"Wise County, Virginia",2015,40530,39.8,17851,2597,15254,37407,2.6570079979,0.0640759930915
"Wolfe County, Kentucky",2009,7080,37.9,3473,1051,2422,20960,2.92320396367,0.148446327684
"Wolfe County, Kentucky",2012,7298,41.3,3642,956,2686,21168,2.71705137751,0.130994793094
"Wolfe County, Kentucky",2015,7261,41.8,3652,734,2918,20504,2.48834818369,0.101088004407
"Wood County, Ohio",2009,124975,34.4,51980,3738,48242,52818,2.59058496746,0.0299099819964
"Wood County, Ohio",2012,126254,35.1,53366,4577,48789,53441,2.58775543668,0.0362523167583
"Wood County, Ohio",2015,128885,34.8,53726,3635,50091,53577,2.57301710886,0.0282034371727
"Wood County, Texas",2009,42104,44,18711,4041,14670,39480,2.87007498296,0.0959766292989
"Wood County, Texas",2012,41927,47.5,20736,4832,15904,42404,2.63625503018,0.115247930928
"Wood County, Texas",2015,42712,48.2,20928,4864,16064,45686,2.65886454183,0.113879003559
"Wood County, West Virginia",2009,86557,41.2,40923,3889,37034,39530,2.33723065291,0.044929930566
"Wood County, West Virginia",2012,86835,41.8,40236,4453,35783,42734,2.42671100802,0.0512811654287
"Wood County, West Virginia",2015,86559,42.5,40265,4073,36192,41884,2.39166114058,0.0470546101503
"Wood County, Wisconsin",2009,74023,41.9,33447,1999,31448,47594,2.35382218265,0.0270051200303
"Wood County, Wisconsin",2012,74591,42.5,34061,2049,32012,46999,2.33009496439,0.0274698019868
"Wood County, Wisconsin",2015,74012,43.4,34256,2539,31717,48961,2.33351199672,0.0343052477977
"Woodbury County, Iowa",2009,101764,35.2,42028,2922,39106,44656,2.60226052268,0.0287134939664
"Woodbury County, Iowa",2012,101948,35.2,41457,2713,38744,45289,2.63132355978,0.0266116059167
"Woodbury County, Iowa",2015,102530,35.4,41488,2832,38656,46720,2.65236961921,0.0276211840437
"Woodford County, Illinois",2009,37950,39.1,14866,828,14038,63917,2.70337654937,0.0218181818182
"Woodford County, Illinois",2012,38736,40.1,15155,904,14251,68552,2.71812504386,0.0233374638579
"Woodford County, Illinois",2015,39106,39.9,15325,975,14350,65852,2.72515679443,0.0249322354626
"Woodford County, Kentucky",2009,24482,40.1,10445,591,9854,56478,2.48447331033,0.0241401846254
"Woodford County, Kentucky",2012,24847,41.7,10711,864,9847,56672,2.52330659084,0.0347728095947
"Woodford County, Kentucky",2015,25317,41.9,10862,1060,9802,58750,2.58284023669,0.0418690998144
"Woodruff County, Arkansas",2009,7677,40.9,4215,572,3643,27880,2.10732912435,0.0745082714602
"Woodruff County, Arkansas",2012,7262,43.3,3907,738,3169,28061,2.29157462922,0.101624896723
"Woodruff County, Arkansas",2015,6983,43.9,3883,972,2911,28993,2.39883201649,0.139195188314
"Woods County, Oklahoma",2009,8440,36.9,4481,855,3626,46074,2.32763375621,0.101303317536
"Woods County, Oklahoma",2012,8741,35.6,4475,968,3507,50690,2.49244368406,0.110742477977
"Woods County, Oklahoma",2015,9033,33.9,4457,1031,3426,55315,2.63660245184,0.114137053028
"Woodson County, Kansas",2009,3331,46.8,2094,484,1610,29681,2.06894409938,0.145301711198
"Woodson County, Kansas",2012,3311,48.8,2017,493,1524,30852,2.17257217848,0.148897614014
"Woodson County, Kansas",2015,3211,47.4,2007,476,1531,35787,2.09732201176,0.148240423544
"Woodward County, Oklahoma",2009,19430,36.6,8515,951,7564,45995,2.56874669487,0.0489449305198
"Woodward County, Oklahoma",2012,20232,37.2,8827,1429,7398,52048,2.73479318735,0.0706306840648
"Woodward County, Oklahoma",2015,20986,36.1,8909,1542,7367,55300,2.84864938238,0.0734775564662
"Worcester County, Maryland",2009,49081,46.9,53954,31380,22574,52600,2.1742269868,0.639351276461
"Worcester County, Maryland",2012,51398,48.1,55666,34472,21194,58138,2.42512031707,0.670687575392
"Worcester County, Maryland",2015,51519,49.1,55749,34976,20773,56773,2.48009435325,0.678895164891
"Worcester County, Massachusetts",2009,795726,38.4,317856,25132,292724,63720,2.71834902502,0.0315837361102
"Worcester County, Massachusetts",2012,799277,39.2,326345,26995,299350,65968,2.67004175714,0.0337742734997
"Worcester County, Massachusetts",2015,810935,39.8,328627,27451,301176,65313,2.69256182432,0.0338510484811
"Worth County, Georgia",2009,21351,39.1,9550,1525,8025,36707,2.66056074766,0.0714252259847
"Worth County, Georgia",2012,21746,39.4,9278,1239,8039,39205,2.70506281876,0.0569759955854
"Worth County, Georgia",2015,21156,40.4,9222,1298,7924,37974,2.6698637052,0.0613537530724
"Worth County, Iowa",2009,7620,43.8,3556,301,3255,49871,2.34101382488,0.039501312336
"Worth County, Iowa",2012,7581,43.9,3546,339,3207,50603,2.36389148737,0.0447170557974
"Worth County, Iowa",2015,7563,44.8,3524,344,3180,48459,2.37830188679,0.0454845960598
"Worth County, Missouri",2009,2058,47.7,1140,240,900,39479,2.28666666667,0.116618075802
"Worth County, Missouri",2012,2146,47.5,1276,297,979,39946,2.19203268641,0.138397017707
"Worth County, Missouri",2015,2082,47.8,1274,374,900,45952,2.31333333333,0.179634966378
"Wrangell City and Borough, Alaska",2009,2168,38.7,1343,382,961,49508,2.25598335068,0.176199261993
"Wrangell City and Borough, Alaska",2012,2368,50.8,1472,312,1160,47348,2.04137931034,0.131756756757
"Wrangell City and Borough, Alaska",2015,2387,50.4,1499,372,1127,48603,2.11801242236,0.155844155844
"Wright County, Iowa",2009,13039,44.1,6600,1010,5590,42859,2.33255813953,0.0774599279086
"Wright County, Iowa",2012,13173,44.4,6537,1050,5487,45713,2.4007654456,0.0797084946481
"Wright County, Iowa",2015,12936,44.6,6510,1015,5495,43698,2.35414012739,0.0784632034632
"Wright County, Minnesota",2009,116527,33.9,47305,3921,43384,67090,2.68594412687,0.0336488539137
"Wright County, Minnesota",2012,124737,34.6,48948,4132,44816,70930,2.783313995,0.0331256964654
"Wright County, Minnesota",2015,128691,35.6,49630,4365,45265,73557,2.84305754998,0.0339184558361
"Wright County, Missouri",2009,18082,40.5,8195,953,7242,27598,2.49682408175,0.0527043468643
"Wright County, Missouri",2012,18732,40.6,8660,1245,7415,29485,2.52623061362,0.066463805253
"Wright County, Missouri",2015,18449,41.7,8628,1277,7351,29778,2.50972656781,0.0692178437856
"Wyandot County, Ohio",2009,22499,40.2,9729,667,9062,47683,2.48278525712,0.0296457620339
"Wyandot County, Ohio",2012,22626,41.4,9868,587,9281,46129,2.43788384872,0.0259436047026
"Wyandot County, Ohio",2015,22467,42,9894,567,9327,47555,2.40881312319,0.0252370142876
"Wyandotte County, Kansas",2009,153753,33,67510,8870,58640,37998,2.62198158254,0.0576899312534
"Wyandotte County, Kansas",2012,157274,33,66810,9454,57356,39163,2.74206708976,0.0601116522756
"Wyandotte County, Kansas",2015,160806,33.3,67113,8243,58870,40113,2.73154408018,0.0512605251048
"Wyoming County, New York",2009,41820,40.2,17331,2273,15058,48943,2.77726125647,0.0543519846963
"Wyoming County, New York",2012,42092,40.7,17934,2301,15633,50635,2.69250943517,0.0546659697805
"Wyoming County, New York",2015,41446,41.1,18037,2250,15787,52564,2.62532463419,0.0542875066351
"Wyoming County, Pennsylvania",2009,27882,40.3,13326,2109,11217,44971,2.48569136133,0.0756401979772
"Wyoming County, Pennsylvania",2012,28221,42,13282,2245,11037,48626,2.55694482196,0.0795506892031
"Wyoming County, Pennsylvania",2015,28147,43.1,13313,2419,10894,51004,2.58371580687,0.08594166341
"Wyoming County, West Virginia",2009,23651,42.4,11930,2048,9882,32141,2.39334142886,0.0865925330853
"Wyoming County, West Virginia",2012,23668,42.4,10990,1844,9146,36010,2.58779794446,0.0779111035998
"Wyoming County, West Virginia",2015,22866,42.8,10852,1653,9199,33730,2.48570496793,0.0722907373393
"Wythe County, Virginia",2009,28517,42.3,13540,2033,11507,38490,2.47823064222,0.0712908089911
"Wythe County, Virginia",2012,29203,42.9,14043,2433,11610,40564,2.51533161068,0.0833133582166
"Wythe County, Virginia",2015,29190,43.6,14159,2296,11863,41360,2.46059175588,0.0786570743405
"Yabucoa Municipio, Puerto Rico",2009,40463,34.2,13807,1983,11824,16327,3.42210757781,0.049007735462
"Yabucoa Municipio, Puerto Rico",2012,37823,36.7,13881,2231,11650,17926,3.24660944206,0.0589852735108
"Yabucoa Municipio, Puerto Rico",2015,36279,39.6,14706,2535,12171,15627,2.98077397091,0.0698751343753
"Yadkin County, North Carolina",2009,37520,41.2,16890,2068,14822,38105,2.53137228444,0.0551172707889
"Yadkin County, North Carolina",2012,38254,41.8,17318,2426,14892,40316,2.56876175128,0.0634182046322
"Yadkin County, North Carolina",2015,37971,42.9,17250,1881,15369,37796,2.47062268202,0.0495378051671
"Yakima County, Washington",2009,232911,32.1,83238,5422,77816,41854,2.99309910558,0.023279278351
"Yakima County, Washington",2012,242454,32.4,85420,5942,79478,44256,3.05058003473,0.0245077416747
"Yakima County, Washington",2015,247408,32.5,86208,6236,79972,44749,3.09368278898,0.0252053288495
"Yakutat City and Borough, Alaska",2009,418,37.6,383,217,166,66250,2.51807228916,0.519138755981
"Yakutat City and Borough, Alaska",2012,644,39.1,454,195,259,71705,2.48648648649,0.302795031056
"Yakutat City and Borough, Alaska",2015,643,42.5,391,141,250,72500,2.572,0.219284603421
"Yalobusha County, Mississippi",2009,13646,40.2,6665,1233,5432,28578,2.51215022091,0.0903561483219
"Yalobusha County, Mississippi",2012,12647,40.2,6354,1638,4716,32343,2.68172179813,0.129516881474
"Yalobusha County, Mississippi",2015,12381,41.5,6360,1259,5101,36502,2.42717114291,0.10168807043
"Yamhill County, Oregon",2009,95494,35.9,35646,2084,33562,51191,2.84530123354,0.02182336063
"Yamhill County, Oregon",2012,99119,37.1,37056,3136,33920,53950,2.92214033019,0.0316387372754
"Yamhill County, Oregon",2015,101119,38.2,37495,3070,34425,53423,2.93737109659,0.0303602685944
"Yancey County, North Carolina",2009,18336,43.6,10546,3134,7412,34949,2.47382622774,0.170920593368
"Yancey County, North Carolina",2012,17814,45.3,11009,3867,7142,38766,2.49425931112,0.217076456719
"Yancey County, North Carolina",2015,17604,46.2,11058,3642,7416,37484,2.37378640777,0.206884798909
"Yankton County, South Dakota",2009,21771,40.4,9466,780,8686,45848,2.50644715634,0.0358274769188
"Yankton County, South Dakota",2012,22434,41.1,9652,1104,8548,53589,2.62447356107,0.049211018989
"Yankton County, South Dakota",2015,22636,40.8,9746,847,8899,48176,2.54365659063,0.0374182717795
"Yates County, New York",2009,24526,40.1,12489,3377,9112,44947,2.69161545215,0.137690614042
"Yates County, New York",2012,25351,40.4,13456,3925,9531,48245,2.65984681565,0.154826239596
"Yates County, New York",2015,25187,41.5,13693,3968,9725,49510,2.58992287918,0.157541588915
"Yauco Municipio, Puerto Rico",2009,48214,35.7,17272,2774,14498,13741,3.3255621465,0.0575351557639
"Yauco Municipio, Puerto Rico",2012,41876,38.4,16848,4810,12038,14728,3.47865093869,0.114862928646
"Yauco Municipio, Puerto Rico",2015,39474,40.8,17133,6698,10435,14708,3.7828461907,0.169681309216
"Yavapai County, Arizona",2009,209365,47.7,103628,17921,85707,43965,2.44279930461,0.0855969240322
"Yavapai County, Arizona",2012,211280,49.3,110317,19149,91168,43652,2.31747981748,0.0906332828474
"Yavapai County, Arizona",2015,215996,51.3,111731,19421,92310,44748,2.33989816921,0.0899137021056
"Yazoo County, Mississippi",2009,28296,34.8,10376,1333,9043,27404,3.129050094,0.0471091320328
"Yazoo County, Mississippi",2012,28220,35.4,10090,1434,8656,26769,3.2601663586,0.0508150248051
"Yazoo County, Mississippi",2015,27911,35.8,10055,1453,8602,28961,3.24471053243,0.0520583282577
"Yell County, Arkansas",2009,21912,36.5,9664,1906,7758,36398,2.82443928848,0.0869843008397
"Yell County, Arkansas",2012,22033,38.4,9734,1870,7864,38245,2.80175483215,0.0848726909636
"Yell County, Arkansas",2015,21835,39.1,9739,2052,7687,37804,2.84050995187,0.093977558965
"Yellow Medicine County, Minnesota",2009,10067,42.9,4969,543,4426,46292,2.27451423407,0.0539386113043
"Yellow Medicine County, Minnesota",2012,10357,42.7,4758,633,4125,52134,2.51078787879,0.0611180843874
"Yellow Medicine County, Minnesota",2015,10092,43,4754,558,4196,53041,2.40514775977,0.0552913198573
"Yellowstone County, Montana",2009,140436,37.7,58880,2815,56065,46967,2.5048782663,0.0200447178786
"Yellowstone County, Montana",2012,148191,38.5,63822,3116,60706,50608,2.44112608309,0.021026917964
"Yellowstone County, Montana",2015,153692,38,65792,4350,61442,52802,2.50141596953,0.0283033599667
"Yoakum County, Texas",2009,7453,33.4,3042,306,2736,48235,2.7240497076,0.0410572923655
"Yoakum County, Texas",2012,7918,31.8,2978,368,2610,48611,3.0337164751,0.046476382925
"Yoakum County, Texas",2015,8213,34.1,2993,266,2727,56153,3.01173450678,0.0323876780714
"Yolo County, California",2009,192974,29.1,71382,3882,67500,56232,2.85887407407,0.020116699659
"Yolo County, California",2012,200873,30.5,74923,4833,70090,57260,2.86592951919,0.0240599781952
"Yolo County, California",2015,207320,30.9,76090,4093,71997,54989,2.8795644263,0.0197424271657
"York County, Maine",2009,201306,41.5,103840,23417,80423,54414,2.50308991209,0.11632539517
"York County, Maine",2012,197861,43,105850,24942,80908,56656,2.44550600682,0.126058192367
"York County, Maine",2015,199682,44.1,106924,24797,82127,57919,2.43138066653,0.124182450096
"York County, Nebraska",2009,14084,40.2,6258,492,5766,47126,2.4425945196,0.0349332575973
"York County, Nebraska",2012,13727,42.2,6223,591,5632,47220,2.43732244318,0.0430538355067
"York County, Nebraska",2015,13825,41.3,6276,672,5604,51802,2.46698786581,0.0486075949367
"York County, Pennsylvania",2009,419563,39.5,173599,9742,163857,56271,2.56054364476,0.0232193973253
"York County, Pennsylvania",2012,434579,40.1,178594,10466,168128,58747,2.58481038257,0.0240830781055
"York County, Pennsylvania",2015,439660,40.7,180237,12821,167416,58269,2.62615281694,0.029161169995
"York County, South Carolina",2009,209351,36.6,85849,7398,78451,51332,2.6685574435,0.0353377820025
"York County, South Carolina",2012,226576,37.2,94007,8202,85805,52571,2.64059204009,0.0361997740273
"York County, South Carolina",2015,240076,37.9,97834,7512,90322,54117,2.65800137287,0.031290091471
"York County, Virginia",2009,61269,39.1,24475,1730,22745,79189,2.69373488679,0.0282361389936
"York County, Virginia",2012,65503,39.6,26625,2617,24008,82454,2.72838220593,0.0399523685938
"York County, Virginia",2015,66471,39.5,27150,3153,23997,81749,2.76997124641,0.047434219434
"Young County, Texas",2009,17701,41.3,8650,1091,7559,38195,2.34171186665,0.0616349358793
"Young County, Texas",2012,18368,42.4,8612,1403,7209,42008,2.54792620336,0.0763828397213
"Young County, Texas",2015,18329,41.9,8634,1519,7115,44693,2.57610681658,0.0828741338862
"Yuba County, California",2009,70906,30.8,27596,3384,24212,46410,2.92854782752,0.0477251572504
"Yuba County, California",2012,72244,31.9,27670,3537,24133,46641,2.99357725935,0.0489590831072
"Yuba County, California",2015,73437,32.1,27930,2791,25139,46892,2.92123791718,0.0380053651429
"Yukon-Koyukuk Census Area, Alaska",2009,5813,33.9,4026,1907,2119,33716,2.74327512978,0.328057801479
"Yukon-Koyukuk Census Area, Alaska",2012,5637,35.6,4032,1971,2061,35559,2.73508005822,0.349654071315
"Yukon-Koyukuk Census Area, Alaska",2015,5644,35,4035,2053,1982,38491,2.84762865792,0.363749114103
"Yuma County, Arizona",2009,188983,34.7,86878,16589,70289,38854,2.68865683108,0.0877803823624
"Yuma County, Arizona",2012,196420,33.6,88064,17953,70111,41156,2.8015575302,0.0914010793198
"Yuma County, Arizona",2015,202987,33.8,89330,18691,70639,40743,2.87358258186,0.0920797883608
"Yuma County, Colorado",2009,9630,38.7,4390,406,3984,39945,2.4171686747,0.0421599169263
"Yuma County, Colorado",2012,10032,36.3,4463,577,3886,45033,2.5815748842,0.0575159489633
"Yuma County, Colorado",2015,10185,36,4438,573,3865,43105,2.63518758085,0.0562592047128
"Zapata County, Texas",2009,13561,29.2,6548,1970,4578,20525,2.9622105723,0.145269522897
"Zapata County, Texas",2012,14014,27.9,6217,1860,4357,28617,3.21643332568,0.132724418439
"Zapata County, Texas",2015,14308,29.2,6223,1706,4517,32162,3.16758910781,0.119233994968
"Zavala County, Texas",2009,11620,31.1,4198,738,3460,22964,3.35838150289,0.0635111876076
"Zavala County, Texas",2012,11753,31.1,4275,718,3557,25206,3.30418892325,0.0610907853314
"Zavala County, Texas",2015,12060,30.5,4297,670,3627,26672,3.32506203474,0.0555555555556
"Ziebach County, South Dakota",2009,2574,26.9,934,174,760,26833,3.38684210526,0.0675990675991
"Ziebach County, South Dakota",2012,2796,26.3,986,171,815,32422,3.43067484663,0.0611587982833
"Ziebach County, South Dakota",2015,2833,27.5,996,186,810,35119,3.4975308642,0.0656547829156
